USN,SCODE,CIE,SEE,TOT,RESULT,GRADE,DATE,ExamType
4JN18CS001,18MAT11,32,41,73,P,8,12019,Regular
4JN18CS001,18PHY12,29,47,76,P,8,12019,Regular
4JN18CS001,18ELE13,25,43,68,P,7,12019,Regular
4JN18CS001,18CIV14,31,26,57,P,6,12019,Regular
4JN18CS001,18EGDL15,31,56,87,P,9,12019,Regular
4JN18CS001,18PHYL16,32,40,72,P,8,12019,Regular
4JN18CS001,18ELEL17,34,52,86,P,9,12019,Regular
4JN18CS001,18EGH18,27,32,59,P,6,12019,Regular
4JN18CS002,18MAT11,33,51,84,P,9,12019,Regular
4JN18CS002,18PHY12,36,45,81,P,9,12019,Regular
4JN18CS002,18ELE13,37,31,68,P,7,12019,Regular
4JN18CS002,18CIV14,34,29,63,P,7,12019,Regular
4JN18CS002,18EGDL15,34,55,89,P,9,12019,Regular
4JN18CS002,18PHYL16,31,44,75,P,8,12019,Regular
4JN18CS002,18ELEL17,31,53,84,P,9,12019,Regular
4JN18CS002,18EGH18,34,38,72,P,8,12019,Regular
4JN18CS003,18MAT11,37,44,81,P,9,12019,Regular
4JN18CS003,18PHY12,33,40,73,P,8,12019,Regular
4JN18CS003,18ELE13,39,42,81,P,9,12019,Regular
4JN18CS003,18CIV14,39,33,72,P,8,12019,Regular
4JN18CS003,18EGDL15,36,21,57,P,6,12019,Regular
4JN18CS003,18PHYL16,32,25,57,P,6,12019,Regular
4JN18CS003,18ELEL17,32,51,83,P,9,12019,Regular
4JN18CS003,18EGH18,34,41,75,P,8,12019,Regular
4JN18CS004,18MAT11,25,21,46,P,5,12019,Regular
4JN18CS004,18PHY12,20,21,41,P,4,12019,Regular
4JN18CS004,18ELE13,30,21,51,P,6,12019,Regular
4JN18CS004,18CIV14,25,21,46,P,5,12019,Regular
4JN18CS004,18EGDL15,36,38,74,P,8,12019,Regular
4JN18CS004,18PHYL16,24,32,56,P,6,12019,Regular
4JN18CS004,18ELEL17,33,50,83,P,9,12019,Regular
4JN18CS004,18EGH18,32,25,57,P,6,12019,Regular
4JN18CS005,18MAT11,24,29,53,P,6,12019,Regular
4JN18CS005,18PHY12,22,21,43,P,4,12019,Regular
4JN18CS005,18ELE13,27,21,48,P,5,12019,Regular
4JN18CS005,18CIV14,24,18,42,F,0,12019,Regular
4JN18CS005,18EGDL15,36,42,78,P,8,12019,Regular
4JN18CS005,18PHYL16,30,39,69,P,7,12019,Regular
4JN18CS005,18ELEL17,32,51,83,P,9,12019,Regular
4JN18CS005,18EGH18,32,34,66,P,7,12019,Regular
4JN18CS006,18MAT11,36,32,68,P,7,12019,Regular
4JN18CS006,18PHY12,29,38,67,P,7,12019,Regular
4JN18CS006,18ELE13,37,30,67,P,7,12019,Regular
4JN18CS006,18CIV14,38,25,63,P,7,12019,Regular
4JN18CS006,18EGDL15,36,54,90,P,10,12019,Regular
4JN18CS006,18PHYL16,32,42,74,P,8,12019,Regular
4JN18CS006,18ELEL17,33,51,84,P,9,12019,Regular
4JN18CS006,18EGH18,34,35,69,P,7,12019,Regular
4JN18CS007,18MAT11,22,26,48,P,5,12019,Regular
4JN18CS007,18PHY12,26,27,53,P,6,12019,Regular
4JN18CS007,18ELE13,30,21,51,P,6,12019,Regular
4JN18CS007,18CIV14,27,21,48,P,5,12019,Regular
4JN18CS007,18EGDL15,36,24,60,P,7,12019,Regular
4JN18CS007,18PHYL16,30,33,63,P,7,12019,Regular
4JN18CS007,18ELEL17,33,52,85,P,9,12019,Regular
4JN18CS007,18EGH18,30,39,69,P,7,12019,Regular
4JN18CS008,18MAT11,38,50,88,P,9,12019,Regular
4JN18CS008,18PHY12,35,49,84,P,9,12019,Regular
4JN18CS008,18ELE13,39,48,87,P,9,12019,Regular
4JN18CS008,18CIV14,33,23,56,P,6,12019,Regular
4JN18CS008,18EGDL15,37,14,51,F,0,12019,Regular
4JN18CS008,18PHYL16,33,25,58,P,6,12019,Regular
4JN18CS008,18ELEL17,33,53,86,P,9,12019,Regular
4JN18CS008,18EGH18,29,27,56,P,6,12019,Regular
4JN18CS009,18MAT11,31,49,80,P,9,12019,Regular
4JN18CS009,18PHY12,31,38,69,P,7,12019,Regular
4JN18CS009,18ELE13,36,29,65,P,7,12019,Regular
4JN18CS009,18CIV14,32,30,62,P,7,12019,Regular
4JN18CS009,18EGDL15,39,43,82,P,9,12019,Regular
4JN18CS009,18PHYL16,34,54,88,P,9,12019,Regular
4JN18CS009,18ELEL17,31,51,82,P,9,12019,Regular
4JN18CS009,18EGH18,32,29,61,P,7,12019,Regular
4JN18CS010,18MAT11,34,37,71,P,8,12019,Regular
4JN18CS010,18PHY12,32,33,65,P,7,12019,Regular
4JN18CS010,18ELE13,35,41,76,P,8,12019,Regular
4JN18CS010,18CIV14,35,31,66,P,7,12019,Regular
4JN18CS010,18EGDL15,37,15,52,F,0,12019,Regular
4JN18CS010,18PHYL16,35,48,83,P,9,12019,Regular
4JN18CS010,18ELEL17,31,51,82,P,9,12019,Regular
4JN18CS010,18EGH18,34,50,84,P,9,12019,Regular
4JN18CS011,18MAT11,37,56,93,P,10,12019,Regular
4JN18CS011,18PHY12,32,44,76,P,8,12019,Regular
4JN18CS011,18ELE13,38,45,83,P,9,12019,Regular
4JN18CS011,18CIV14,36,26,62,P,7,12019,Regular
4JN18CS011,18EGDL15,37,26,63,P,7,12019,Regular
4JN18CS011,18PHYL16,32,47,79,P,8,12019,Regular
4JN18CS011,18ELEL17,33,51,84,P,9,12019,Regular
4JN18CS011,18EGH18,33,40,73,P,8,12019,Regular
4JN18CS012,18MAT11,28,35,63,P,7,12019,Regular
4JN18CS012,18PHY12,27,32,59,P,6,12019,Regular
4JN18CS012,18ELE13,31,27,58,P,6,12019,Regular
4JN18CS012,18CIV14,30,23,53,P,6,12019,Regular
4JN18CS012,18EGDL15,37,25,62,P,7,12019,Regular
4JN18CS012,18PHYL16,33,45,78,P,8,12019,Regular
4JN18CS012,18ELEL17,31,52,83,P,9,12019,Regular
4JN18CS012,18EGH18,33,38,71,P,8,12019,Regular
4JN18CS013,18MAT11,36,55,91,P,10,12019,Regular
4JN18CS013,18PHY12,24,37,61,P,7,12019,Regular
4JN18CS013,18ELE13,28,36,64,P,7,12019,Regular
4JN18CS013,18CIV14,34,29,63,P,7,12019,Regular
4JN18CS013,18EGDL15,33,44,77,P,8,12019,Regular
4JN18CS013,18PHYL16,29,43,72,P,8,12019,Regular
4JN18CS013,18ELEL17,35,53,88,P,9,12019,Regular
4JN18CS013,18EGH18,30,38,68,P,7,12019,Regular
4JN18CS014,18MAT11,40,54,94,P,10,12019,Regular
4JN18CS014,18PHY12,36,50,86,P,9,12019,Regular
4JN18CS014,18ELE13,39,41,80,P,9,12019,Regular
4JN18CS014,18CIV14,38,30,68,P,7,12019,Regular
4JN18CS014,18EGDL15,37,59,96,P,10,12019,Regular
4JN18CS014,18PHYL16,35,52,87,P,9,12019,Regular
4JN18CS014,18ELEL17,36,53,89,P,9,12019,Regular
4JN18CS014,18EGH18,34,38,72,P,8,12019,Regular
4JN18CS015,18MAT11,36,52,88,P,9,12019,Regular
4JN18CS015,18PHY12,32,31,63,P,7,12019,Regular
4JN18CS015,18ELE13,36,43,79,P,8,12019,Regular
4JN18CS015,18CIV14,35,30,65,P,7,12019,Regular
4JN18CS015,18EGDL15,37,32,69,P,7,12019,Regular
4JN18CS015,18PHYL16,34,53,87,P,9,12019,Regular
4JN18CS015,18ELEL17,32,51,83,P,9,12019,Regular
4JN18CS015,18EGH18,31,38,69,P,7,12019,Regular
4JN18CS016,18MAT11,34,49,83,P,9,12019,Regular
4JN18CS016,18PHY12,32,50,82,P,9,12019,Regular
4JN18CS016,18ELE13,37,34,71,P,8,12019,Regular
4JN18CS016,18CIV14,37,39,76,P,8,12019,Regular
4JN18CS016,18EGDL15,40,39,79,P,8,12019,Regular
4JN18CS016,18PHYL16,34,40,74,P,8,12019,Regular
4JN18CS016,18ELEL17,34,51,85,P,9,12019,Regular
4JN18CS016,18EGH18,32,45,77,P,8,12019,Regular
4JN18CS017,18MAT11,26,21,47,P,5,12019,Regular
4JN18CS017,18PHY12,21,21,42,P,4,12019,Regular
4JN18CS017,18ELE13,30,12,42,F,0,12019,Regular
4JN18CS017,18CIV14,28,21,49,P,5,12019,Regular
4JN18CS017,18EGDL15,37,24,61,P,7,12019,Regular
4JN18CS017,18PHYL16,31,42,73,P,8,12019,Regular
4JN18CS017,18ELEL17,31,48,79,P,8,12019,Regular
4JN18CS017,18EGH18,27,23,50,P,6,12019,Regular
4JN18CS018,18MAT11,27,41,68,P,7,12019,Regular
4JN18CS018,18PHY12,26,29,55,P,6,12019,Regular
4JN18CS018,18ELE13,31,24,55,P,6,12019,Regular
4JN18CS018,18CIV14,30,23,53,P,6,12019,Regular
4JN18CS018,18EGDL15,37,12,49,F,0,12019,Regular
4JN18CS018,18PHYL16,34,31,65,P,7,12019,Regular
4JN18CS018,18ELEL17,31,48,79,P,8,12019,Regular
4JN18CS018,18EGH18,27,32,59,P,6,12019,Regular
4JN18CS019,18MAT11,39,60,99,P,10,12019,Regular
4JN18CS019,18PHY12,34,48,82,P,9,12019,Regular
4JN18CS019,18ELE13,39,47,86,P,9,12019,Regular
4JN18CS019,18CIV14,39,35,74,P,8,12019,Regular
4JN18CS019,18EGDL15,37,41,78,P,8,12019,Regular
4JN18CS019,18PHYL16,36,56,92,P,10,12019,Regular
4JN18CS019,18ELEL17,36,53,89,P,9,12019,Regular
4JN18CS019,18EGH18,33,45,78,P,8,12019,Regular
4JN18CS020,18MAT11,37,57,94,P,10,12019,Regular
4JN18CS020,18PHY12,34,39,73,P,8,12019,Regular
4JN18CS020,18ELE13,38,23,61,P,7,12019,Regular
4JN18CS020,18CIV14,38,30,68,P,7,12019,Regular
4JN18CS020,18EGDL15,37,45,82,P,9,12019,Regular
4JN18CS020,18PHYL16,33,51,84,P,9,12019,Regular
4JN18CS020,18ELEL17,32,47,79,P,8,12019,Regular
4JN18CS020,18EGH18,33,39,72,P,8,12019,Regular
4JN18CS021,18MAT11,39,57,96,P,10,12019,Regular
4JN18CS021,18PHY12,39,57,96,P,10,12019,Regular
4JN18CS021,18ELE13,38,57,95,P,10,12019,Regular
4JN18CS021,18CIV14,38,38,76,P,8,12019,Regular
4JN18CS021,18EGDL15,38,47,85,P,9,12019,Regular
4JN18CS021,18PHYL16,35,54,89,P,9,12019,Regular
4JN18CS021,18ELEL17,34,51,85,P,9,12019,Regular
4JN18CS021,18EGH18,33,36,69,P,7,12019,Regular
4JN18CS022,18MAT11,34,54,88,P,9,12019,Regular
4JN18CS022,18PHY12,27,45,72,P,8,12019,Regular
4JN18CS022,18ELE13,36,37,73,P,8,12019,Regular
4JN18CS022,18CIV14,34,33,67,P,7,12019,Regular
4JN18CS022,18EGDL15,39,60,99,P,10,12019,Regular
4JN18CS022,18PHYL16,31,44,75,P,8,12019,Regular
4JN18CS022,18ELEL17,34,52,86,P,9,12019,Regular
4JN18CS022,18EGH18,32,45,77,P,8,12019,Regular
4JN18CS023,18MAT11,35,42,77,P,8,12019,Regular
4JN18CS023,18PHY12,19,38,57,P,6,12019,Regular
4JN18CS023,18ELE13,24,34,58,P,6,12019,Regular
4JN18CS023,18CIV14,35,21,56,P,6,12019,Regular
4JN18CS023,18EGDL15,37,39,76,P,8,12019,Regular
4JN18CS023,18PHYL16,31,30,61,P,7,12019,Regular
4JN18CS023,18ELEL17,33,47,80,P,9,12019,Regular
4JN18CS023,18EGH18,24,26,50,P,6,12019,Regular
4JN18CS024,18MAT11,31,21,52,P,6,12019,Regular
4JN18CS024,18PHY12,25,22,47,P,5,12019,Regular
4JN18CS024,18ELE13,20,14,34,F,0,12019,Regular
4JN18CS024,18CIV14,26,24,50,P,6,12019,Regular
4JN18CS024,18EGDL15,39,24,63,P,7,12019,Regular
4JN18CS024,18PHYL16,29,35,64,P,7,12019,Regular
4JN18CS024,18ELEL17,34,42,76,P,8,12019,Regular
4JN18CS024,18EGH18,25,36,61,P,7,12019,Regular
4JN18CS025,18MAT11,37,45,82,P,9,12019,Regular
4JN18CS025,18PHY12,30,24,54,P,6,12019,Regular
4JN18CS025,18ELE13,20,28,48,P,5,12019,Regular
4JN18CS025,18CIV14,38,50,88,P,9,12019,Regular
4JN18CS025,18EGDL15,39,60,99,P,10,12019,Regular
4JN18CS025,18PHYL16,33,45,78,P,8,12019,Regular
4JN18CS025,18ELEL17,30,57,87,P,9,12019,Regular
4JN18CS025,18EGH18,30,36,66,P,7,12019,Regular
4JN18CS026,18MAT11,35,26,61,P,7,12019,Regular
4JN18CS026,18PHY12,32,27,59,P,6,12019,Regular
4JN18CS026,18ELE13,33,30,63,P,7,12019,Regular
4JN18CS026,18CIV14,29,27,56,P,6,12019,Regular
4JN18CS026,18EGDL15,38,21,59,P,6,12019,Regular
4JN18CS026,18PHYL16,34,45,79,P,8,12019,Regular
4JN18CS026,18ELEL17,30,51,81,P,9,12019,Regular
4JN18CS026,18EGH18,28,29,57,P,6,12019,Regular
4JN18CS027,18MAT11,27,17,44,F,0,12019,Regular
4JN18CS027,18PHY12,16,24,40,P,4,12019,Regular
4JN18CS027,18ELE13,20,5,25,F,0,12019,Regular
4JN18CS027,18CIV14,23,22,45,P,5,12019,Regular
4JN18CS027,18EGDL15,35,42,77,P,8,12019,Regular
4JN18CS027,18PHYL16,25,12,37,F,0,12019,Regular
4JN18CS027,18ELEL17,33,48,81,P,9,12019,Regular
4JN18CS027,18EGH18,25,29,54,P,6,12019,Regular
4JN18CS028,18MAT11,20,24,44,P,4,12019,Regular
4JN18CS028,18PHY12,23,27,50,P,6,12019,Regular
4JN18CS028,18ELE13,26,21,47,P,5,12019,Regular
4JN18CS028,18CIV14,22,21,43,P,4,12019,Regular
4JN18CS028,18EGDL15,38,21,59,P,6,12019,Regular
4JN18CS028,18PHYL16,35,38,73,P,8,12019,Regular
4JN18CS028,18ELEL17,35,30,65,P,7,12019,Regular
4JN18CS028,18EGH18,30,34,64,P,7,12019,Regular
4JN18CS029,18MAT11,32,24,56,P,6,12019,Regular
4JN18CS029,18PHY12,23,33,56,P,6,12019,Regular
4JN18CS029,18ELE13,26,29,55,P,6,12019,Regular
4JN18CS029,18CIV14,33,21,54,P,6,12019,Regular
4JN18CS029,18EGDL15,39,42,81,P,9,12019,Regular
4JN18CS029,18PHYL16,29,38,67,P,7,12019,Regular
4JN18CS029,18ELEL17,36,47,83,P,9,12019,Regular
4JN18CS029,18EGH18,25,26,51,P,6,12019,Regular
4JN18CS030,18MAT11,39,46,85,P,9,12019,Regular
4JN18CS030,18PHY12,35,39,74,P,8,12019,Regular
4JN18CS030,18ELE13,40,42,82,P,9,12019,Regular
4JN18CS030,18CIV14,39,42,81,P,9,12019,Regular
4JN18CS030,18EGDL15,39,48,87,P,9,12019,Regular
4JN18CS030,18PHYL16,36,51,87,P,9,12019,Regular
4JN18CS030,18ELEL17,38,57,95,P,10,12019,Regular
4JN18CS030,18EGH18,34,38,72,P,8,12019,Regular
4JN18CS031,18MAT11,40,55,95,P,10,12019,Regular
4JN18CS031,18PHY12,35,47,82,P,9,12019,Regular
4JN18CS031,18ELE13,39,51,90,P,10,12019,Regular
4JN18CS031,18CIV14,35,30,65,P,7,12019,Regular
4JN18CS031,18EGDL15,38,49,87,P,9,12019,Regular
4JN18CS031,18PHYL16,35,51,86,P,9,12019,Regular
4JN18CS031,18ELEL17,35,58,93,P,10,12019,Regular
4JN18CS031,18EGH18,29,35,64,P,7,12019,Regular
4JN18CS032,18MAT11,40,58,98,P,10,12019,Regular
4JN18CS032,18PHY12,37,53,90,P,10,12019,Regular
4JN18CS032,18ELE13,32,44,76,P,8,12019,Regular
4JN18CS032,18CIV14,39,34,73,P,8,12019,Regular
4JN18CS032,18EGDL15,39,42,81,P,9,12019,Regular
4JN18CS032,18PHYL16,33,54,87,P,9,12019,Regular
4JN18CS032,18ELEL17,32,56,88,P,9,12019,Regular
4JN18CS032,18EGH18,32,41,73,P,8,12019,Regular
4JN18CS033,18MAT11,35,38,73,P,8,12019,Regular
4JN18CS033,18PHY12,25,32,57,P,6,12019,Regular
4JN18CS033,18ELE13,24,21,45,P,5,12019,Regular
4JN18CS033,18CIV14,31,26,57,P,6,12019,Regular
4JN18CS033,18EGDL15,39,29,68,P,7,12019,Regular
4JN18CS033,18PHYL16,31,48,79,P,8,12019,Regular
4JN18CS033,18ELEL17,32,50,82,P,9,12019,Regular
4JN18CS033,18EGH18,26,32,58,P,6,12019,Regular
4JN18CS034,18MAT11,34,51,85,P,9,12019,Regular
4JN18CS034,18PHY12,34,45,79,P,8,12019,Regular
4JN18CS034,18ELE13,38,30,68,P,7,12019,Regular
4JN18CS034,18CIV14,37,29,66,P,7,12019,Regular
4JN18CS034,18EGDL15,38,29,67,P,7,12019,Regular
4JN18CS034,18PHYL16,36,48,84,P,9,12019,Regular
4JN18CS034,18ELEL17,38,58,96,P,10,12019,Regular
4JN18CS034,18EGH18,33,41,74,P,8,12019,Regular
4JN18CS035,18MAT11,23,30,53,P,6,12019,Regular
4JN18CS035,18PHY12,19,21,40,P,4,12019,Regular
4JN18CS035,18ELE13,22,15,37,F,0,12019,Regular
4JN18CS035,18CIV14,22,21,43,P,4,12019,Regular
4JN18CS035,18EGDL15,38,30,68,P,7,12019,Regular
4JN18CS035,18PHYL16,30,48,78,P,8,12019,Regular
4JN18CS035,18ELEL17,36,48,84,P,9,12019,Regular
4JN18CS035,18EGH18,31,35,66,P,7,12019,Regular
4JN18CS036,18MAT11,32,42,74,P,8,12019,Regular
4JN18CS036,18PHY12,33,43,76,P,8,12019,Regular
4JN18CS036,18ELE13,28,29,57,P,6,12019,Regular
4JN18CS036,18CIV14,37,27,64,P,7,12019,Regular
4JN18CS036,18EGDL15,39,39,78,P,8,12019,Regular
4JN18CS036,18PHYL16,34,53,87,P,9,12019,Regular
4JN18CS036,18ELEL17,36,45,81,P,9,12019,Regular
4JN18CS036,18EGH18,32,45,77,P,8,12019,Regular
4JN18CS037,18MAT11,36,56,92,P,10,12019,Regular
4JN18CS037,18PHY12,36,50,86,P,9,12019,Regular
4JN18CS037,18ELE13,26,41,67,P,7,12019,Regular
4JN18CS037,18CIV14,35,27,62,P,7,12019,Regular
4JN18CS037,18EGDL15,39,47,86,P,9,12019,Regular
4JN18CS037,18PHYL16,33,49,82,P,9,12019,Regular
4JN18CS037,18ELEL17,36,53,89,P,9,12019,Regular
4JN18CS037,18EGH18,31,42,73,P,8,12019,Regular
4JN18CS038,18MAT11,32,32,64,P,7,12019,Regular
4JN18CS038,18PHY12,25,37,62,P,7,12019,Regular
4JN18CS038,18ELE13,28,21,49,P,5,12019,Regular
4JN18CS038,18CIV14,30,22,52,P,6,12019,Regular
4JN18CS038,18EGDL15,39,51,90,P,10,12019,Regular
4JN18CS038,18PHYL16,29,38,67,P,7,12019,Regular
4JN18CS038,18ELEL17,32,57,89,P,9,12019,Regular
4JN18CS038,18EGH18,28,42,70,P,8,12019,Regular
4JN18CS039,18MAT11,20,1,21,F,0,12019,Regular
4JN18CS039,18PHY12,16,5,21,F,0,12019,Regular
4JN18CS039,18ELE13,20,5,25,F,0,12019,Regular
4JN18CS039,18CIV14,21,13,34,F,0,12019,Regular
4JN18CS039,18EGDL15,33,9,42,F,0,12019,Regular
4JN18CS039,18PHYL16,27,17,44,F,0,12019,Regular
4JN18CS039,18ELEL17,30,27,57,P,6,12019,Regular
4JN18CS039,18EGH18,31,30,61,P,7,12019,Regular
4JN18CS040,18MAT11,27,27,54,P,6,12019,Regular
4JN18CS040,18PHY12,22,29,51,P,6,12019,Regular
4JN18CS040,18ELE13,29,9,38,F,0,12019,Regular
4JN18CS040,18CIV14,27,22,49,P,5,12019,Regular
4JN18CS040,18EGDL15,37,39,76,P,8,12019,Regular
4JN18CS040,18PHYL16,25,32,57,P,6,12019,Regular
4JN18CS040,18ELEL17,32,53,85,P,9,12019,Regular
4JN18CS040,18EGH18,32,26,58,P,6,12019,Regular
4JN18CS041,18MAT11,30,13,43,F,0,12019,Regular
4JN18CS041,18PHY12,16,26,42,P,4,12019,Regular
4JN18CS041,18ELE13,18,13,31,F,0,12019,Regular
4JN18CS041,18CIV14,26,15,41,F,0,12019,Regular
4JN18CS041,18EGDL15,32,4,36,F,0,12019,Regular
4JN18CS041,18PHYL16,27,24,51,P,6,12019,Regular
4JN18CS041,18ELEL17,32,24,56,P,6,12019,Regular
4JN18CS041,18EGH18,21,28,49,P,5,12019,Regular
4JN18CS042,18MAT11,39,57,96,P,10,12019,Regular
4JN18CS042,18PHY12,35,53,88,P,9,12019,Regular
4JN18CS042,18ELE13,35,43,78,P,8,12019,Regular
4JN18CS042,18CIV14,37,29,66,P,7,12019,Regular
4JN18CS042,18EGDL15,39,49,88,P,9,12019,Regular
4JN18CS042,18PHYL16,33,35,68,P,7,12019,Regular
4JN18CS042,18ELEL17,34,52,86,P,9,12019,Regular
4JN18CS042,18EGH18,29,38,67,P,7,12019,Regular
4JN18CS043,18MAT11,28,39,67,P,7,12019,Regular
4JN18CS043,18PHY12,24,37,61,P,7,12019,Regular
4JN18CS043,18ELE13,26,25,51,P,6,12019,Regular
4JN18CS043,18CIV14,29,23,52,P,6,12019,Regular
4JN18CS043,18EGDL15,39,42,81,P,9,12019,Regular
4JN18CS043,18PHYL16,31,32,63,P,7,12019,Regular
4JN18CS043,18ELEL17,34,48,82,P,9,12019,Regular
4JN18CS043,18EGH18,28,28,56,P,6,12019,Regular
4JN18CS044,18MAT11,36,46,82,P,9,12019,Regular
4JN18CS044,18PHY12,35,43,78,P,8,12019,Regular
4JN18CS044,18ELE13,39,41,80,P,9,12019,Regular
4JN18CS044,18CIV14,32,30,62,P,7,12019,Regular
4JN18CS044,18EGDL15,38,11,49,F,0,12019,Regular
4JN18CS044,18PHYL16,31,46,77,P,8,12019,Regular
4JN18CS044,18ELEL17,36,54,90,P,10,12019,Regular
4JN18CS044,18EGH18,32,31,63,P,7,12019,Regular
4JN18CS045,18MAT11,33,37,70,P,8,12019,Regular
4JN18CS045,18PHY12,25,29,54,P,6,12019,Regular
4JN18CS045,18ELE13,20,21,41,P,4,12019,Regular
4JN18CS045,18CIV14,37,27,64,P,7,12019,Regular
4JN18CS045,18EGDL15,37,42,79,P,8,12019,Regular
4JN18CS045,18PHYL16,35,50,85,P,9,12019,Regular
4JN18CS045,18ELEL17,35,55,90,P,10,12019,Regular
4JN18CS045,18EGH18,29,37,66,P,7,12019,Regular
4JN18CS046,18MAT11,38,59,97,P,10,12019,Regular
4JN18CS046,18PHY12,33,46,79,P,8,12019,Regular
4JN18CS046,18ELE13,38,41,79,P,8,12019,Regular
4JN18CS046,18CIV14,32,36,68,P,7,12019,Regular
4JN18CS046,18EGDL15,38,15,53,F,0,12019,Regular
4JN18CS046,18PHYL16,31,33,64,P,7,12019,Regular
4JN18CS046,18ELEL17,35,24,59,P,6,12019,Regular
4JN18CS046,18EGH18,31,33,64,P,7,12019,Regular
4JN18CS047,18MAT11,19,15,34,F,0,12019,Regular
4JN18CS047,18PHY12,16,24,40,P,4,12019,Regular
4JN18CS047,18ELE13,16,12,28,F,0,12019,Regular
4JN18CS047,18CIV14,23,9,32,F,0,12019,Regular
4JN18CS047,18EGDL15,39,10,49,F,0,12019,Regular
4JN18CS047,18PHYL16,30,18,48,F,0,12019,Regular
4JN18CS047,18ELEL17,32,39,71,P,8,12019,Regular
4JN18CS047,18EGH18,26,36,62,P,7,12019,Regular
4JN18CS048,18MAT11,28,35,63,P,7,12019,Regular
4JN18CS048,18PHY12,26,41,67,P,7,12019,Regular
4JN18CS048,18ELE13,24,21,45,P,5,12019,Regular
4JN18CS048,18CIV14,33,23,56,P,6,12019,Regular
4JN18CS048,18EGDL15,39,41,80,P,9,12019,Regular
4JN18CS048,18PHYL16,31,38,69,P,7,12019,Regular
4JN18CS048,18ELEL17,34,54,88,P,9,12019,Regular
4JN18CS048,18EGH18,30,38,68,P,7,12019,Regular
4JN18CS049,18MAT11,33,39,72,P,8,12019,Regular
4JN18CS049,18PHY12,21,32,53,P,6,12019,Regular
4JN18CS049,18ELE13,25,33,58,P,6,12019,Regular
4JN18CS049,18CIV14,31,21,52,P,6,12019,Regular
4JN18CS049,18EGDL15,39,45,84,P,9,12019,Regular
4JN18CS049,18PHYL16,34,54,88,P,9,12019,Regular
4JN18CS049,18ELEL17,33,50,83,P,9,12019,Regular
4JN18CS049,18EGH18,32,36,68,P,7,12019,Regular
4JN18CS050,18MAT11,28,30,58,P,6,12019,Regular
4JN18CS050,18PHY12,22,21,43,P,4,12019,Regular
4JN18CS050,18ELE13,18,11,29,F,0,12019,Regular
4JN18CS050,18CIV14,29,21,50,P,6,12019,Regular
4JN18CS050,18EGDL15,39,47,86,P,9,12019,Regular
4JN18CS050,18PHYL16,34,38,72,P,8,12019,Regular
4JN18CS050,18ELEL17,32,51,83,P,9,12019,Regular
4JN18CS050,18EGH18,23,26,49,P,5,12019,Regular
4JN18CS051,18MAT11,32,30,62,P,7,12019,Regular
4JN18CS051,18PHY12,26,31,57,P,6,12019,Regular
4JN18CS051,18ELE13,30,21,51,P,6,12019,Regular
4JN18CS051,18CIV14,32,21,53,P,6,12019,Regular
4JN18CS051,18EGDL15,30,42,72,P,8,12019,Regular
4JN18CS051,18PHYL16,35,44,79,P,8,12019,Regular
4JN18CS051,18ELEL17,34,50,84,P,9,12019,Regular
4JN18CS051,18EGH18,31,33,64,P,7,12019,Regular
4JN18CS052,18MAT11,38,47,85,P,9,12019,Regular
4JN18CS052,18PHY12,29,48,77,P,8,12019,Regular
4JN18CS052,18ELE13,28,27,55,P,6,12019,Regular
4JN18CS052,18CIV14,38,21,59,P,6,12019,Regular
4JN18CS052,18EGDL15,39,59,98,P,10,12019,Regular
4JN18CS052,18PHYL16,35,37,72,P,8,12019,Regular
4JN18CS052,18ELEL17,33,50,83,P,9,12019,Regular
4JN18CS052,18EGH18,28,39,67,P,7,12019,Regular
4JN18CS053,18MAT11,36,60,96,P,10,12019,Regular
4JN18CS053,18PHY12,27,44,71,P,8,12019,Regular
4JN18CS053,18ELE13,36,48,84,P,9,12019,Regular
4JN18CS053,18CIV14,36,21,57,P,6,12019,Regular
4JN18CS053,18EGDL15,35,47,82,P,9,12019,Regular
4JN18CS053,18PHYL16,32,42,74,P,8,12019,Regular
4JN18CS053,18ELEL17,34,53,87,P,9,12019,Regular
4JN18CS053,18EGH18,30,43,73,P,8,12019,Regular
4JN18CS054,18MAT11,37,55,92,P,10,12019,Regular
4JN18CS054,18PHY12,26,23,49,P,5,12019,Regular
4JN18CS054,18ELE13,34,27,61,P,7,12019,Regular
4JN18CS054,18CIV14,38,31,69,P,7,12019,Regular
4JN18CS054,18EGDL15,40,57,97,P,10,12019,Regular
4JN18CS054,18PHYL16,33,46,79,P,8,12019,Regular
4JN18CS054,18ELEL17,35,53,88,P,9,12019,Regular
4JN18CS054,18EGH18,32,36,68,P,7,12019,Regular
4JN18CS055,18MAT11,36,48,84,P,9,12019,Regular
4JN18CS055,18PHY12,23,33,56,P,6,12019,Regular
4JN18CS055,18ELE13,29,34,63,P,7,12019,Regular
4JN18CS055,18CIV14,38,30,68,P,7,12019,Regular
4JN18CS055,18EGDL15,32,32,64,P,7,12019,Regular
4JN18CS055,18PHYL16,36,36,72,P,8,12019,Regular
4JN18CS055,18ELEL17,27,50,77,P,8,12019,Regular
4JN18CS055,18EGH18,30,33,63,P,7,12019,Regular
4JN18CS056,18MAT11,40,59,99,P,10,12019,Regular
4JN18CS056,18PHY12,37,53,90,P,10,12019,Regular
4JN18CS056,18ELE13,36,41,77,P,8,12019,Regular
4JN18CS056,18CIV14,40,32,72,P,8,12019,Regular
4JN18CS056,18EGDL15,39,57,96,P,10,12019,Regular
4JN18CS056,18PHYL16,36,51,87,P,9,12019,Regular
4JN18CS056,18ELEL17,35,54,89,P,9,12019,Regular
4JN18CS056,18EGH18,33,44,77,P,8,12019,Regular
4JN18CS057,18MAT11,37,56,93,P,10,12019,Regular
4JN18CS057,18PHY12,23,27,50,P,6,12019,Regular
4JN18CS057,18ELE13,32,27,59,P,6,12019,Regular
4JN18CS057,18CIV14,36,21,57,P,6,12019,Regular
4JN18CS057,18EGDL15,38,42,80,P,9,12019,Regular
4JN18CS057,18PHYL16,32,42,74,P,8,12019,Regular
4JN18CS057,18ELEL17,35,51,86,P,9,12019,Regular
4JN18CS057,18EGH18,33,42,75,P,8,12019,Regular
4JN18CS058,18MAT11,39,49,88,P,9,12019,Regular
4JN18CS058,18PHY12,34,44,78,P,8,12019,Regular
4JN18CS058,18ELE13,38,38,76,P,8,12019,Regular
4JN18CS058,18CIV14,38,26,64,P,7,12019,Regular
4JN18CS058,18EGDL15,39,47,86,P,9,12019,Regular
4JN18CS058,18PHYL16,36,38,74,P,8,12019,Regular
4JN18CS058,18ELEL17,34,51,85,P,9,12019,Regular
4JN18CS058,18EGH18,33,36,69,P,7,12019,Regular
4JN18CS059,18MAT11,34,33,67,P,7,12019,Regular
4JN18CS059,18PHY12,30,37,67,P,7,12019,Regular
4JN18CS059,18ELE13,23,28,51,P,6,12019,Regular
4JN18CS059,18CIV14,36,24,60,P,7,12019,Regular
4JN18CS059,18EGDL15,39,55,94,P,10,12019,Regular
4JN18CS059,18PHYL16,33,28,61,P,7,12019,Regular
4JN18CS059,18ELEL17,32,51,83,P,9,12019,Regular
4JN18CS059,18EGH18,30,33,63,P,7,12019,Regular
4JN18CS060,18MAT11,38,49,87,P,9,12019,Regular
4JN18CS060,18PHY12,38,46,84,P,9,12019,Regular
4JN18CS060,18ELE13,36,24,60,P,7,12019,Regular
4JN18CS060,18CIV14,40,29,69,P,7,12019,Regular
4JN18CS060,18EGDL15,39,40,79,P,8,12019,Regular
4JN18CS060,18PHYL16,33,48,81,P,9,12019,Regular
4JN18CS060,18ELEL17,34,54,88,P,9,12019,Regular
4JN18CS060,18EGH18,33,42,75,P,8,12019,Regular
4JN18CS061,18MAT11,38,29,67,P,7,12019,Regular
4JN18CS061,18PHY12,33,44,77,P,8,12019,Regular
4JN18CS061,18ELE13,32,33,65,P,7,12019,Regular
4JN18CS061,18CIV14,36,25,61,P,7,12019,Regular
4JN18CS061,18EGDL15,39,44,83,P,9,12019,Regular
4JN18CS061,18PHYL16,31,44,75,P,8,12019,Regular
4JN18CS061,18ELEL17,36,45,81,P,9,12019,Regular
4JN18CS061,18EGH18,30,39,69,P,7,12019,Regular
4JN18CS062,18MAT11,35,36,71,P,8,12019,Regular
4JN18CS062,18PHY12,27,36,63,P,7,12019,Regular
4JN18CS062,18ELE13,26,24,50,P,6,12019,Regular
4JN18CS062,18CIV14,35,26,61,P,7,12019,Regular
4JN18CS062,18EGDL15,39,47,86,P,9,12019,Regular
4JN18CS062,18PHYL16,35,51,86,P,9,12019,Regular
4JN18CS062,18ELEL17,36,57,93,P,10,12019,Regular
4JN18CS062,18EGH18,31,41,72,P,8,12019,Regular
4JN18CS063,18MAT11,28,24,52,P,6,12019,Regular
4JN18CS063,18PHY12,20,22,42,P,4,12019,Regular
4JN18CS063,18ELE13,28,24,52,P,6,12019,Regular
4JN18CS063,18CIV14,32,21,53,P,6,12019,Regular
4JN18CS063,18EGDL15,37,21,58,P,6,12019,Regular
4JN18CS063,18PHYL16,32,29,61,P,7,12019,Regular
4JN18CS063,18ELEL17,34,29,63,P,7,12019,Regular
4JN18CS063,18EGH18,24,30,54,P,6,12019,Regular
4JN18CS064,18MAT11,37,51,88,P,9,12019,Regular
4JN18CS064,18PHY12,29,45,74,P,8,12019,Regular
4JN18CS064,18ELE13,28,42,70,P,8,12019,Regular
4JN18CS064,18CIV14,32,35,67,P,7,12019,Regular
4JN18CS064,18EGDL15,39,48,87,P,9,12019,Regular
4JN18CS064,18PHYL16,35,41,76,P,8,12019,Regular
4JN18CS064,18ELEL17,36,46,82,P,9,12019,Regular
4JN18CS064,18EGH18,27,37,64,P,7,12019,Regular
4JN18CS065,18MAT11,30,50,80,P,9,12019,Regular
4JN18CS065,18PHY12,25,27,52,P,6,12019,Regular
4JN18CS065,18ELE13,26,24,50,P,6,12019,Regular
4JN18CS065,18CIV14,36,28,64,P,7,12019,Regular
4JN18CS065,18EGDL15,39,48,87,P,9,12019,Regular
4JN18CS065,18PHYL16,31,51,82,P,9,12019,Regular
4JN18CS065,18ELEL17,35,52,87,P,9,12019,Regular
4JN18CS065,18EGH18,29,33,62,P,7,12019,Regular
4JN18CS066,18MAT11,39,39,78,P,8,12019,Regular
4JN18CS066,18PHY12,32,33,65,P,7,12019,Regular
4JN18CS066,18ELE13,32,27,59,P,6,12019,Regular
4JN18CS066,18CIV14,39,41,80,P,9,12019,Regular
4JN18CS066,18EGDL15,39,48,87,P,9,12019,Regular
4JN18CS066,18PHYL16,31,48,79,P,8,12019,Regular
4JN18CS066,18ELEL17,35,56,91,P,10,12019,Regular
4JN18CS066,18EGH18,35,50,85,P,9,12019,Regular
4JN18CS067,18MAT11,31,24,55,P,6,12019,Regular
4JN18CS067,18PHY12,25,25,50,P,6,12019,Regular
4JN18CS067,18ELE13,32,45,77,P,8,12019,Regular
4JN18CS067,18CIV14,27,25,52,P,6,12019,Regular
4JN18CS067,18EGDL15,37,47,84,P,9,12019,Regular
4JN18CS067,18PHYL16,30,45,75,P,8,12019,Regular
4JN18CS067,18ELEL17,35,52,87,P,9,12019,Regular
4JN18CS067,18EGH18,30,24,54,P,6,12019,Regular
4JN18CS068,18MAT11,33,57,90,P,10,12019,Regular
4JN18CS068,18PHY12,32,51,83,P,9,12019,Regular
4JN18CS068,18ELE13,39,36,75,P,8,12019,Regular
4JN18CS068,18CIV14,39,33,72,P,8,12019,Regular
4JN18CS068,18EGDL15,38,48,86,P,9,12019,Regular
4JN18CS068,18PHYL16,35,45,80,P,9,12019,Regular
4JN18CS068,18ELEL17,35,48,83,P,9,12019,Regular
4JN18CS068,18EGH18,33,31,64,P,7,12019,Regular
4JN18CS069,18MAT11,28,35,63,P,7,12019,Regular
4JN18CS069,18PHY12,25,18,43,F,0,12019,Regular
4JN18CS069,18ELE13,26,14,40,F,0,12019,Regular
4JN18CS069,18CIV14,25,25,50,P,6,12019,Regular
4JN18CS069,18EGDL15,37,54,91,P,10,12019,Regular
4JN18CS069,18PHYL16,31,30,61,P,7,12019,Regular
4JN18CS069,18ELEL17,35,51,86,P,9,12019,Regular
4JN18CS069,18EGH18,27,38,65,P,7,12019,Regular
4JN18CS070,18MAT11,40,56,96,P,10,12019,Regular
4JN18CS070,18PHY12,33,43,76,P,8,12019,Regular
4JN18CS070,18ELE13,34,39,73,P,8,12019,Regular
4JN18CS070,18CIV14,39,45,84,P,9,12019,Regular
4JN18CS070,18EGDL15,39,54,93,P,10,12019,Regular
4JN18CS070,18PHYL16,35,45,80,P,9,12019,Regular
4JN18CS070,18ELEL17,34,53,87,P,9,12019,Regular
4JN18CS070,18EGH18,31,39,70,P,8,12019,Regular
4JN18CS071,18MAT11,36,57,93,P,10,12019,Regular
4JN18CS071,18PHY12,23,43,66,P,7,12019,Regular
4JN18CS071,18ELE13,36,31,67,P,7,12019,Regular
4JN18CS071,18CIV14,36,21,57,P,6,12019,Regular
4JN18CS071,18EGDL15,39,36,75,P,8,12019,Regular
4JN18CS071,18PHYL16,34,45,79,P,8,12019,Regular
4JN18CS071,18ELEL17,34,49,83,P,9,12019,Regular
4JN18CS071,18EGH18,31,35,66,P,7,12019,Regular
4JN18CS072,18MAT11,36,35,71,P,8,12019,Regular
4JN18CS072,18PHY12,32,45,77,P,8,12019,Regular
4JN18CS072,18ELE13,37,42,79,P,8,12019,Regular
4JN18CS072,18CIV14,40,33,73,P,8,12019,Regular
4JN18CS072,18EGDL15,37,50,87,P,9,12019,Regular
4JN18CS072,18PHYL16,31,53,84,P,9,12019,Regular
4JN18CS072,18ELEL17,37,53,90,P,10,12019,Regular
4JN18CS072,18EGH18,34,37,71,P,8,12019,Regular
4JN18CS073,18MAT11,40,59,99,P,10,12019,Regular
4JN18CS073,18PHY12,33,48,81,P,9,12019,Regular
4JN18CS073,18ELE13,39,46,85,P,9,12019,Regular
4JN18CS073,18CIV14,39,36,75,P,8,12019,Regular
4JN18CS073,18EGDL15,32,52,84,P,9,12019,Regular
4JN18CS073,18PHYL16,36,51,87,P,9,12019,Regular
4JN18CS073,18ELEL17,34,56,90,P,10,12019,Regular
4JN18CS073,18EGH18,34,35,69,P,7,12019,Regular
4JN18CS074,18MAT11,39,45,84,P,9,12019,Regular
4JN18CS074,18PHY12,29,39,68,P,7,12019,Regular
4JN18CS074,18ELE13,38,34,72,P,8,12019,Regular
4JN18CS074,18CIV14,37,28,65,P,7,12019,Regular
4JN18CS074,18EGDL15,37,45,82,P,9,12019,Regular
4JN18CS074,18PHYL16,34,46,80,P,9,12019,Regular
4JN18CS074,18ELEL17,33,51,84,P,9,12019,Regular
4JN18CS074,18EGH18,32,39,71,P,8,12019,Regular
4JN18CS075,18MAT11,36,53,89,P,9,12019,Regular
4JN18CS075,18PHY12,23,40,63,P,7,12019,Regular
4JN18CS075,18ELE13,31,36,67,P,7,12019,Regular
4JN18CS075,18CIV14,40,28,68,P,7,12019,Regular
4JN18CS075,18EGDL15,37,44,81,P,9,12019,Regular
4JN18CS075,18PHYL16,28,49,77,P,8,12019,Regular
4JN18CS075,18ELEL17,33,45,78,P,8,12019,Regular
4JN18CS075,18EGH18,32,35,67,P,7,12019,Regular
4JN18CS076,18MAT11,40,53,93,P,10,12019,Regular
4JN18CS076,18PHY12,33,49,82,P,9,12019,Regular
4JN18CS076,18ELE13,30,38,68,P,7,12019,Regular
4JN18CS076,18CIV14,39,34,73,P,8,12019,Regular
4JN18CS076,18EGDL15,39,50,89,P,9,12019,Regular
4JN18CS076,18PHYL16,35,38,73,P,8,12019,Regular
4JN18CS076,18ELEL17,34,56,90,P,10,12019,Regular
4JN18CS076,18EGH18,25,33,58,P,6,12019,Regular
4JN18CS077,18MAT11,29,50,79,P,8,12019,Regular
4JN18CS077,18PHY12,21,26,47,P,5,12019,Regular
4JN18CS077,18ELE13,29,28,57,P,6,12019,Regular
4JN18CS077,18CIV14,33,24,57,P,6,12019,Regular
4JN18CS077,18EGDL15,30,30,60,P,7,12019,Regular
4JN18CS077,18PHYL16,31,33,64,P,7,12019,Regular
4JN18CS077,18ELEL17,33,44,77,P,8,12019,Regular
4JN18CS077,18EGH18,30,24,54,P,6,12019,Regular
4JN18CS079,18MAT11,39,45,84,P,9,12019,Regular
4JN18CS079,18PHY12,32,35,67,P,7,12019,Regular
4JN18CS079,18ELE13,36,37,73,P,8,12019,Regular
4JN18CS079,18CIV14,40,33,73,P,8,12019,Regular
4JN18CS079,18EGDL15,35,54,89,P,9,12019,Regular
4JN18CS079,18PHYL16,31,42,73,P,8,12019,Regular
4JN18CS079,18ELEL17,38,52,90,P,10,12019,Regular
4JN18CS079,18EGH18,31,37,68,P,7,12019,Regular
4JN18CS080,18MAT11,36,48,84,P,9,12019,Regular
4JN18CS080,18PHY12,17,27,44,P,4,12019,Regular
4JN18CS080,18ELE13,29,26,55,P,6,12019,Regular
4JN18CS080,18CIV14,30,21,51,P,6,12019,Regular
4JN18CS080,18EGDL15,35,36,71,P,8,12019,Regular
4JN18CS080,18PHYL16,29,37,66,P,7,12019,Regular
4JN18CS080,18ELEL17,27,45,72,P,8,12019,Regular
4JN18CS080,18EGH18,31,39,70,P,8,12019,Regular
4JN18CS081,18MAT11,38,43,81,P,9,12019,Regular
4JN18CS081,18PHY12,27,47,74,P,8,12019,Regular
4JN18CS081,18ELE13,36,38,74,P,8,12019,Regular
4JN18CS081,18CIV14,39,28,67,P,7,12019,Regular
4JN18CS081,18EGDL15,37,51,88,P,9,12019,Regular
4JN18CS081,18PHYL16,35,41,76,P,8,12019,Regular
4JN18CS081,18ELEL17,35,56,91,P,10,12019,Regular
4JN18CS081,18EGH18,34,42,76,P,8,12019,Regular
4JN18CS082,18MAT11,21,21,42,P,4,12019,Regular
4JN18CS082,18PHY12,16,7,23,F,0,12019,Regular
4JN18CS082,18ELE13,23,14,37,F,0,12019,Regular
4JN18CS082,18CIV14,24,10,34,F,0,12019,Regular
4JN18CS082,18EGDL15,34,32,66,P,7,12019,Regular
4JN18CS082,18PHYL16,31,24,55,P,6,12019,Regular
4JN18CS082,18ELEL17,34,57,91,P,10,12019,Regular
4JN18CS082,18EGH18,28,24,52,P,6,12019,Regular
4JN18CS083,18MAT11,34,54,88,P,9,12019,Regular
4JN18CS083,18PHY12,35,57,92,P,10,12019,Regular
4JN18CS083,18ELE13,37,38,75,P,8,12019,Regular
4JN18CS083,18CIV14,38,34,72,P,8,12019,Regular
4JN18CS083,18EGDL15,40,52,92,P,10,12019,Regular
4JN18CS083,18PHYL16,37,41,78,P,8,12019,Regular
4JN18CS083,18ELEL17,34,55,89,P,9,12019,Regular
4JN18CS083,18EGH18,32,45,77,P,8,12019,Regular
4JN18CS084,18MAT11,40,58,98,P,10,12019,Regular
4JN18CS084,18PHY12,37,56,93,P,10,12019,Regular
4JN18CS084,18ELE13,35,53,88,P,9,12019,Regular
4JN18CS084,18CIV14,40,35,75,P,8,12019,Regular
4JN18CS084,18EGDL15,38,46,84,P,9,12019,Regular
4JN18CS084,18PHYL16,35,40,75,P,8,12019,Regular
4JN18CS084,18ELEL17,36,54,90,P,10,12019,Regular
4JN18CS084,18EGH18,32,36,68,P,7,12019,Regular
4JN18CS085,18MAT11,26,50,76,P,8,12019,Regular
4JN18CS085,18PHY12,25,35,60,P,7,12019,Regular
4JN18CS085,18ELE13,34,23,57,P,6,12019,Regular
4JN18CS085,18CIV14,34,23,57,P,6,12019,Regular
4JN18CS085,18EGDL15,40,47,87,P,9,12019,Regular
4JN18CS085,18PHYL16,31,34,65,P,7,12019,Regular
4JN18CS085,18ELEL17,34,55,89,P,9,12019,Regular
4JN18CS085,18EGH18,31,34,65,P,7,12019,Regular
4JN18CS086,18MAT11,40,50,90,P,10,12019,Regular
4JN18CS086,18PHY12,33,41,74,P,8,12019,Regular
4JN18CS086,18ELE13,38,46,84,P,9,12019,Regular
4JN18CS086,18CIV14,37,40,77,P,8,12019,Regular
4JN18CS086,18EGDL15,40,55,95,P,10,12019,Regular
4JN18CS086,18PHYL16,32,32,64,P,7,12019,Regular
4JN18CS086,18ELEL17,35,54,89,P,9,12019,Regular
4JN18CS086,18EGH18,34,44,78,P,8,12019,Regular
4JN18CS087,18MAT11,28,27,55,P,6,12019,Regular
4JN18CS087,18PHY12,16,15,31,F,0,12019,Regular
4JN18CS087,18ELE13,26,24,50,P,6,12019,Regular
4JN18CS087,18CIV14,33,26,59,P,6,12019,Regular
4JN18CS087,18EGDL15,38,56,94,P,10,12019,Regular
4JN18CS087,18PHYL16,28,43,71,P,8,12019,Regular
4JN18CS087,18ELEL17,35,54,89,P,9,12019,Regular
4JN18CS087,18EGH18,28,28,56,P,6,12019,Regular
4JN18CS088,18MAT11,38,60,98,P,10,12019,Regular
4JN18CS088,18PHY12,27,40,67,P,7,12019,Regular
4JN18CS088,18ELE13,24,38,62,P,7,12019,Regular
4JN18CS088,18CIV14,31,27,58,P,6,12019,Regular
4JN18CS088,18EGDL15,37,53,90,P,10,12019,Regular
4JN18CS088,18PHYL16,35,52,87,P,9,12019,Regular
4JN18CS088,18ELEL17,34,55,89,P,9,12019,Regular
4JN18CS088,18EGH18,31,48,79,P,8,12019,Regular
4JN18CS089,18MAT11,39,47,86,P,9,12019,Regular
4JN18CS089,18PHY12,25,44,69,P,7,12019,Regular
4JN18CS089,18ELE13,37,48,85,P,9,12019,Regular
4JN18CS089,18CIV14,30,29,59,P,6,12019,Regular
4JN18CS089,18EGDL15,36,50,86,P,9,12019,Regular
4JN18CS089,18PHYL16,33,52,85,P,9,12019,Regular
4JN18CS089,18ELEL17,35,54,89,P,9,12019,Regular
4JN18CS089,18EGH18,32,39,71,P,8,12019,Regular
4JN18CS090,18MAT11,20,26,46,P,5,12019,Regular
4JN18CS090,18PHY12,16,6,22,F,0,12019,Regular
4JN18CS090,18ELE13,19,15,34,F,0,12019,Regular
4JN18CS090,18CIV14,25,14,39,F,0,12019,Regular
4JN18CS090,18EGDL15,37,29,66,P,7,12019,Regular
4JN18CS090,18PHYL16,20,36,56,P,6,12019,Regular
4JN18CS090,18ELEL17,34,50,84,P,9,12019,Regular
4JN18CS090,18EGH18,30,32,62,P,7,12019,Regular
4JN18CS091,18MAT11,26,51,77,P,8,12019,Regular
4JN18CS091,18PHY12,28,41,69,P,7,12019,Regular
4JN18CS091,18ELE13,32,30,62,P,7,12019,Regular
4JN18CS091,18CIV14,38,26,64,P,7,12019,Regular
4JN18CS091,18EGDL15,36,52,88,P,9,12019,Regular
4JN18CS091,18PHYL16,32,28,60,P,7,12019,Regular
4JN18CS091,18ELEL17,34,56,90,P,10,12019,Regular
4JN18CS091,18EGH18,29,36,65,P,7,12019,Regular
4JN18CS092,18MAT11,40,59,99,P,10,12019,Regular
4JN18CS092,18PHY12,39,58,97,P,10,12019,Regular
4JN18CS092,18ELE13,40,57,97,P,10,12019,Regular
4JN18CS092,18CIV14,38,44,82,P,9,12019,Regular
4JN18CS092,18EGDL15,40,55,95,P,10,12019,Regular
4JN18CS092,18PHYL16,37,56,93,P,10,12019,Regular
4JN18CS092,18ELEL17,34,56,90,P,10,12019,Regular
4JN18CS092,18EGH18,35,47,82,P,9,12019,Regular
4JN18CS093,18MAT11,22,30,52,P,6,12019,Regular
4JN18CS093,18PHY12,24,30,54,P,6,12019,Regular
4JN18CS093,18ELE13,27,21,48,P,5,12019,Regular
4JN18CS093,18CIV14,28,23,51,P,6,12019,Regular
4JN18CS093,18EGDL15,32,33,65,P,7,12019,Regular
4JN18CS093,18PHYL16,32,33,65,P,7,12019,Regular
4JN18CS093,18ELEL17,34,52,86,P,9,12019,Regular
4JN18CS093,18EGH18,31,39,70,P,8,12019,Regular
4JN18CS094,18MAT11,31,34,65,P,7,12019,Regular
4JN18CS094,18PHY12,24,44,68,P,7,12019,Regular
4JN18CS094,18ELE13,25,21,46,P,5,12019,Regular
4JN18CS094,18CIV14,31,31,62,P,7,12019,Regular
4JN18CS094,18EGDL15,39,30,69,P,7,12019,Regular
4JN18CS094,18PHYL16,33,41,74,P,8,12019,Regular
4JN18CS094,18ELEL17,35,53,88,P,9,12019,Regular
4JN18CS094,18EGH18,28,37,65,P,7,12019,Regular
4JN18CS095,18MAT11,38,53,91,P,10,12019,Regular
4JN18CS095,18PHY12,32,49,81,P,9,12019,Regular
4JN18CS095,18ELE13,36,36,72,P,8,12019,Regular
4JN18CS095,18CIV14,39,31,70,P,8,12019,Regular
4JN18CS095,18EGDL15,40,51,91,P,10,12019,Regular
4JN18CS095,18PHYL16,35,54,89,P,9,12019,Regular
4JN18CS095,18ELEL17,34,54,88,P,9,12019,Regular
4JN18CS095,18EGH18,31,32,63,P,7,12019,Regular
4JN18CS096,18MAT11,40,52,92,P,10,12019,Regular
4JN18CS096,18PHY12,34,38,72,P,8,12019,Regular
4JN18CS096,18ELE13,35,26,61,P,7,12019,Regular
4JN18CS096,18CIV14,40,28,68,P,7,12019,Regular
4JN18CS096,18EGDL15,37,57,94,P,10,12019,Regular
4JN18CS096,18PHYL16,32,54,86,P,9,12019,Regular
4JN18CS096,18ELEL17,38,54,92,P,10,12019,Regular
4JN18CS096,18EGH18,34,44,78,P,8,12019,Regular
4JN18CS097,18MAT11,28,23,51,P,6,12019,Regular
4JN18CS097,18PHY12,28,25,53,P,6,12019,Regular
4JN18CS097,18ELE13,25,23,48,P,5,12019,Regular
4JN18CS097,18CIV14,37,23,60,P,7,12019,Regular
4JN18CS097,18EGDL15,36,53,89,P,9,12019,Regular
4JN18CS097,18PHYL16,30,39,69,P,7,12019,Regular
4JN18CS097,18ELEL17,35,55,90,P,10,12019,Regular
4JN18CS097,18EGH18,29,44,73,P,8,12019,Regular
4JN18CS098,18MAT11,39,57,96,P,10,12019,Regular
4JN18CS098,18PHY12,32,47,79,P,8,12019,Regular
4JN18CS098,18ELE13,27,38,65,P,7,12019,Regular
4JN18CS098,18CIV14,39,24,63,P,7,12019,Regular
4JN18CS098,18EGDL15,38,38,76,P,8,12019,Regular
4JN18CS098,18PHYL16,35,47,82,P,9,12019,Regular
4JN18CS098,18ELEL17,36,54,90,P,10,12019,Regular
4JN18CS098,18EGH18,30,39,69,P,7,12019,Regular
4JN18CS099,18MAT11,28,50,78,P,8,12019,Regular
4JN18CS099,18PHY12,28,36,64,P,7,12019,Regular
4JN18CS099,18ELE13,32,21,53,P,6,12019,Regular
4JN18CS099,18CIV14,31,21,52,P,6,12019,Regular
4JN18CS099,18EGDL15,34,33,67,P,7,12019,Regular
4JN18CS099,18PHYL16,32,36,68,P,7,12019,Regular
4JN18CS099,18ELEL17,34,53,87,P,9,12019,Regular
4JN18CS099,18EGH18,30,38,68,P,7,12019,Regular
4JN18CS100,18MAT11,36,49,85,P,9,12019,Regular
4JN18CS100,18PHY12,24,42,66,P,7,12019,Regular
4JN18CS100,18ELE13,34,41,75,P,8,12019,Regular
4JN18CS100,18CIV14,38,27,65,P,7,12019,Regular
4JN18CS100,18EGDL15,40,54,94,P,10,12019,Regular
4JN18CS100,18PHYL16,35,51,86,P,9,12019,Regular
4JN18CS100,18ELEL17,32,52,84,P,9,12019,Regular
4JN18CS100,18EGH18,29,35,64,P,7,12019,Regular
4JN18CS101,18MAT11,39,60,99,P,10,12019,Regular
4JN18CS101,18PHY12,23,21,44,P,4,12019,Regular
4JN18CS101,18ELE13,30,27,57,P,6,12019,Regular
4JN18CS101,18CIV14,36,35,71,P,8,12019,Regular
4JN18CS101,18EGDL15,34,49,83,P,9,12019,Regular
4JN18CS101,18PHYL16,28,38,66,P,7,12019,Regular
4JN18CS101,18ELEL17,34,54,88,P,9,12019,Regular
4JN18CS101,18EGH18,25,30,55,P,6,12019,Regular
4JN18CS102,18MAT11,39,42,81,P,9,12019,Regular
4JN18CS102,18PHY12,32,49,81,P,9,12019,Regular
4JN18CS102,18ELE13,32,45,77,P,8,12019,Regular
4JN18CS102,18CIV14,39,32,71,P,8,12019,Regular
4JN18CS102,18EGDL15,37,53,90,P,10,12019,Regular
4JN18CS102,18PHYL16,31,38,69,P,7,12019,Regular
4JN18CS102,18ELEL17,34,51,85,P,9,12019,Regular
4JN18CS102,18EGH18,31,43,74,P,8,12019,Regular
4JN18CS103,18MAT11,32,38,70,P,8,12019,Regular
4JN18CS103,18PHY12,31,47,78,P,8,12019,Regular
4JN18CS103,18ELE13,35,32,67,P,7,12019,Regular
4JN18CS103,18CIV14,33,23,56,P,6,12019,Regular
4JN18CS103,18EGDL15,36,39,75,P,8,12019,Regular
4JN18CS103,18PHYL16,35,51,86,P,9,12019,Regular
4JN18CS103,18ELEL17,35,56,91,P,10,12019,Regular
4JN18CS103,18EGH18,29,37,66,P,7,12019,Regular
4JN18CS104,18MAT11,39,58,97,P,10,12019,Regular
4JN18CS104,18PHY12,30,45,75,P,8,12019,Regular
4JN18CS104,18ELE13,39,47,86,P,9,12019,Regular
4JN18CS104,18CIV14,39,35,74,P,8,12019,Regular
4JN18CS104,18EGDL15,40,54,94,P,10,12019,Regular
4JN18CS104,18PHYL16,36,49,85,P,9,12019,Regular
4JN18CS104,18ELEL17,35,54,89,P,9,12019,Regular
4JN18CS104,18EGH18,32,40,72,P,8,12019,Regular
4JN18CS105,18MAT11,27,26,53,P,6,12019,Regular
4JN18CS105,18PHY12,21,21,42,P,4,12019,Regular
4JN18CS105,18ELE13,23,21,44,P,4,12019,Regular
4JN18CS105,18CIV14,31,21,52,P,6,12019,Regular
4JN18CS105,18EGDL15,35,52,87,P,9,12019,Regular
4JN18CS105,18PHYL16,33,44,77,P,8,12019,Regular
4JN18CS105,18ELEL17,37,51,88,P,9,12019,Regular
4JN18CS105,18EGH18,31,34,65,P,7,12019,Regular
4JN18CS106,18MAT11,37,44,81,P,9,12019,Regular
4JN18CS106,18PHY12,31,36,67,P,7,12019,Regular
4JN18CS106,18ELE13,33,35,68,P,7,12019,Regular
4JN18CS106,18CIV14,38,28,66,P,7,12019,Regular
4JN18CS106,18EGDL15,34,53,87,P,9,12019,Regular
4JN18CS106,18PHYL16,33,44,77,P,8,12019,Regular
4JN18CS106,18ELEL17,36,50,86,P,9,12019,Regular
4JN18CS106,18EGH18,32,30,62,P,7,12019,Regular
4JN18CS107,18MAT11,29,53,82,P,9,12019,Regular
4JN18CS107,18PHY12,32,34,66,P,7,12019,Regular
4JN18CS107,18ELE13,31,38,69,P,7,12019,Regular
4JN18CS107,18CIV14,32,21,53,P,6,12019,Regular
4JN18CS107,18EGDL15,34,41,75,P,8,12019,Regular
4JN18CS107,18PHYL16,32,39,71,P,8,12019,Regular
4JN18CS107,18ELEL17,34,54,88,P,9,12019,Regular
4JN18CS107,18EGH18,29,35,64,P,7,12019,Regular
4JN18CS108,18MAT11,30,0,30,A,0,12019,Regular
4JN18CS108,18PHY12,16,0,16,A,0,12019,Regular
4JN18CS108,18ELE13,21,0,21,A,0,12019,Regular
4JN18CS108,18CIV14,21,0,21,A,0,12019,Regular
4JN18CS108,18EGDL15,30,26,56,P,6,12019,Regular
4JN18CS108,18PHYL16,25,0,25,A,0,12019,Regular
4JN18CS108,18ELEL17,36,0,36,A,0,12019,Regular
4JN18CS108,18EGH18,29,0,29,A,0,12019,Regular
4JN18CS109,18MAT11,37,57,94,P,10,12019,Regular
4JN18CS109,18PHY12,35,50,85,P,9,12019,Regular
4JN18CS109,18ELE13,37,45,82,P,9,12019,Regular
4JN18CS109,18CIV14,38,27,65,P,7,12019,Regular
4JN18CS109,18EGDL15,34,47,81,P,9,12019,Regular
4JN18CS109,18PHYL16,35,54,89,P,9,12019,Regular
4JN18CS109,18ELEL17,38,52,90,P,10,12019,Regular
4JN18CS109,18EGH18,28,38,66,P,7,12019,Regular
4JN18CS110,18MAT11,30,35,65,P,7,12019,Regular
4JN18CS110,18PHY12,31,37,68,P,7,12019,Regular
4JN18CS110,18ELE13,29,23,52,P,6,12019,Regular
4JN18CS110,18CIV14,39,26,65,P,7,12019,Regular
4JN18CS110,18EGDL15,31,53,84,P,9,12019,Regular
4JN18CS110,18PHYL16,33,46,79,P,8,12019,Regular
4JN18CS110,18ELEL17,36,48,84,P,9,12019,Regular
4JN18CS110,18EGH18,30,38,68,P,7,12019,Regular
4JN18CS111,18MAT11,37,43,80,P,9,12019,Regular
4JN18CS111,18PHY12,35,47,82,P,9,12019,Regular
4JN18CS111,18ELE13,33,43,76,P,8,12019,Regular
4JN18CS111,18CIV14,38,32,70,P,8,12019,Regular
4JN18CS111,18EGDL15,36,38,74,P,8,12019,Regular
4JN18CS111,18PHYL16,34,50,84,P,9,12019,Regular
4JN18CS111,18ELEL17,35,53,88,P,9,12019,Regular
4JN18CS111,18EGH18,31,37,68,P,7,12019,Regular
4JN18CS112,18MAT11,30,41,71,P,8,12019,Regular
4JN18CS112,18PHY12,31,32,63,P,7,12019,Regular
4JN18CS112,18ELE13,35,43,78,P,8,12019,Regular
4JN18CS112,18CIV14,35,25,60,P,7,12019,Regular
4JN18CS112,18EGDL15,35,47,82,P,9,12019,Regular
4JN18CS112,18PHYL16,33,44,77,P,8,12019,Regular
4JN18CS112,18ELEL17,34,44,78,P,8,12019,Regular
4JN18CS112,18EGH18,29,35,64,P,7,12019,Regular
4JN18CS113,18MAT11,31,27,58,P,6,12019,Regular
4JN18CS113,18PHY12,28,27,55,P,6,12019,Regular
4JN18CS113,18ELE13,33,21,54,P,6,12019,Regular
4JN18CS113,18CIV14,33,25,58,P,6,12019,Regular
4JN18CS113,18EGDL15,31,44,75,P,8,12019,Regular
4JN18CS113,18PHYL16,34,45,79,P,8,12019,Regular
4JN18CS113,18ELEL17,34,52,86,P,9,12019,Regular
4JN18CS113,18EGH18,24,30,54,P,6,12019,Regular
4JN18CS114,18MAT11,27,29,56,P,6,12019,Regular
4JN18CS114,18PHY12,22,27,49,P,5,12019,Regular
4JN18CS114,18ELE13,20,21,41,P,4,12019,Regular
4JN18CS114,18CIV14,27,21,48,P,5,12019,Regular
4JN18CS114,18EGDL15,32,38,70,P,8,12019,Regular
4JN18CS114,18PHYL16,29,26,55,P,6,12019,Regular
4JN18CS114,18ELEL17,36,35,71,P,8,12019,Regular
4JN18CS114,18EGH18,29,33,62,P,7,12019,Regular
4JN18CS115,18MAT11,38,53,91,P,10,12019,Regular
4JN18CS115,18PHY12,33,47,80,P,9,12019,Regular
4JN18CS115,18ELE13,39,53,92,P,10,12019,Regular
4JN18CS115,18CIV14,40,35,75,P,8,12019,Regular
4JN18CS115,18EGDL15,40,56,96,P,10,12019,Regular
4JN18CS115,18PHYL16,35,53,88,P,9,12019,Regular
4JN18CS115,18ELEL17,38,56,94,P,10,12019,Regular
4JN18CS115,18EGH18,31,41,72,P,8,12019,Regular
4JN18CS116,18MAT11,40,53,93,P,10,12019,Regular
4JN18CS116,18PHY12,35,53,88,P,9,12019,Regular
4JN18CS116,18ELE13,39,59,98,P,10,12019,Regular
4JN18CS116,18CIV14,40,35,75,P,8,12019,Regular
4JN18CS116,18EGDL15,40,56,96,P,10,12019,Regular
4JN18CS116,18PHYL16,35,53,88,P,9,12019,Regular
4JN18CS116,18ELEL17,36,56,92,P,10,12019,Regular
4JN18CS116,18EGH18,32,42,74,P,8,12019,Regular
4JN18CS117,18MAT11,31,40,71,P,8,12019,Regular
4JN18CS117,18PHY12,29,40,69,P,7,12019,Regular
4JN18CS117,18ELE13,29,33,62,P,7,12019,Regular
4JN18CS117,18CIV14,37,24,61,P,7,12019,Regular
4JN18CS117,18EGDL15,40,55,95,P,10,12019,Regular
4JN18CS117,18PHYL16,33,50,83,P,9,12019,Regular
4JN18CS117,18ELEL17,36,52,88,P,9,12019,Regular
4JN18CS117,18EGH18,31,41,72,P,8,12019,Regular
4JN18CS118,18MAT11,37,56,93,P,10,12019,Regular
4JN18CS118,18PHY12,37,51,88,P,9,12019,Regular
4JN18CS118,18ELE13,39,46,85,P,9,12019,Regular
4JN18CS118,18CIV14,37,27,64,P,7,12019,Regular
4JN18CS118,18EGDL15,40,57,97,P,10,12019,Regular
4JN18CS118,18PHYL16,38,54,92,P,10,12019,Regular
4JN18CS118,18ELEL17,38,58,96,P,10,12019,Regular
4JN18CS118,18EGH18,27,34,61,P,7,12019,Regular
4JN18CS119,18MAT11,27,15,42,F,0,12019,Regular
4JN18CS119,18PHY12,22,34,56,P,6,12019,Regular
4JN18CS119,18ELE13,25,17,42,F,0,12019,Regular
4JN18CS119,18CIV14,28,21,49,P,5,12019,Regular
4JN18CS119,18EGDL15,32,35,67,P,7,12019,Regular
4JN18CS119,18PHYL16,34,31,65,P,7,12019,Regular
4JN18CS119,18ELEL17,32,41,73,P,8,12019,Regular
4JN18CS119,18EGH18,31,38,69,P,7,12019,Regular
4JN18CS120,18MAT11,30,48,78,P,8,12019,Regular
4JN18CS120,18PHY12,34,39,73,P,8,12019,Regular
4JN18CS120,18ELE13,35,35,70,P,8,12019,Regular
4JN18CS120,18CIV14,38,26,64,P,7,12019,Regular
4JN18CS120,18EGDL15,39,43,82,P,9,12019,Regular
4JN18CS120,18PHYL16,24,41,65,P,7,12019,Regular
4JN18CS120,18ELEL17,35,47,82,P,9,12019,Regular
4JN18CS120,18EGH18,31,41,72,P,8,12019,Regular
4JN18CS121,18MAT11,40,59,99,P,10,12019,Regular
4JN18CS121,18PHY12,38,59,97,P,10,12019,Regular
4JN18CS121,18ELE13,40,48,88,P,9,12019,Regular
4JN18CS121,18CIV14,40,44,84,P,9,12019,Regular
4JN18CS121,18EGDL15,40,56,96,P,10,12019,Regular
4JN18CS121,18PHYL16,35,56,91,P,10,12019,Regular
4JN18CS121,18ELEL17,39,48,87,P,9,12019,Regular
4JN18CS121,18EGH18,32,39,71,P,8,12019,Regular
4JN18CS122,18MAT11,37,59,96,P,10,12019,Regular
4JN18CS122,18PHY12,33,55,88,P,9,12019,Regular
4JN18CS122,18ELE13,38,42,80,P,9,12019,Regular
4JN18CS122,18CIV14,38,32,70,P,8,12019,Regular
4JN18CS122,18EGDL15,40,47,87,P,9,12019,Regular
4JN18CS122,18PHYL16,36,48,84,P,9,12019,Regular
4JN18CS122,18ELEL17,37,47,84,P,9,12019,Regular
4JN18CS122,18EGH18,28,39,67,P,7,12019,Regular
4JN18CS123,18MAT11,38,57,95,P,10,12019,Regular
4JN18CS123,18PHY12,35,46,81,P,9,12019,Regular
4JN18CS123,18ELE13,37,42,79,P,8,12019,Regular
4JN18CS123,18CIV14,37,27,64,P,7,12019,Regular
4JN18CS123,18EGDL15,36,26,62,P,7,12019,Regular
4JN18CS123,18PHYL16,36,41,77,P,8,12019,Regular
4JN18CS123,18ELEL17,38,45,83,P,9,12019,Regular
4JN18CS123,18EGH18,27,26,53,P,6,12019,Regular
4JN18CS124,18MAT11,23,21,44,P,4,12019,Regular
4JN18CS124,18PHY12,23,22,45,P,5,12019,Regular
4JN18CS124,18ELE13,21,21,42,P,4,12019,Regular
4JN18CS124,18CIV14,29,21,50,P,6,12019,Regular
4JN18CS124,18EGDL15,38,43,81,P,9,12019,Regular
4JN18CS124,18PHYL16,20,32,52,P,6,12019,Regular
4JN18CS124,18ELEL17,30,33,63,P,7,12019,Regular
4JN18CS124,18EGH18,31,45,76,P,8,12019,Regular
4JN18CS125,18MAT11,24,17,41,F,0,12019,Regular
4JN18CS125,18PHY12,22,24,46,P,5,12019,Regular
4JN18CS125,18ELE13,19,18,37,F,0,12019,Regular
4JN18CS125,18CIV14,32,30,62,P,7,12019,Regular
4JN18CS125,18EGDL15,25,31,56,P,6,12019,Regular
4JN18CS125,18PHYL16,20,30,50,P,6,12019,Regular
4JN18CS125,18ELEL17,30,43,73,P,8,12019,Regular
4JN18CS125,18EGH18,28,34,62,P,7,12019,Regular
4JN18CS126,18MAT11,28,26,54,P,6,12019,Regular
4JN18CS126,18PHY12,17,23,40,P,4,12019,Regular
4JN18CS126,18ELE13,16,24,40,P,4,12019,Regular
4JN18CS126,18CIV14,32,21,53,P,6,12019,Regular
4JN18CS126,18EGDL15,23,32,55,P,6,12019,Regular
4JN18CS126,18PHYL16,29,32,61,P,7,12019,Regular
4JN18CS126,18ELEL17,23,40,63,P,7,12019,Regular
4JN18CS126,18EGH18,25,32,57,P,6,12019,Regular
4JN18CS127,18MAT11,28,39,67,P,7,12019,Regular
4JN18CS127,18PHY12,33,35,68,P,7,12019,Regular
4JN18CS127,18ELE13,33,42,75,P,8,12019,Regular
4JN18CS127,18CIV14,32,29,61,P,7,12019,Regular
4JN18CS127,18EGDL15,40,25,65,P,7,12019,Regular
4JN18CS127,18PHYL16,33,44,77,P,8,12019,Regular
4JN18CS127,18ELEL17,34,35,69,P,7,12019,Regular
4JN18CS127,18EGH18,25,31,56,P,6,12019,Regular
4JN18CS128,18MAT11,40,54,94,P,10,12019,Regular
4JN18CS128,18PHY12,35,45,80,P,9,12019,Regular
4JN18CS128,18ELE13,37,45,82,P,9,12019,Regular
4JN18CS128,18CIV14,40,42,82,P,9,12019,Regular
4JN18CS128,18EGDL15,38,53,91,P,10,12019,Regular
4JN18CS128,18PHYL16,37,54,91,P,10,12019,Regular
4JN18CS128,18ELEL17,36,42,78,P,8,12019,Regular
4JN18CS128,18EGH18,34,45,79,P,8,12019,Regular
4JN16CS002,17MAT31,30,36,66,P,7,12019,Regular
4JN16CS002,17CS32,31,36,67,P,7,12019,Regular
4JN16CS002,17CS33,27,30,57,P,6,12019,Regular
4JN16CS002,17CS34,28,21,49,P,5,12019,Regular
4JN16CS002,17CS35,25,35,60,P,7,12019,Regular
4JN16CS002,17CS36,31,21,52,P,6,12019,Regular
4JN16CS002,17CSL37,38,51,89,P,9,12019,Regular
4JN16CS002,17CSL38,31,58,89,P,9,12019,Regular
4JN16CS002,17KKM39,12,24,36,P,0,12019,Regular
4JN16CS043,17MAT31,19,24,43,P,4,12019,Regular
4JN16CS043,17CS32,27,15,42,F,0,12019,Regular
4JN16CS043,17CS33,19,11,30,F,0,12019,Regular
4JN16CS043,17CS34,20,8,28,F,0,12019,Regular
4JN16CS043,17CS35,19,23,42,P,4,12019,Regular
4JN16CS043,17CS36,24,29,53,P,6,12019,Regular
4JN16CS043,17CSL37,30,12,42,F,0,12019,Regular
4JN16CS043,17CSL38,31,4,35,F,0,12019,Regular
4JN16CS043,17KKM39,12,0,12,A,0,12019,Regular
4JN16CS043,15MAT21,12,12,24,F,0,12019,Backlog
4JN16CS043,15MAT11,13,6,19,F,0,12019,Backlog
4JN16CS043,15CIV13,13,17,30,F,0,12019,Backlog
4JN16CS043,15ELE15,12,17,29,F,0,12019,Backlog
4JN16CS069,17MAT31,25,28,53,P,6,12019,Regular
4JN16CS069,17CS32,21,14,35,F,0,12019,Regular
4JN16CS069,17CS33,20,5,25,F,0,12019,Regular
4JN16CS069,17CS34,20,6,26,F,0,12019,Regular
4JN16CS069,17CS35,19,2,21,F,0,12019,Regular
4JN16CS069,17CS36,20,9,29,F,0,12019,Regular
4JN16CS069,17CSL37,36,48,84,P,9,12019,Regular
4JN16CS069,17CSL38,29,27,56,P,6,12019,Regular
4JN16CS069,17KKM39,12,18,30,P,0,12019,Regular
4JN16CS076,17MAT31,26,31,57,P,6,12019,Regular
4JN16CS076,17CS32,26,29,55,P,6,12019,Regular
4JN16CS076,17CS33,27,5,32,F,0,12019,Regular
4JN16CS076,17CS34,34,23,57,P,6,12019,Regular
4JN16CS076,17CS35,19,12,31,F,0,12019,Regular
4JN16CS076,17CS36,25,9,34,F,0,12019,Regular
4JN16CS076,17CSL37,40,30,70,P,8,12019,Regular
4JN16CS076,17CSL38,30,47,77,P,8,12019,Regular
4JN16CS076,17KKM39,15,25,40,P,4,12019,Regular
4JN16CS076,15MAT21,13,36,49,P,5,12019,Backlog
4JN16CS081,17MAT31,19,13,32,F,0,12019,Regular
4JN16CS081,17CS32,30,13,43,F,0,12019,Regular
4JN16CS081,17CS33,26,11,37,F,0,12019,Regular
4JN16CS081,17CS34,20,22,42,P,4,12019,Regular
4JN16CS081,17CS35,21,21,42,P,4,12019,Regular
4JN16CS081,17CS36,25,18,43,F,0,12019,Regular
4JN16CS081,17CSL37,34,30,64,P,7,12019,Regular
4JN16CS081,17CSL38,30,41,71,P,8,12019,Regular
4JN16CS081,17KKM39,15,15,30,P,0,12019,Regular
4JN16CS081,15MAT21,17,20,37,F,0,12019,Backlog
4JN16CS081,15MAT11,7,1,8,F,0,12019,Backlog
4JN16CS081,15PCD13,9,11,20,F,0,12019,Backlog
4JN17CS007,17MAT31,35,41,76,P,8,12019,Regular
4JN17CS007,17CS32,30,36,66,P,7,12019,Regular
4JN17CS007,17CS33,32,23,55,P,6,12019,Regular
4JN17CS007,17CS34,33,29,62,P,7,12019,Regular
4JN17CS007,17CS35,23,27,50,P,6,12019,Regular
4JN17CS007,17CS36,27,26,53,P,6,12019,Regular
4JN17CS007,17CSL37,40,60,100,P,10,12019,Regular
4JN17CS007,17CSL38,38,53,91,P,10,12019,Regular
4JN17CS007,17KKM39,15,27,42,P,4,12019,Regular
4JN17CS008,17MAT31,38,54,92,P,10,12019,Regular
4JN17CS008,17CS32,39,39,78,P,8,12019,Regular
4JN17CS008,17CS33,34,44,78,P,8,12019,Regular
4JN17CS008,17CS34,38,37,75,P,8,12019,Regular
4JN17CS008,17CS35,34,39,73,P,8,12019,Regular
4JN17CS008,17CS36,37,41,78,P,8,12019,Regular
4JN17CS008,17CSL37,40,59,99,P,10,12019,Regular
4JN17CS008,17CSL38,38,59,97,P,10,12019,Regular
4JN17CS008,17KKM39,15,29,44,P,4,12019,Regular
4JN17CS009,17MAT31,40,59,99,P,10,12019,Regular
4JN17CS009,17CS32,38,40,78,P,8,12019,Regular
4JN17CS009,17CS33,38,29,67,P,7,12019,Regular
4JN17CS009,17CS34,38,27,65,P,7,12019,Regular
4JN17CS009,17CS35,38,34,72,P,8,12019,Regular
4JN17CS009,17CS36,40,39,79,P,8,12019,Regular
4JN17CS009,17CSL37,40,60,100,P,10,12019,Regular
4JN17CS009,17CSL38,35,58,93,P,10,12019,Regular
4JN17CS009,17KKM39,17,27,44,P,4,12019,Regular
4JN17CS011,17MAT31,22,30,52,P,6,12019,Regular
4JN17CS011,17CS32,29,38,67,P,7,12019,Regular
4JN17CS011,17CS33,22,21,43,P,4,12019,Regular
4JN17CS011,17CS34,23,22,45,P,5,12019,Regular
4JN17CS011,17CS35,22,29,51,P,6,12019,Regular
4JN17CS011,17CS36,20,27,47,P,5,12019,Regular
4JN17CS011,17CSL37,37,59,96,P,10,12019,Regular
4JN17CS011,17CSL38,26,51,77,P,8,12019,Regular
4JN17CS011,17KKM39,15,23,38,P,0,12019,Regular
4JN17CS015,17MAT31,28,29,57,P,6,12019,Regular
4JN17CS015,17CS32,30,29,59,P,6,12019,Regular
4JN17CS015,17CS33,22,15,37,F,0,12019,Regular
4JN17CS015,17CS34,32,41,73,P,8,12019,Regular
4JN17CS015,17CS35,20,27,47,P,5,12019,Regular
4JN17CS015,17CS36,26,14,40,F,0,12019,Regular
4JN17CS015,17CSL37,40,57,97,P,10,12019,Regular
4JN17CS015,17CSL38,33,53,86,P,9,12019,Regular
4JN17CS015,17KKM39,13,27,40,P,4,12019,Regular
4JN17CS017,17MAT31,20,21,41,P,4,12019,Regular
4JN17CS017,17CS32,24,14,38,F,0,12019,Regular
4JN17CS017,17CS33,20,18,38,F,0,12019,Regular
4JN17CS017,17CS34,20,17,37,F,0,12019,Regular
4JN17CS017,17CS35,19,14,33,F,0,12019,Regular
4JN17CS017,17CS36,22,27,49,P,5,12019,Regular
4JN17CS017,17CSL37,33,24,57,P,6,12019,Regular
4JN17CS017,17CSL38,25,44,69,P,7,12019,Regular
4JN17CS017,17KKM39,12,24,36,P,0,12019,Regular
4JN17CS017,17MAT21,20,5,25,F,0,12019,Backlog
4JN17CS017,17CPL26,30,45,75,P,8,12019,Backlog
4JN17CS017,17MAT11,20,14,34,F,0,12019,Backlog
4JN17CS017,17PHY12,19,14,33,F,0,12019,Backlog
4JN17CS020,17MAT31,26,30,56,P,6,12019,Regular
4JN17CS020,17CS32,28,30,58,P,6,12019,Regular
4JN17CS020,17CS33,20,29,49,P,5,12019,Regular
4JN17CS020,17CS34,32,24,56,P,6,12019,Regular
4JN17CS020,17CS35,19,27,46,P,5,12019,Regular
4JN17CS020,17CS36,29,21,50,P,6,12019,Regular
4JN17CS020,17CSL37,38,59,97,P,10,12019,Regular
4JN17CS020,17CSL38,33,56,89,P,9,12019,Regular
4JN17CS020,17KKM39,15,21,36,P,0,12019,Regular
4JN17CS020,17ELN25,30,26,56,P,6,12019,Backlog
4JN17CS020,17CPL26,37,33,70,P,8,12019,Backlog
4JN17CS021,17MAT31,22,21,43,P,4,12019,Regular
4JN17CS021,17CS32,29,21,50,P,6,12019,Regular
4JN17CS021,17CS33,29,23,52,P,6,12019,Regular
4JN17CS021,17CS34,23,23,46,P,5,12019,Regular
4JN17CS021,17CS35,22,26,48,P,5,12019,Regular
4JN17CS021,17CS36,30,14,44,F,0,12019,Regular
4JN17CS021,17CSL37,37,54,91,P,10,12019,Regular
4JN17CS021,17CSL38,38,51,89,P,9,12019,Regular
4JN17CS021,17KKM39,15,23,38,P,0,12019,Regular
4JN17CS021,17MAT11,19,15,34,F,0,12019,Backlog
4JN17CS021,17PHY12,19,21,40,P,4,12019,Backlog
4JN17CS021,17ELE15,29,21,50,P,6,12019,Backlog
4JN17CS022,17MAT31,36,39,75,P,8,12019,Regular
4JN17CS022,17CS32,33,36,69,P,7,12019,Regular
4JN17CS022,17CS33,31,21,52,P,6,12019,Regular
4JN17CS022,17CS34,30,21,51,P,6,12019,Regular
4JN17CS022,17CS35,25,38,63,P,7,12019,Regular
4JN17CS022,17CS36,31,21,52,P,6,12019,Regular
4JN17CS022,17CSL37,40,60,100,P,10,12019,Regular
4JN17CS022,17CSL38,37,48,85,P,9,12019,Regular
4JN17CS022,17KKM39,17,23,40,P,4,12019,Regular
4JN17CS024,17MAT31,24,23,47,P,5,12019,Regular
4JN17CS024,17CS32,29,21,50,P,6,12019,Regular
4JN17CS024,17CS33,24,12,36,F,0,12019,Regular
4JN17CS024,17CS34,24,14,38,F,0,12019,Regular
4JN17CS024,17CS35,23,23,46,P,5,12019,Regular
4JN17CS024,17CS36,20,15,35,F,0,12019,Regular
4JN17CS024,17CSL37,33,27,60,P,7,12019,Regular
4JN17CS024,17CSL38,20,25,45,P,5,12019,Regular
4JN17CS024,17KKM39,14,23,37,P,0,12019,Regular
4JN17CS024,17MAT21,19,11,30,F,0,12019,Backlog
4JN17CS024,17PCD23,34,0,34,A,0,12019,Backlog
4JN17CS024,17ELE15,31,21,52,P,6,12019,Backlog
4JN17CS027,17MAT31,39,59,98,P,10,12019,Regular
4JN17CS027,17CS32,39,50,89,P,9,12019,Regular
4JN17CS027,17CS33,36,36,72,P,8,12019,Regular
4JN17CS027,17CS34,38,32,70,P,8,12019,Regular
4JN17CS027,17CS35,40,39,79,P,8,12019,Regular
4JN17CS027,17CS36,36,41,77,P,8,12019,Regular
4JN17CS027,17CSL37,40,60,100,P,10,12019,Regular
4JN17CS027,17CSL38,39,47,86,P,9,12019,Regular
4JN17CS027,17KKM39,15,28,43,P,4,12019,Regular
4JN17CS028,17MAT31,40,54,94,P,10,12019,Regular
4JN17CS028,17CS32,36,44,80,P,9,12019,Regular
4JN17CS028,17CS33,37,40,77,P,8,12019,Regular
4JN17CS028,17CS34,36,35,71,P,8,12019,Regular
4JN17CS028,17CS35,38,41,79,P,8,12019,Regular
4JN17CS028,17CS36,39,41,80,P,9,12019,Regular
4JN17CS028,17CSL37,40,60,100,P,10,12019,Regular
4JN17CS028,17CSL38,40,59,99,P,10,12019,Regular
4JN17CS028,17KKM39,16,28,44,P,4,12019,Regular
4JN17CS029,17MAT31,20,30,50,P,6,12019,Regular
4JN17CS029,17CS32,27,21,48,P,5,12019,Regular
4JN17CS029,17CS33,21,15,36,F,0,12019,Regular
4JN17CS029,17CS34,20,21,41,P,4,12019,Regular
4JN17CS029,17CS35,19,21,40,P,4,12019,Regular
4JN17CS029,17CS36,20,16,36,F,0,12019,Regular
4JN17CS029,17CSL37,33,27,60,P,7,12019,Regular
4JN17CS029,17CSL38,30,50,80,P,9,12019,Regular
4JN17CS029,17KKM39,12,10,22,P,0,12019,Regular
4JN17CS029,17MAT21,20,21,41,P,4,12019,Backlog
4JN17CS029,17PCD23,33,21,54,P,6,12019,Backlog
4JN17CS033,17MAT31,37,42,79,P,8,12019,Regular
4JN17CS033,17CS32,33,43,76,P,8,12019,Regular
4JN17CS033,17CS33,30,24,54,P,6,12019,Regular
4JN17CS033,17CS34,33,32,65,P,7,12019,Regular
4JN17CS033,17CS35,24,35,59,P,6,12019,Regular
4JN17CS033,17CS36,36,23,59,P,6,12019,Regular
4JN17CS033,17CSL37,37,56,93,P,10,12019,Regular
4JN17CS033,17CSL38,35,32,67,P,7,12019,Regular
4JN17CS033,17KKM39,14,21,35,P,0,12019,Regular
4JN17CS034,17MAT31,21,21,42,P,4,12019,Regular
4JN17CS034,17CS32,31,35,66,P,7,12019,Regular
4JN17CS034,17CS33,24,21,45,P,5,12019,Regular
4JN17CS034,17CS34,20,17,37,F,0,12019,Regular
4JN17CS034,17CS35,19,25,44,P,4,12019,Regular
4JN17CS034,17CS36,20,10,30,F,0,12019,Regular
4JN17CS034,17CSL37,30,54,84,P,9,12019,Regular
4JN17CS034,17CSL38,28,47,75,P,8,12019,Regular
4JN17CS034,17KKM39,12,18,30,P,0,12019,Regular
4JN17CS034,17PHYL17,23,32,55,P,6,12019,Backlog
4JN17CS036,17MAT31,31,40,71,P,8,12019,Regular
4JN17CS036,17CS32,33,28,61,P,7,12019,Regular
4JN17CS036,17CS33,32,22,54,P,6,12019,Regular
4JN17CS036,17CS34,28,25,53,P,6,12019,Regular
4JN17CS036,17CS35,24,33,57,P,6,12019,Regular
4JN17CS036,17CS36,33,27,60,P,7,12019,Regular
4JN17CS036,17CSL37,40,57,97,P,10,12019,Regular
4JN17CS036,17CSL38,33,45,78,P,8,12019,Regular
4JN17CS036,17KKM39,12,20,32,P,0,12019,Regular
4JN17CS040,17MAT31,23,26,49,P,5,12019,Regular
4JN17CS040,17CS32,27,13,40,F,0,12019,Regular
4JN17CS040,17CS33,28,31,59,P,6,12019,Regular
4JN17CS040,17CS34,25,13,38,F,0,12019,Regular
4JN17CS040,17CS35,23,21,44,P,4,12019,Regular
4JN17CS040,17CS36,27,14,41,F,0,12019,Regular
4JN17CS040,17CSL37,35,45,80,P,9,12019,Regular
4JN17CS040,17CSL38,34,30,64,P,7,12019,Regular
4JN17CS040,17KKM39,14,24,38,P,0,12019,Regular
4JN17CS040,17MAT21,19,11,30,F,0,12019,Backlog
4JN17CS040,17PCD23,35,27,62,P,7,12019,Backlog
4JN17CS042,17MAT31,32,39,71,P,8,12019,Regular
4JN17CS042,17CS32,30,35,65,P,7,12019,Regular
4JN17CS042,17CS33,30,21,51,P,6,12019,Regular
4JN17CS042,17CS34,24,21,45,P,5,12019,Regular
4JN17CS042,17CS35,27,33,60,P,7,12019,Regular
4JN17CS042,17CS36,38,29,67,P,7,12019,Regular
4JN17CS042,17CSL37,40,57,97,P,10,12019,Regular
4JN17CS042,17CSL38,35,54,89,P,9,12019,Regular
4JN17CS042,17KKM39,15,20,35,P,0,12019,Regular
4JN17CS043,17MAT31,38,54,92,P,10,12019,Regular
4JN17CS043,17CS32,34,45,79,P,8,12019,Regular
4JN17CS043,17CS33,33,33,66,P,7,12019,Regular
4JN17CS043,17CS34,33,35,68,P,7,12019,Regular
4JN17CS043,17CS35,31,42,73,P,8,12019,Regular
4JN17CS043,17CS36,37,33,70,P,8,12019,Regular
4JN17CS043,17CSL37,40,60,100,P,10,12019,Regular
4JN17CS043,17CSL38,35,30,65,P,7,12019,Regular
4JN17CS043,17KKM39,16,30,46,P,5,12019,Regular
4JN17CS046,17MAT31,35,56,91,P,10,12019,Regular
4JN17CS046,17CS32,29,37,66,P,7,12019,Regular
4JN17CS046,17CS33,24,23,47,P,5,12019,Regular
4JN17CS046,17CS34,28,21,49,P,5,12019,Regular
4JN17CS046,17CS35,19,26,45,P,5,12019,Regular
4JN17CS046,17CS36,25,21,46,P,5,12019,Regular
4JN17CS046,17CSL37,40,60,100,P,10,12019,Regular
4JN17CS046,17CSL38,32,30,62,P,7,12019,Regular
4JN17CS046,17KKM39,12,19,31,P,0,12019,Regular
4JN17CS046,17ELE15,35,9,44,F,0,12019,Backlog
4JN17CS049,17MAT31,32,35,67,P,7,12019,Regular
4JN17CS049,17CS32,29,29,58,P,6,12019,Regular
4JN17CS049,17CS33,23,18,41,F,0,12019,Regular
4JN17CS049,17CS34,23,9,32,F,0,12019,Regular
4JN17CS049,17CS35,26,21,47,P,5,12019,Regular
4JN17CS049,17CS36,23,25,48,P,5,12019,Regular
4JN17CS049,17CSL37,40,57,97,P,10,12019,Regular
4JN17CS049,17CSL38,31,36,67,P,7,12019,Regular
4JN17CS049,17KKM39,14,24,38,P,0,12019,Regular
4JN17CS049,17CHE22,28,21,49,P,5,12019,Backlog
4JN17CS050,17MAT31,25,26,51,P,6,12019,Regular
4JN17CS050,17CS32,24,12,36,F,0,12019,Regular
4JN17CS050,17CS33,20,17,37,F,0,12019,Regular
4JN17CS050,17CS34,20,6,26,F,0,12019,Regular
4JN17CS050,17CS35,19,17,36,F,0,12019,Regular
4JN17CS050,17CS36,20,8,28,F,0,12019,Regular
4JN17CS050,17CSL37,32,24,56,P,6,12019,Regular
4JN17CS050,17CSL38,29,18,47,F,0,12019,Regular
4JN17CS050,17KKM39,12,18,30,P,0,12019,Regular
4JN17CS050,17CHE22,15,15,30,F,0,12019,Backlog
4JN17CS050,17ELN25,19,8,27,F,0,12019,Backlog
4JN17CS050,17ELE15,26,21,47,P,5,12019,Backlog
4JN17CS051,17MAT31,29,41,70,P,8,12019,Regular
4JN17CS051,17CS32,30,39,69,P,7,12019,Regular
4JN17CS051,17CS33,30,26,56,P,6,12019,Regular
4JN17CS051,17CS34,31,24,55,P,6,12019,Regular
4JN17CS051,17CS35,24,26,50,P,6,12019,Regular
4JN17CS051,17CS36,29,21,50,P,6,12019,Regular
4JN17CS051,17CSL37,40,51,91,P,10,12019,Regular
4JN17CS051,17CSL38,35,30,65,P,7,12019,Regular
4JN17CS051,17KKM39,13,25,38,P,0,12019,Regular
4JN17CS052,17MAT31,25,38,63,P,7,12019,Regular
4JN17CS052,17CS32,31,27,58,P,6,12019,Regular
4JN17CS052,17CS33,26,26,52,P,6,12019,Regular
4JN17CS052,17CS34,24,23,47,P,5,12019,Regular
4JN17CS052,17CS35,24,31,55,P,6,12019,Regular
4JN17CS052,17CS36,26,27,53,P,6,12019,Regular
4JN17CS052,17CSL37,38,57,95,P,10,12019,Regular
4JN17CS052,17CSL38,33,24,57,P,6,12019,Regular
4JN17CS052,17KKM39,14,26,40,P,4,12019,Regular
4JN17CS053,17MAT31,31,30,61,P,7,12019,Regular
4JN17CS053,17CS32,30,21,51,P,6,12019,Regular
4JN17CS053,17CS33,20,6,26,F,0,12019,Regular
4JN17CS053,17CS34,22,9,31,F,0,12019,Regular
4JN17CS053,17CS35,21,16,37,F,0,12019,Regular
4JN17CS053,17CS36,23,14,37,F,0,12019,Regular
4JN17CS053,17CSL37,38,57,95,P,10,12019,Regular
4JN17CS053,17CSL38,23,33,56,P,6,12019,Regular
4JN17CS053,17KKM39,12,23,35,P,0,12019,Regular
4JN17CS053,17ELN25,35,0,35,A,0,12019,Backlog
4JN17CS053,17PHY12,31,21,52,P,6,12019,Backlog
4JN17CS055,17MAT31,30,44,74,P,8,12019,Regular
4JN17CS055,17CS32,30,29,59,P,6,12019,Regular
4JN17CS055,17CS33,29,23,52,P,6,12019,Regular
4JN17CS055,17CS34,25,21,46,P,5,12019,Regular
4JN17CS055,17CS35,21,23,44,P,4,12019,Regular
4JN17CS055,17CS36,28,33,61,P,7,12019,Regular
4JN17CS055,17CSL37,39,60,99,P,10,12019,Regular
4JN17CS055,17CSL38,34,24,58,P,6,12019,Regular
4JN17CS055,17KKM39,15,17,32,P,0,12019,Regular
4JN17CS056,17MAT31,40,56,96,P,10,12019,Regular
4JN17CS056,17CS32,39,36,75,P,8,12019,Regular
4JN17CS056,17CS33,37,35,72,P,8,12019,Regular
4JN17CS056,17CS34,40,32,72,P,8,12019,Regular
4JN17CS056,17CS35,38,44,82,P,9,12019,Regular
4JN17CS056,17CS36,38,46,84,P,9,12019,Regular
4JN17CS056,17CSL37,40,60,100,P,10,12019,Regular
4JN17CS056,17CSL38,38,59,97,P,10,12019,Regular
4JN17CS056,17KKM39,17,28,45,P,5,12019,Regular
4JN17CS059,17MAT31,35,53,88,P,9,12019,Regular
4JN17CS059,17CS32,35,37,72,P,8,12019,Regular
4JN17CS059,17CS33,31,40,71,P,8,12019,Regular
4JN17CS059,17CS34,28,29,57,P,6,12019,Regular
4JN17CS059,17CS35,29,45,74,P,8,12019,Regular
4JN17CS059,17CS36,34,33,67,P,7,12019,Regular
4JN17CS059,17CSL37,40,60,100,P,10,12019,Regular
4JN17CS059,17CSL38,36,51,87,P,9,12019,Regular
4JN17CS059,17KKM39,14,22,36,P,0,12019,Regular
4JN17CS060,17MAT31,28,35,63,P,7,12019,Regular
4JN17CS060,17CS32,37,34,71,P,8,12019,Regular
4JN17CS060,17CS33,30,15,45,F,0,12019,Regular
4JN17CS060,17CS34,29,22,51,P,6,12019,Regular
4JN17CS060,17CS35,27,16,43,F,0,12019,Regular
4JN17CS060,17CS36,30,21,51,P,6,12019,Regular
4JN17CS060,17CSL37,40,59,99,P,10,12019,Regular
4JN17CS060,17CSL38,31,30,61,P,7,12019,Regular
4JN17CS060,17KKM39,15,22,37,P,0,12019,Regular
4JN17CS061,17MAT31,38,50,88,P,9,12019,Regular
4JN17CS061,17CS32,32,39,71,P,8,12019,Regular
4JN17CS061,17CS33,32,23,55,P,6,12019,Regular
4JN17CS061,17CS34,28,18,46,F,0,12019,Regular
4JN17CS061,17CS35,27,24,51,P,6,12019,Regular
4JN17CS061,17CS36,31,27,58,P,6,12019,Regular
4JN17CS061,17CSL37,40,60,100,P,10,12019,Regular
4JN17CS061,17CSL38,31,18,49,F,0,12019,Regular
4JN17CS061,17KKM39,15,22,37,P,0,12019,Regular
4JN17CS062,17MAT31,39,60,99,P,10,12019,Regular
4JN17CS062,17CS32,38,45,83,P,9,12019,Regular
4JN17CS062,17CS33,40,37,77,P,8,12019,Regular
4JN17CS062,17CS34,40,39,79,P,8,12019,Regular
4JN17CS062,17CS35,37,50,87,P,9,12019,Regular
4JN17CS062,17CS36,38,49,87,P,9,12019,Regular
4JN17CS062,17CSL37,40,60,100,P,10,12019,Regular
4JN17CS062,17CSL38,36,59,95,P,10,12019,Regular
4JN17CS062,17KKM39,15,23,38,P,0,12019,Regular
4JN17CS067,17MAT31,35,49,84,P,9,12019,Regular
4JN17CS067,17CS32,35,45,80,P,9,12019,Regular
4JN17CS067,17CS33,30,23,53,P,6,12019,Regular
4JN17CS067,17CS34,30,15,45,F,0,12019,Regular
4JN17CS067,17CS35,31,21,52,P,6,12019,Regular
4JN17CS067,17CS36,31,24,55,P,6,12019,Regular
4JN17CS067,17CSL37,40,60,100,P,10,12019,Regular
4JN17CS067,17CSL38,35,56,91,P,10,12019,Regular
4JN17CS067,17KKM39,12,21,33,P,0,12019,Regular
4JN17CS069,17MAT31,40,58,98,P,10,12019,Regular
4JN17CS069,17CS32,40,47,87,P,9,12019,Regular
4JN17CS069,17CS33,39,35,74,P,8,12019,Regular
4JN17CS069,17CS34,40,37,77,P,8,12019,Regular
4JN17CS069,17CS35,39,46,85,P,9,12019,Regular
4JN17CS069,17CS36,40,50,90,P,10,12019,Regular
4JN17CS069,17CSL37,40,60,100,P,10,12019,Regular
4JN17CS069,17CSL38,40,59,99,P,10,12019,Regular
4JN17CS069,17KKM39,17,26,43,P,4,12019,Regular
4JN17CS070,17MAT31,40,58,98,P,10,12019,Regular
4JN17CS070,17CS32,38,38,76,P,8,12019,Regular
4JN17CS070,17CS33,37,36,73,P,8,12019,Regular
4JN17CS070,17CS34,39,32,71,P,8,12019,Regular
4JN17CS070,17CS35,34,45,79,P,8,12019,Regular
4JN17CS070,17CS36,38,33,71,P,8,12019,Regular
4JN17CS070,17CSL37,40,60,100,P,10,12019,Regular
4JN17CS070,17CSL38,37,59,96,P,10,12019,Regular
4JN17CS070,17KKM39,15,26,41,P,4,12019,Regular
4JN17CS077,17MAT31,40,51,91,P,10,12019,Regular
4JN17CS077,17CS32,34,38,72,P,8,12019,Regular
4JN17CS077,17CS33,30,33,63,P,7,12019,Regular
4JN17CS077,17CS34,31,27,58,P,6,12019,Regular
4JN17CS077,17CS35,28,30,58,P,6,12019,Regular
4JN17CS077,17CS36,35,45,80,P,9,12019,Regular
4JN17CS077,17CSL37,40,60,100,P,10,12019,Regular
4JN17CS077,17CSL38,33,57,90,P,10,12019,Regular
4JN17CS077,17KKM39,16,22,38,P,0,12019,Regular
4JN17CS078,17MAT31,40,55,95,P,10,12019,Regular
4JN17CS078,17CS32,40,33,73,P,8,12019,Regular
4JN17CS078,17CS33,36,37,73,P,8,12019,Regular
4JN17CS078,17CS34,40,33,73,P,8,12019,Regular
4JN17CS078,17CS35,35,30,65,P,7,12019,Regular
4JN17CS078,17CS36,37,31,68,P,7,12019,Regular
4JN17CS078,17CSL37,40,60,100,P,10,12019,Regular
4JN17CS078,17CSL38,38,59,97,P,10,12019,Regular
4JN17CS078,17KKM39,14,21,35,P,0,12019,Regular
4JN17CS079,17MAT31,33,45,78,P,8,12019,Regular
4JN17CS079,17CS32,30,26,56,P,6,12019,Regular
4JN17CS079,17CS33,29,26,55,P,6,12019,Regular
4JN17CS079,17CS34,27,24,51,P,6,12019,Regular
4JN17CS079,17CS35,19,29,48,P,5,12019,Regular
4JN17CS079,17CS36,34,27,61,P,7,12019,Regular
4JN17CS079,17CSL37,31,55,86,P,9,12019,Regular
4JN17CS079,17CSL38,34,44,78,P,8,12019,Regular
4JN17CS079,17KKM39,16,22,38,P,0,12019,Regular
4JN17CS080,17MAT31,26,22,48,P,5,12019,Regular
4JN17CS080,17CS32,26,30,56,P,6,12019,Regular
4JN17CS080,17CS33,29,32,61,P,7,12019,Regular
4JN17CS080,17CS34,25,21,46,P,5,12019,Regular
4JN17CS080,17CS35,24,24,48,P,5,12019,Regular
4JN17CS080,17CS36,33,21,54,P,6,12019,Regular
4JN17CS080,17CSL37,40,57,97,P,10,12019,Regular
4JN17CS080,17CSL38,34,53,87,P,9,12019,Regular
4JN17CS080,17KKM39,17,24,41,P,4,12019,Regular
4JN17CS080,17MAT21,23,29,52,P,6,12019,Backlog
4JN17CS080,17PCD23,34,30,64,P,7,12019,Backlog
4JN17CS080,17ELN25,25,30,55,P,6,12019,Backlog
4JN17CS083,17MAT31,39,47,86,P,9,12019,Regular
4JN17CS083,17CS32,38,40,78,P,8,12019,Regular
4JN17CS083,17CS33,38,25,63,P,7,12019,Regular
4JN17CS083,17CS34,37,36,73,P,8,12019,Regular
4JN17CS083,17CS35,37,42,79,P,8,12019,Regular
4JN17CS083,17CS36,37,45,82,P,9,12019,Regular
4JN17CS083,17CSL37,40,60,100,P,10,12019,Regular
4JN17CS083,17CSL38,36,54,90,P,10,12019,Regular
4JN17CS083,17KKM39,18,26,44,P,4,12019,Regular
4JN17CS087,17MAT31,36,53,89,P,9,12019,Regular
4JN17CS087,17CS32,40,55,95,P,10,12019,Regular
4JN17CS087,17CS33,36,38,74,P,8,12019,Regular
4JN17CS087,17CS34,40,36,76,P,8,12019,Regular
4JN17CS087,17CS35,40,46,86,P,9,12019,Regular
4JN17CS087,17CS36,37,49,86,P,9,12019,Regular
4JN17CS087,17CSL37,40,60,100,P,10,12019,Regular
4JN17CS087,17CSL38,40,59,99,P,10,12019,Regular
4JN17CS087,17KKM39,18,29,47,P,5,12019,Regular
4JN17CS088,17MAT31,36,39,75,P,8,12019,Regular
4JN17CS088,17CS32,31,32,63,P,7,12019,Regular
4JN17CS088,17CS33,30,21,51,P,6,12019,Regular
4JN17CS088,17CS34,26,21,47,P,5,12019,Regular
4JN17CS088,17CS35,21,24,45,P,5,12019,Regular
4JN17CS088,17CS36,29,21,50,P,6,12019,Regular
4JN17CS088,17CSL37,40,60,100,P,10,12019,Regular
4JN17CS088,17CSL38,36,50,86,P,9,12019,Regular
4JN17CS088,17KKM39,14,18,32,P,0,12019,Regular
4JN17CS090,17MAT31,23,33,56,P,6,12019,Regular
4JN17CS090,17CS32,28,30,58,P,6,12019,Regular
4JN17CS090,17CS33,23,14,37,F,0,12019,Regular
4JN17CS090,17CS34,22,36,58,P,6,12019,Regular
4JN17CS090,17CS35,19,21,40,P,4,12019,Regular
4JN17CS090,17CS36,28,21,49,P,5,12019,Regular
4JN17CS090,17CSL37,32,59,91,P,10,12019,Regular
4JN17CS090,17CSL38,33,38,71,P,8,12019,Regular
4JN17CS090,17KKM39,13,12,25,P,0,12019,Regular
4JN17CS091,17MAT31,24,39,63,P,7,12019,Regular
4JN17CS091,17CS32,28,29,57,P,6,12019,Regular
4JN17CS091,17CS33,25,22,47,P,5,12019,Regular
4JN17CS091,17CS34,25,28,53,P,6,12019,Regular
4JN17CS091,17CS35,20,28,48,P,5,12019,Regular
4JN17CS091,17CS36,26,15,41,F,0,12019,Regular
4JN17CS091,17CSL37,38,57,95,P,10,12019,Regular
4JN17CS091,17CSL38,33,44,77,P,8,12019,Regular
4JN17CS091,17KKM39,12,16,28,P,0,12019,Regular
4JN17CS092,17MAT31,40,58,98,P,10,12019,Regular
4JN17CS092,17CS32,35,46,81,P,9,12019,Regular
4JN17CS092,17CS33,31,26,57,P,6,12019,Regular
4JN17CS092,17CS34,27,21,48,P,5,12019,Regular
4JN17CS092,17CS35,25,32,57,P,6,12019,Regular
4JN17CS092,17CS36,35,33,68,P,7,12019,Regular
4JN17CS092,17CSL37,40,59,99,P,10,12019,Regular
4JN17CS092,17CSL38,35,59,94,P,10,12019,Regular
4JN17CS092,17KKM39,16,25,41,P,4,12019,Regular
4JN17CS097,17MAT31,28,24,52,P,6,12019,Regular
4JN17CS097,17CS32,23,21,44,P,4,12019,Regular
4JN17CS097,17CS33,37,23,60,P,7,12019,Regular
4JN17CS097,17CS34,23,21,44,P,4,12019,Regular
4JN17CS097,17CS35,20,27,47,P,5,12019,Regular
4JN17CS097,17CS36,20,14,34,F,0,12019,Regular
4JN17CS097,17CSL37,28,57,85,P,9,12019,Regular
4JN17CS097,17CSL38,34,38,72,P,8,12019,Regular
4JN17CS097,17KKM39,12,21,33,P,0,12019,Regular
4JN17CS097,17MAT21,26,6,32,F,0,12019,Backlog
4JN17CS098,17MAT31,37,54,91,P,10,12019,Regular
4JN17CS098,17CS32,37,39,76,P,8,12019,Regular
4JN17CS098,17CS33,35,31,66,P,7,12019,Regular
4JN17CS098,17CS34,39,27,66,P,7,12019,Regular
4JN17CS098,17CS35,32,32,64,P,7,12019,Regular
4JN17CS098,17CS36,37,21,58,P,6,12019,Regular
4JN17CS098,17CSL37,40,59,99,P,10,12019,Regular
4JN17CS098,17CSL38,37,59,96,P,10,12019,Regular
4JN17CS098,17KKM39,14,26,40,P,4,12019,Regular
4JN17CS103,17MAT31,19,14,33,F,0,12019,Regular
4JN17CS103,17CS32,32,21,53,P,6,12019,Regular
4JN17CS103,17CS33,28,27,55,P,6,12019,Regular
4JN17CS103,17CS34,28,30,58,P,6,12019,Regular
4JN17CS103,17CS35,25,29,54,P,6,12019,Regular
4JN17CS103,17CS36,27,11,38,F,0,12019,Regular
4JN17CS103,17CSL37,30,30,60,P,7,12019,Regular
4JN17CS103,17CSL38,34,21,55,F,0,12019,Regular
4JN17CS103,17KKM39,14,25,39,P,0,12019,Regular
4JN17CS103,17MAT11,19,14,33,F,0,12019,Backlog
4JN17CS108,17MAT31,40,51,91,P,10,12019,Regular
4JN17CS108,17CS32,39,45,84,P,9,12019,Regular
4JN17CS108,17CS33,40,39,79,P,8,12019,Regular
4JN17CS108,17CS34,38,38,76,P,8,12019,Regular
4JN17CS108,17CS35,40,42,82,P,9,12019,Regular
4JN17CS108,17CS36,37,38,75,P,8,12019,Regular
4JN17CS108,17CSL37,40,60,100,P,10,12019,Regular
4JN17CS108,17CSL38,37,57,94,P,10,12019,Regular
4JN17CS108,17KKM39,18,29,47,P,5,12019,Regular
4JN17CS109,17MAT31,29,42,71,P,8,12019,Regular
4JN17CS109,17CS32,33,28,61,P,7,12019,Regular
4JN17CS109,17CS33,30,33,63,P,7,12019,Regular
4JN17CS109,17CS34,34,30,64,P,7,12019,Regular
4JN17CS109,17CS35,25,26,51,P,6,12019,Regular
4JN17CS109,17CS36,29,21,50,P,6,12019,Regular
4JN17CS109,17CSL37,40,30,70,P,8,12019,Regular
4JN17CS109,17CSL38,36,27,63,P,7,12019,Regular
4JN17CS109,17KKM39,15,23,38,P,0,12019,Regular
4JN17CS110,17MAT31,35,48,83,P,9,12019,Regular
4JN17CS110,17CS32,31,24,55,P,6,12019,Regular
4JN17CS110,17CS33,32,32,64,P,7,12019,Regular
4JN17CS110,17CS34,37,33,70,P,8,12019,Regular
4JN17CS110,17CS35,26,24,50,P,6,12019,Regular
4JN17CS110,17CS36,34,26,60,P,7,12019,Regular
4JN17CS110,17CSL37,40,57,97,P,10,12019,Regular
4JN17CS110,17CSL38,36,33,69,P,7,12019,Regular
4JN17CS110,17KKM39,17,22,39,P,0,12019,Regular
4JN17CS114,17MAT31,22,21,43,P,4,12019,Regular
4JN17CS114,17CS32,32,21,53,P,6,12019,Regular
4JN17CS114,17CS33,25,22,47,P,5,12019,Regular
4JN17CS114,17CS34,25,36,61,P,7,12019,Regular
4JN17CS114,17CS35,24,22,46,P,5,12019,Regular
4JN17CS114,17CS36,26,23,49,P,5,12019,Regular
4JN17CS114,17CSL37,40,57,97,P,10,12019,Regular
4JN17CS114,17CSL38,29,30,59,P,6,12019,Regular
4JN17CS114,17KKM39,12,26,38,P,0,12019,Regular
4JN17CS115,17MAT31,37,40,77,P,8,12019,Regular
4JN17CS115,17CS32,38,39,77,P,8,12019,Regular
4JN17CS115,17CS33,36,41,77,P,8,12019,Regular
4JN17CS115,17CS34,37,36,73,P,8,12019,Regular
4JN17CS115,17CS35,38,36,74,P,8,12019,Regular
4JN17CS115,17CS36,38,32,70,P,8,12019,Regular
4JN17CS115,17CSL37,35,60,95,P,10,12019,Regular
4JN17CS115,17CSL38,38,60,98,P,10,12019,Regular
4JN17CS115,17KKM39,12,26,38,P,0,12019,Regular
4JN17CS122,17MAT31,33,42,75,P,8,12019,Regular
4JN17CS122,17CS32,34,45,79,P,8,12019,Regular
4JN17CS122,17CS33,34,38,72,P,8,12019,Regular
4JN17CS122,17CS34,25,33,58,P,6,12019,Regular
4JN17CS122,17CS35,24,34,58,P,6,12019,Regular
4JN17CS122,17CS36,31,26,57,P,6,12019,Regular
4JN17CS122,17CSL37,40,60,100,P,10,12019,Regular
4JN17CS122,17CSL38,29,57,86,P,9,12019,Regular
4JN17CS122,17KKM39,13,27,40,P,4,12019,Regular
4JN17CS123,17MAT31,29,37,66,P,7,12019,Regular
4JN17CS123,17CS32,33,36,69,P,7,12019,Regular
4JN17CS123,17CS33,24,21,45,P,5,12019,Regular
4JN17CS123,17CS34,25,23,48,P,5,12019,Regular
4JN17CS123,17CS35,21,25,46,P,5,12019,Regular
4JN17CS123,17CS36,31,22,53,P,6,12019,Regular
4JN17CS123,17CSL37,40,60,100,P,10,12019,Regular
4JN17CS123,17CSL38,36,39,75,P,8,12019,Regular
4JN17CS123,17KKM39,12,24,36,P,0,12019,Regular
4JN17CS124,17MAT31,27,39,66,P,7,12019,Regular
4JN17CS124,17CS32,30,35,65,P,7,12019,Regular
4JN17CS124,17CS33,21,25,46,P,5,12019,Regular
4JN17CS124,17CS34,28,38,66,P,7,12019,Regular
4JN17CS124,17CS35,27,27,54,P,6,12019,Regular
4JN17CS124,17CS36,30,11,41,F,0,12019,Regular
4JN17CS124,17CSL37,40,57,97,P,10,12019,Regular
4JN17CS124,17CSL38,32,26,58,P,6,12019,Regular
4JN17CS124,17KKM39,14,20,34,P,0,12019,Regular
4JN17CS127,17MAT31,31,33,64,P,7,12019,Regular
4JN17CS127,17CS32,33,38,71,P,8,12019,Regular
4JN17CS127,17CS33,25,14,39,F,0,12019,Regular
4JN17CS127,17CS34,27,23,50,P,6,12019,Regular
4JN17CS127,17CS35,22,35,57,P,6,12019,Regular
4JN17CS127,17CS36,34,33,67,P,7,12019,Regular
4JN17CS127,17CSL37,38,60,98,P,10,12019,Regular
4JN17CS127,17CSL38,33,51,84,P,9,12019,Regular
4JN17CS127,17KKM39,16,22,38,P,0,12019,Regular
4JN17CS128,17MAT31,34,42,76,P,8,12019,Regular
4JN17CS128,17CS32,29,24,53,P,6,12019,Regular
4JN17CS128,17CS33,28,23,51,P,6,12019,Regular
4JN17CS128,17CS34,33,24,57,P,6,12019,Regular
4JN17CS128,17CS35,19,21,40,P,4,12019,Regular
4JN17CS128,17CS36,32,15,47,F,0,12019,Regular
4JN17CS128,17CSL37,35,56,91,P,10,12019,Regular
4JN17CS128,17CSL38,31,30,61,P,7,12019,Regular
4JN17CS128,17KKM39,13,18,31,P,0,12019,Regular
4JN17CS129,17MAT31,29,28,57,P,6,12019,Regular
4JN17CS129,17CS32,33,30,63,P,7,12019,Regular
4JN17CS129,17CS33,30,21,51,P,6,12019,Regular
4JN17CS129,17CS34,27,29,56,P,6,12019,Regular
4JN17CS129,17CS35,22,37,59,P,6,12019,Regular
4JN17CS129,17CS36,30,25,55,P,6,12019,Regular
4JN17CS129,17CSL37,38,60,98,P,10,12019,Regular
4JN17CS129,17CSL38,34,55,89,P,9,12019,Regular
4JN17CS129,17KKM39,13,16,29,P,0,12019,Regular
4JN17CS130,17MAT31,33,44,77,P,8,12019,Regular
4JN17CS130,17CS32,32,42,74,P,8,12019,Regular
4JN17CS130,17CS33,26,23,49,P,5,12019,Regular
4JN17CS130,17CS34,23,21,44,P,4,12019,Regular
4JN17CS130,17CS35,19,33,52,P,6,12019,Regular
4JN17CS130,17CS36,30,22,52,P,6,12019,Regular
4JN17CS130,17CSL37,35,60,95,P,10,12019,Regular
4JN17CS130,17CSL38,30,45,75,P,8,12019,Regular
4JN17CS130,17KKM39,15,25,40,P,4,12019,Regular
4JN18CS400,17MATDIP31,0,0,0,A,0,12019,Regular
4JN18CS400,17MAT31,20,14,34,F,0,12019,Regular
4JN18CS400,17CS32,28,29,57,P,6,12019,Regular
4JN18CS400,17CS33,19,18,37,F,0,12019,Regular
4JN18CS400,17CS34,21,35,56,P,6,12019,Regular
4JN18CS400,17CS35,19,22,41,P,4,12019,Regular
4JN18CS400,17CS36,20,10,30,F,0,12019,Regular
4JN18CS400,17CSL37,30,30,60,P,7,12019,Regular
4JN18CS400,17CSL38,29,24,53,P,6,12019,Regular
4JN18CS400,17KKM39,12,21,33,P,0,12019,Regular
4JN18CS401,17MATDIP31,0,0,0,A,0,12019,Regular
4JN18CS401,17MAT31,20,14,34,F,0,12019,Regular
4JN18CS401,17CS32,30,34,64,P,7,12019,Regular
4JN18CS401,17CS33,30,21,51,P,6,12019,Regular
4JN18CS401,17CS34,32,27,59,P,6,12019,Regular
4JN18CS401,17CS35,27,31,58,P,6,12019,Regular
4JN18CS401,17CS36,26,15,41,F,0,12019,Regular
4JN18CS401,17CSL37,33,54,87,P,9,12019,Regular
4JN18CS401,17CSL38,29,27,56,P,6,12019,Regular
4JN18CS401,17KKM39,13,20,33,P,0,12019,Regular
4JN18CS404,17MATDIP31,0,0,0,A,0,12019,Regular
4JN18CS404,17MAT31,25,21,46,P,5,12019,Regular
4JN18CS404,17CS32,29,21,50,P,6,12019,Regular
4JN18CS404,17CS33,25,31,56,P,6,12019,Regular
4JN18CS404,17CS34,33,28,61,P,7,12019,Regular
4JN18CS404,17CS35,26,31,57,P,6,12019,Regular
4JN18CS404,17CS36,25,21,46,P,5,12019,Regular
4JN18CS404,17CSL37,33,51,84,P,9,12019,Regular
4JN18CS404,17CSL38,30,27,57,P,6,12019,Regular
4JN18CS404,17KKM39,12,18,30,P,0,12019,Regular
4JN18CS409,17MAT31,25,23,48,P,5,12019,Regular
4JN18CS409,17MATDIP31,0,0,0,A,0,12019,Regular
4JN18CS409,17CS32,33,18,51,F,0,12019,Regular
4JN18CS409,17CS33,26,24,50,P,6,12019,Regular
4JN18CS409,17CS34,29,21,50,P,6,12019,Regular
4JN18CS409,17CS35,24,31,55,P,6,12019,Regular
4JN18CS409,17CS36,27,21,48,P,5,12019,Regular
4JN18CS409,17CSL37,40,48,88,P,9,12019,Regular
4JN18CS409,17CSL38,30,27,57,P,6,12019,Regular
4JN18CS409,17KKM39,17,27,44,P,4,12019,Regular
4JN18CS411,17MATDIP31,0,0,0,A,0,12019,Regular
4JN18CS411,17MAT31,19,12,31,F,0,12019,Regular
4JN18CS411,17CS32,32,21,53,P,6,12019,Regular
4JN18CS411,17CS33,30,30,60,P,7,12019,Regular
4JN18CS411,17CS34,35,21,56,P,6,12019,Regular
4JN18CS411,17CS35,26,24,50,P,6,12019,Regular
4JN18CS411,17CS36,24,10,34,F,0,12019,Regular
4JN18CS411,17CSL37,38,36,74,P,8,12019,Regular
4JN18CS411,17CSL38,30,29,59,P,6,12019,Regular
4JN18CS411,17KKM39,17,19,36,P,0,12019,Regular
4JN18CS412,17MAT31,27,36,63,P,7,12019,Regular
4JN18CS412,17MATDIP31,0,23,23,P,0,12019,Regular
4JN18CS412,17CS32,33,33,66,P,7,12019,Regular
4JN18CS412,17CS33,32,23,55,P,6,12019,Regular
4JN18CS412,17CS34,30,23,53,P,6,12019,Regular
4JN18CS412,17CS35,27,35,62,P,7,12019,Regular
4JN18CS412,17CS36,29,24,53,P,6,12019,Regular
4JN18CS412,17CSL37,33,54,87,P,9,12019,Regular
4JN18CS412,17CSL38,34,30,64,P,7,12019,Regular
4JN18CS412,17KKM39,16,22,38,P,0,12019,Regular
4JN18CS413,17MAT31,24,24,48,P,5,12019,Regular
4JN18CS413,17MATDIP31,0,0,0,A,0,12019,Regular
4JN18CS413,17CS32,30,22,52,P,6,12019,Regular
4JN18CS413,17CS33,29,12,41,F,0,12019,Regular
4JN18CS413,17CS34,25,17,42,F,0,12019,Regular
4JN18CS413,17CS35,25,33,58,P,6,12019,Regular
4JN18CS413,17CS36,28,21,49,P,5,12019,Regular
4JN18CS413,17CSL37,35,57,92,P,10,12019,Regular
4JN18CS413,17CSL38,34,26,60,P,7,12019,Regular
4JN18CS413,17KKM39,15,22,37,P,0,12019,Regular
4JN18CS414,17MATDIP31,0,0,0,A,0,12019,Regular
4JN18CS414,17MAT31,21,14,35,F,0,12019,Regular
4JN18CS414,17CS32,30,10,40,F,0,12019,Regular
4JN18CS414,17CS33,26,15,41,F,0,12019,Regular
4JN18CS414,17CS34,29,8,37,F,0,12019,Regular
4JN18CS414,17CS35,20,26,46,P,5,12019,Regular
4JN18CS414,17CS36,21,9,30,F,0,12019,Regular
4JN18CS414,17CSL37,40,30,70,P,8,12019,Regular
4JN18CS414,17CSL38,30,26,56,P,6,12019,Regular
4JN18CS414,17KKM39,12,20,32,P,0,12019,Regular
4JN18CS416,17MATDIP31,0,0,0,A,0,12019,Regular
4JN18CS416,17MAT31,22,17,39,F,0,12019,Regular
4JN18CS416,17CS32,36,29,65,P,7,12019,Regular
4JN18CS416,17CS33,32,25,57,P,6,12019,Regular
4JN18CS416,17CS34,37,30,67,P,7,12019,Regular
4JN18CS416,17CS35,30,39,69,P,7,12019,Regular
4JN18CS416,17CS36,29,31,60,P,7,12019,Regular
4JN18CS416,17CSL37,35,54,89,P,9,12019,Regular
4JN18CS416,17CSL38,32,30,62,P,7,12019,Regular
4JN18CS416,17KKM39,12,28,40,P,4,12019,Regular
4JN18CS420,17MATDIP31,0,10,10,F,0,12019,Regular
4JN18CS420,17MAT31,19,8,27,F,0,12019,Regular
4JN18CS420,17CS32,27,14,41,F,0,12019,Regular
4JN18CS420,17CS33,25,18,43,F,0,12019,Regular
4JN18CS420,17CS34,31,22,53,P,6,12019,Regular
4JN18CS420,17CS35,22,21,43,P,4,12019,Regular
4JN18CS420,17CS36,20,5,25,F,0,12019,Regular
4JN18CS420,17CSL37,36,27,63,P,7,12019,Regular
4JN18CS420,17CSL38,30,29,59,P,6,12019,Regular
4JN18CS420,17KKM39,12,22,34,P,0,12019,Regular
4JN18CS422,17MAT31,24,21,45,P,5,12019,Regular
4JN18CS422,17MATDIP31,0,0,0,A,0,12019,Regular
4JN18CS422,17CS32,32,35,67,P,7,12019,Regular
4JN18CS422,17CS33,28,31,59,P,6,12019,Regular
4JN18CS422,17CS34,28,42,70,P,8,12019,Regular
4JN18CS422,17CS35,22,33,55,P,6,12019,Regular
4JN18CS422,17CS36,26,11,37,F,0,12019,Regular
4JN18CS422,17CSL37,35,30,65,P,7,12019,Regular
4JN18CS422,17CSL38,33,32,65,P,7,12019,Regular
4JN18CS422,17KKM39,15,21,36,P,0,12019,Regular
4JN18CS423,17MATDIP31,0,0,0,A,0,12019,Regular
4JN18CS423,17MAT31,21,13,34,F,0,12019,Regular
4JN18CS423,17CS32,33,33,66,P,7,12019,Regular
4JN18CS423,17CS33,30,33,63,P,7,12019,Regular
4JN18CS423,17CS34,26,26,52,P,6,12019,Regular
4JN18CS423,17CS35,23,32,55,P,6,12019,Regular
4JN18CS423,17CS36,29,21,50,P,6,12019,Regular
4JN18CS423,17CSL37,33,57,90,P,10,12019,Regular
4JN18CS423,17CSL38,33,30,63,P,7,12019,Regular
4JN18CS423,17KKM39,13,22,35,P,0,12019,Regular
4JN16CS004,17MAT31,28,32,60,P,7,12019,Regular
4JN16CS004,17CS32,28,26,54,P,6,12019,Regular
4JN16CS004,17CS33,34,21,55,P,6,12019,Regular
4JN16CS004,17CS34,30,21,51,P,6,12019,Regular
4JN16CS004,17CS35,26,21,47,P,5,12019,Regular
4JN16CS004,17CS36,32,21,53,P,6,12019,Regular
4JN16CS004,17CSL37,35,54,89,P,9,12019,Regular
4JN16CS004,17CSL38,35,32,67,P,7,12019,Regular
4JN16CS004,17KKM39,12,24,36,P,0,12019,Regular
4JN16CS068,17MAT31,36,36,72,P,8,12019,Regular
4JN16CS068,17CS32,32,41,73,P,8,12019,Regular
4JN16CS068,17CS33,34,29,63,P,7,12019,Regular
4JN16CS068,17CS34,30,21,51,P,6,12019,Regular
4JN16CS068,17CS35,25,27,52,P,6,12019,Regular
4JN16CS068,17CS36,37,30,67,P,7,12019,Regular
4JN16CS068,17CSL37,40,57,97,P,10,12019,Regular
4JN16CS068,17CSL38,39,40,79,P,8,12019,Regular
4JN16CS068,17KKM39,16,25,41,P,4,12019,Regular
4JN17CS002,17MAT31,30,23,53,P,6,12019,Regular
4JN17CS002,17CS32,26,33,59,P,6,12019,Regular
4JN17CS002,17CS33,24,23,47,P,5,12019,Regular
4JN17CS002,17CS34,22,25,47,P,5,12019,Regular
4JN17CS002,17CS35,20,21,41,P,4,12019,Regular
4JN17CS002,17CS36,33,29,62,P,7,12019,Regular
4JN17CS002,17CSL37,35,42,77,P,8,12019,Regular
4JN17CS002,17CSL38,35,41,76,P,8,12019,Regular
4JN17CS002,17KKM39,15,21,36,P,0,12019,Regular
4JN17CS004,17MAT31,40,51,91,P,10,12019,Regular
4JN17CS004,17CS32,34,43,77,P,8,12019,Regular
4JN17CS004,17CS33,34,30,64,P,7,12019,Regular
4JN17CS004,17CS34,30,32,62,P,7,12019,Regular
4JN17CS004,17CS35,29,36,65,P,7,12019,Regular
4JN17CS004,17CS36,36,31,67,P,7,12019,Regular
4JN17CS004,17CSL37,40,60,100,P,10,12019,Regular
4JN17CS004,17CSL38,40,58,98,P,10,12019,Regular
4JN17CS004,17KKM39,16,20,36,P,0,12019,Regular
4JN17CS010,17MAT31,32,37,69,P,7,12019,Regular
4JN17CS010,17CS32,34,35,69,P,7,12019,Regular
4JN17CS010,17CS33,28,29,57,P,6,12019,Regular
4JN17CS010,17CS34,27,34,61,P,7,12019,Regular
4JN17CS010,17CS35,22,21,43,P,4,12019,Regular
4JN17CS010,17CS36,26,22,48,P,5,12019,Regular
4JN17CS010,17CSL37,38,45,83,P,9,12019,Regular
4JN17CS010,17CSL38,33,58,91,P,10,12019,Regular
4JN17CS010,17KKM39,12,22,34,P,0,12019,Regular
4JN17CS012,17MAT31,36,31,67,P,7,12019,Regular
4JN17CS012,17CS32,33,31,64,P,7,12019,Regular
4JN17CS012,17CS33,30,21,51,P,6,12019,Regular
4JN17CS012,17CS34,28,27,55,P,6,12019,Regular
4JN17CS012,17CS35,30,40,70,P,8,12019,Regular
4JN17CS012,17CS36,38,25,63,P,7,12019,Regular
4JN17CS012,17CSL37,35,54,89,P,9,12019,Regular
4JN17CS012,17CSL38,36,58,94,P,10,12019,Regular
4JN17CS012,17KKM39,16,26,42,P,4,12019,Regular
4JN17CS013,17MAT31,30,44,74,P,8,12019,Regular
4JN17CS013,17CS32,26,31,57,P,6,12019,Regular
4JN17CS013,17CS33,27,32,59,P,6,12019,Regular
4JN17CS013,17CS34,25,29,54,P,6,12019,Regular
4JN17CS013,17CS35,24,21,45,P,5,12019,Regular
4JN17CS013,17CS36,30,32,62,P,7,12019,Regular
4JN17CS013,17CSL37,35,59,94,P,10,12019,Regular
4JN17CS013,17CSL38,34,45,79,P,8,12019,Regular
4JN17CS013,17KKM39,14,21,35,P,0,12019,Regular
4JN17CS013,17PCD23,26,37,63,P,7,12019,Backlog
4JN17CS014,17MAT31,40,52,92,P,10,12019,Regular
4JN17CS014,17CS32,40,36,76,P,8,12019,Regular
4JN17CS014,17CS33,39,33,72,P,8,12019,Regular
4JN17CS014,17CS34,33,48,81,P,9,12019,Regular
4JN17CS014,17CS35,32,36,68,P,7,12019,Regular
4JN17CS014,17CS36,36,49,85,P,9,12019,Regular
4JN17CS014,17CSL37,40,60,100,P,10,12019,Regular
4JN17CS014,17CSL38,40,58,98,P,10,12019,Regular
4JN17CS014,17KKM39,15,24,39,P,0,12019,Regular
4JN17CS016,17MAT31,38,49,87,P,9,12019,Regular
4JN17CS016,17CS32,38,35,73,P,8,12019,Regular
4JN17CS016,17CS33,37,33,70,P,8,12019,Regular
4JN17CS016,17CS34,37,36,73,P,8,12019,Regular
4JN17CS016,17CS35,33,50,83,P,9,12019,Regular
4JN17CS016,17CS36,40,32,72,P,8,12019,Regular
4JN17CS016,17CSL37,40,59,99,P,10,12019,Regular
4JN17CS016,17CSL38,37,58,95,P,10,12019,Regular
4JN17CS016,17KKM39,17,30,47,P,5,12019,Regular
4JN17CS019,17MAT31,38,48,86,P,9,12019,Regular
4JN17CS019,17CS32,40,58,98,P,10,12019,Regular
4JN17CS019,17CS33,35,33,68,P,7,12019,Regular
4JN17CS019,17CS34,37,31,68,P,7,12019,Regular
4JN17CS019,17CS35,36,41,77,P,8,12019,Regular
4JN17CS019,17CS36,38,30,68,P,7,12019,Regular
4JN17CS019,17CSL37,40,60,100,P,10,12019,Regular
4JN17CS019,17CSL38,39,59,98,P,10,12019,Regular
4JN17CS019,17KKM39,16,29,45,P,5,12019,Regular
4JN17CS025,17MAT31,33,45,78,P,8,12019,Regular
4JN17CS025,17CS32,29,29,58,P,6,12019,Regular
4JN17CS025,17CS33,36,29,65,P,7,12019,Regular
4JN17CS025,17CS34,29,24,53,P,6,12019,Regular
4JN17CS025,17CS35,25,41,66,P,7,12019,Regular
4JN17CS025,17CS36,35,30,65,P,7,12019,Regular
4JN17CS025,17CSL37,40,57,97,P,10,12019,Regular
4JN17CS025,17CSL38,38,58,96,P,10,12019,Regular
4JN17CS025,17KKM39,15,22,37,P,0,12019,Regular
4JN17CS026,17MAT31,35,41,76,P,8,12019,Regular
4JN17CS026,17CS32,29,41,70,P,8,12019,Regular
4JN17CS026,17CS33,33,42,75,P,8,12019,Regular
4JN17CS026,17CS34,33,27,60,P,7,12019,Regular
4JN17CS026,17CS35,26,33,59,P,6,12019,Regular
4JN17CS026,17CS36,38,35,73,P,8,12019,Regular
4JN17CS026,17CSL37,38,60,98,P,10,12019,Regular
4JN17CS026,17CSL38,39,54,93,P,10,12019,Regular
4JN17CS026,17KKM39,14,25,39,P,0,12019,Regular
4JN17CS030,17MAT31,31,43,74,P,8,12019,Regular
4JN17CS030,17CS32,25,33,58,P,6,12019,Regular
4JN17CS030,17CS33,24,17,41,F,0,12019,Regular
4JN17CS030,17CS34,24,29,53,P,6,12019,Regular
4JN17CS030,17CS35,23,21,44,P,4,12019,Regular
4JN17CS030,17CS36,35,11,46,F,0,12019,Regular
4JN17CS030,17CSL37,40,57,97,P,10,12019,Regular
4JN17CS030,17CSL38,36,48,84,P,9,12019,Regular
4JN17CS030,17KKM39,15,23,38,P,0,12019,Regular
4JN17CS031,17MAT31,32,30,62,P,7,12019,Regular
4JN17CS031,17CS32,35,46,81,P,9,12019,Regular
4JN17CS031,17CS33,32,24,56,P,6,12019,Regular
4JN17CS031,17CS34,36,50,86,P,9,12019,Regular
4JN17CS031,17CS35,31,40,71,P,8,12019,Regular
4JN17CS031,17CS36,32,26,58,P,6,12019,Regular
4JN17CS031,17CSL37,40,59,99,P,10,12019,Regular
4JN17CS031,17CSL38,38,39,77,P,8,12019,Regular
4JN17CS031,17KKK39,16,21,37,P,0,12019,Regular
4JN17CS032,17MAT31,26,24,50,P,6,12019,Regular
4JN17CS032,17CS32,28,29,57,P,6,12019,Regular
4JN17CS032,17CS33,27,15,42,F,0,12019,Regular
4JN17CS032,17CS34,22,23,45,P,5,12019,Regular
4JN17CS032,17CS35,24,32,56,P,6,12019,Regular
4JN17CS032,17CS36,29,21,50,P,6,12019,Regular
4JN17CS032,17CSL37,35,42,77,P,8,12019,Regular
4JN17CS032,17CSL38,34,30,64,P,7,12019,Regular
4JN17CS032,17KKM39,14,22,36,P,0,12019,Regular
4JN17CS035,17MAT31,22,32,54,P,6,12019,Regular
4JN17CS035,17CS32,31,32,63,P,7,12019,Regular
4JN17CS035,17CS33,28,23,51,P,6,12019,Regular
4JN17CS035,17CS34,24,23,47,P,5,12019,Regular
4JN17CS035,17CS35,23,29,52,P,6,12019,Regular
4JN17CS035,17CS36,33,21,54,P,6,12019,Regular
4JN17CS035,17CSL37,38,36,74,P,8,12019,Regular
4JN17CS035,17CSL38,35,32,67,P,7,12019,Regular
4JN17CS035,17KKM39,14,22,36,P,0,12019,Regular
4JN17CS038,17MAT31,40,51,91,P,10,12019,Regular
4JN17CS038,17CS32,38,41,79,P,8,12019,Regular
4JN17CS038,17CS33,40,24,64,P,7,12019,Regular
4JN17CS038,17CS34,34,39,73,P,8,12019,Regular
4JN17CS038,17CS35,33,44,77,P,8,12019,Regular
4JN17CS038,17CS36,40,41,81,P,9,12019,Regular
4JN17CS038,17CSL37,40,60,100,P,10,12019,Regular
4JN17CS038,17CSL38,40,59,99,P,10,12019,Regular
4JN17CS038,17KKM39,17,26,43,P,4,12019,Regular
4JN17CS039,17MAT31,40,55,95,P,10,12019,Regular
4JN17CS039,17CS32,40,47,87,P,9,12019,Regular
4JN17CS039,17CS33,38,35,73,P,8,12019,Regular
4JN17CS039,17CS34,40,35,75,P,8,12019,Regular
4JN17CS039,17CS35,37,42,79,P,8,12019,Regular
4JN17CS039,17CS36,39,45,84,P,9,12019,Regular
4JN17CS039,17CSL37,40,60,100,P,10,12019,Regular
4JN17CS039,17CSL38,38,60,98,P,10,12019,Regular
4JN17CS039,17KKM39,17,27,44,P,4,12019,Regular
4JN17CS044,17MAT31,32,50,82,P,9,12019,Regular
4JN17CS044,17CS32,29,38,67,P,7,12019,Regular
4JN17CS044,17CS33,27,23,50,P,6,12019,Regular
4JN17CS044,17CS34,25,28,53,P,6,12019,Regular
4JN17CS044,17CS35,28,38,66,P,7,12019,Regular
4JN17CS044,17CS36,35,21,56,P,6,12019,Regular
4JN17CS044,17CSL37,35,51,86,P,9,12019,Regular
4JN17CS044,17CSL38,30,39,69,P,7,12019,Regular
4JN17CS044,17KKM39,12,14,26,P,0,12019,Regular
4JN17CS045,17MAT31,36,41,77,P,8,12019,Regular
4JN17CS045,17CS32,31,40,71,P,8,12019,Regular
4JN17CS045,17CS33,35,38,73,P,8,12019,Regular
4JN17CS045,17CS34,34,40,74,P,8,12019,Regular
4JN17CS045,17CS35,33,42,75,P,8,12019,Regular
4JN17CS045,17CS36,36,33,69,P,7,12019,Regular
4JN17CS045,17CSL37,40,59,99,P,10,12019,Regular
4JN17CS045,17CSL38,37,54,91,P,10,12019,Regular
4JN17CS045,17KKM39,12,24,36,P,0,12019,Regular
4JN17CS047,17MAT31,35,34,69,P,7,12019,Regular
4JN17CS047,17CS32,33,38,71,P,8,12019,Regular
4JN17CS047,17CS33,25,22,47,P,5,12019,Regular
4JN17CS047,17CS34,25,24,49,P,5,12019,Regular
4JN17CS047,17CS35,25,26,51,P,6,12019,Regular
4JN17CS047,17CS36,37,24,61,P,7,12019,Regular
4JN17CS047,17CSL37,35,36,71,P,8,12019,Regular
4JN17CS047,17CSL38,36,30,66,P,7,12019,Regular
4JN17CS047,17KKM39,16,27,43,P,4,12019,Regular
4JN17CS048,17MAT31,28,30,58,P,6,12019,Regular
4JN17CS048,17CS32,31,26,57,P,6,12019,Regular
4JN17CS048,17CS33,28,28,56,P,6,12019,Regular
4JN17CS048,17CS34,30,33,63,P,7,12019,Regular
4JN17CS048,17CS35,25,21,46,P,5,12019,Regular
4JN17CS048,17CS36,36,21,57,P,6,12019,Regular
4JN17CS048,17CSL37,35,60,95,P,10,12019,Regular
4JN17CS048,17CSL38,34,39,73,P,8,12019,Regular
4JN17CS048,17KKM39,12,21,33,P,0,12019,Regular
4JN17CS057,17MAT31,30,35,65,P,7,12019,Regular
4JN17CS057,17CS32,28,29,57,P,6,12019,Regular
4JN17CS057,17CS33,30,28,58,P,6,12019,Regular
4JN17CS057,17CS34,26,29,55,P,6,12019,Regular
4JN17CS057,17CS35,24,30,54,P,6,12019,Regular
4JN17CS057,17CS36,34,30,64,P,7,12019,Regular
4JN17CS057,17CSL37,35,60,95,P,10,12019,Regular
4JN17CS057,17CSL38,37,47,84,P,9,12019,Regular
4JN17CS057,17KKM39,14,23,37,P,0,12019,Regular
4JN17CS063,17MAT31,30,33,63,P,7,12019,Regular
4JN17CS063,17CS32,25,36,61,P,7,12019,Regular
4JN17CS063,17CS33,27,21,48,P,5,12019,Regular
4JN17CS063,17CS34,22,32,54,P,6,12019,Regular
4JN17CS063,17CS35,21,32,53,P,6,12019,Regular
4JN17CS063,17CS36,36,35,71,P,8,12019,Regular
4JN17CS063,17CSL37,40,42,82,P,9,12019,Regular
4JN17CS063,17CSL38,36,36,72,P,8,12019,Regular
4JN17CS063,17KKM39,14,22,36,P,0,12019,Regular
4JN17CS066,17MAT31,34,40,74,P,8,12019,Regular
4JN17CS066,17CS32,32,36,68,P,7,12019,Regular
4JN17CS066,17CS33,36,23,59,P,6,12019,Regular
4JN17CS066,17CS34,34,36,70,P,8,12019,Regular
4JN17CS066,17CS35,30,40,70,P,8,12019,Regular
4JN17CS066,17CS36,37,24,61,P,7,12019,Regular
4JN17CS066,17CSL37,40,59,99,P,10,12019,Regular
4JN17CS066,17CSL38,39,50,89,P,9,12019,Regular
4JN17CS066,17KKM39,13,25,38,P,0,12019,Regular
4JN17CS068,17MAT31,27,24,51,P,6,12019,Regular
4JN17CS068,17CS32,31,35,66,P,7,12019,Regular
4JN17CS068,17CS33,28,21,49,P,5,12019,Regular
4JN17CS068,17CS34,22,32,54,P,6,12019,Regular
4JN17CS068,17CS35,25,34,59,P,6,12019,Regular
4JN17CS068,17CS36,35,26,61,P,7,12019,Regular
4JN17CS068,17CSL37,40,60,100,P,10,12019,Regular
4JN17CS068,17CSL38,37,48,85,P,9,12019,Regular
4JN17CS068,17KKM39,14,23,37,P,0,12019,Regular
4JN17CS071,17MAT31,19,21,40,P,4,12019,Regular
4JN17CS071,17CS32,20,29,49,P,5,12019,Regular
4JN17CS071,17CS33,22,23,45,P,5,12019,Regular
4JN17CS071,17CS34,26,30,56,P,6,12019,Regular
4JN17CS071,17CS35,23,36,59,P,6,12019,Regular
4JN17CS071,17CS36,28,9,37,F,0,12019,Regular
4JN17CS071,17CSL37,35,57,92,P,10,12019,Regular
4JN17CS071,17CSL38,37,38,75,P,8,12019,Regular
4JN17CS071,17KKK39,15,24,39,P,0,12019,Regular
4JN17CS071,17ELN25,24,21,45,P,5,12019,Backlog
4JN17CS071,17CPL26,38,51,89,P,9,12019,Backlog
4JN17CS073,17MAT31,30,24,54,P,6,12019,Regular
4JN17CS073,17CS32,32,37,69,P,7,12019,Regular
4JN17CS073,17CS33,33,29,62,P,7,12019,Regular
4JN17CS073,17CS34,25,31,56,P,6,12019,Regular
4JN17CS073,17CS35,23,31,54,P,6,12019,Regular
4JN17CS073,17CS36,34,8,42,F,0,12019,Regular
4JN17CS073,17CSL37,35,54,89,P,9,12019,Regular
4JN17CS073,17CSL38,38,59,97,P,10,12019,Regular
4JN17CS073,17KKM39,12,22,34,P,0,12019,Regular
4JN17CS074,17MAT31,36,47,83,P,9,12019,Regular
4JN17CS074,17CS32,30,35,65,P,7,12019,Regular
4JN17CS074,17CS33,25,24,49,P,5,12019,Regular
4JN17CS074,17CS34,27,28,55,P,6,12019,Regular
4JN17CS074,17CS35,25,25,50,P,6,12019,Regular
4JN17CS074,17CS36,34,39,73,P,8,12019,Regular
4JN17CS074,17CSL37,35,60,95,P,10,12019,Regular
4JN17CS074,17CSL38,35,48,83,P,9,12019,Regular
4JN17CS074,17KKM39,15,23,38,P,0,12019,Regular
4JN17CS076,17MAT31,33,33,66,P,7,12019,Regular
4JN17CS076,17CS32,37,50,87,P,9,12019,Regular
4JN17CS076,17CS33,29,22,51,P,6,12019,Regular
4JN17CS076,17CS34,22,21,43,P,4,12019,Regular
4JN17CS076,17CS35,23,21,44,P,4,12019,Regular
4JN17CS076,17CS36,34,42,76,P,8,12019,Regular
4JN17CS076,17CSL37,40,57,97,P,10,12019,Regular
4JN17CS076,17CSL38,35,56,91,P,10,12019,Regular
4JN17CS076,17KKM39,16,23,39,P,0,12019,Regular
4JN17CS081,17MAT31,30,38,68,P,7,12019,Regular
4JN17CS081,17CS32,24,27,51,P,6,12019,Regular
4JN17CS081,17CS33,21,21,42,P,4,12019,Regular
4JN17CS081,17CS34,20,32,52,P,6,12019,Regular
4JN17CS081,17CS35,22,21,43,P,4,12019,Regular
4JN17CS081,17CS36,25,36,61,P,7,12019,Regular
4JN17CS081,17CSL37,38,59,97,P,10,12019,Regular
4JN17CS081,17CSL38,36,41,77,P,8,12019,Regular
4JN17CS081,17KKK39,14,22,36,P,0,12019,Regular
4JN17CS084,17MAT31,36,34,70,P,8,12019,Regular
4JN17CS084,17CS32,31,26,57,P,6,12019,Regular
4JN17CS084,17CS33,27,21,48,P,5,12019,Regular
4JN17CS084,17CS34,31,24,55,P,6,12019,Regular
4JN17CS084,17CS35,25,38,63,P,7,12019,Regular
4JN17CS084,17CS36,35,21,56,P,6,12019,Regular
4JN17CS084,17CSL37,40,54,94,P,10,12019,Regular
4JN17CS084,17CSL38,36,50,86,P,9,12019,Regular
4JN17CS084,17KKM39,13,24,37,P,0,12019,Regular
4JN17CS086,17MAT31,24,21,45,P,5,12019,Regular
4JN17CS086,17CS32,20,32,52,P,6,12019,Regular
4JN17CS086,17CS33,22,23,45,P,5,12019,Regular
4JN17CS086,17CS34,20,17,37,F,0,12019,Regular
4JN17CS086,17CS35,19,5,24,F,0,12019,Regular
4JN17CS086,17CS36,30,11,41,F,0,12019,Regular
4JN17CS086,17CSL37,20,39,59,P,6,12019,Regular
4JN17CS086,17CSL38,30,48,78,P,8,12019,Regular
4JN17CS086,17KKM39,12,21,33,P,0,12019,Regular
4JN17CS086,17MAT21,19,21,40,P,4,12019,Backlog
4JN17CS086,17ELE25,21,6,27,F,0,12019,Backlog
4JN17CS086,17ELN15,28,10,38,F,0,12019,Backlog
4JN17CS089,17MAT31,39,54,93,P,10,12019,Regular
4JN17CS089,17CS32,36,39,75,P,8,12019,Regular
4JN17CS089,17CS33,40,41,81,P,9,12019,Regular
4JN17CS089,17CS34,38,31,69,P,7,12019,Regular
4JN17CS089,17CS35,38,42,80,P,9,12019,Regular
4JN17CS089,17CS36,38,39,77,P,8,12019,Regular
4JN17CS089,17CSL37,40,60,100,P,10,12019,Regular
4JN17CS089,17CSL38,40,59,99,P,10,12019,Regular
4JN17CS089,17KKM39,17,27,44,P,4,12019,Regular
4JN17CS093,17MAT31,37,51,88,P,9,12019,Regular
4JN17CS093,17CS32,36,43,79,P,8,12019,Regular
4JN17CS093,17CS33,36,31,67,P,7,12019,Regular
4JN17CS093,17CS34,36,32,68,P,7,12019,Regular
4JN17CS093,17CS35,33,38,71,P,8,12019,Regular
4JN17CS093,17CS36,40,37,77,P,8,12019,Regular
4JN17CS093,17CSL37,40,59,99,P,10,12019,Regular
4JN17CS093,17CSL38,38,59,97,P,10,12019,Regular
4JN17CS093,17KKM39,16,28,44,P,4,12019,Regular
4JN17CS095,17MAT31,39,47,86,P,9,12019,Regular
4JN17CS095,17CS32,33,53,86,P,9,12019,Regular
4JN17CS095,17CS33,39,39,78,P,8,12019,Regular
4JN17CS095,17CS34,33,28,61,P,7,12019,Regular
4JN17CS095,17CS35,35,34,69,P,7,12019,Regular
4JN17CS095,17CS36,36,21,57,P,6,12019,Regular
4JN17CS095,17CSL37,40,60,100,P,10,12019,Regular
4JN17CS095,17CSL38,39,56,95,P,10,12019,Regular
4JN17CS095,17KKM39,16,27,43,P,4,12019,Regular
4JN17CS096,17MAT31,39,39,78,P,8,12019,Regular
4JN17CS096,17CS32,37,38,75,P,8,12019,Regular
4JN17CS096,17CS33,39,33,72,P,8,12019,Regular
4JN17CS096,17CS34,34,35,69,P,7,12019,Regular
4JN17CS096,17CS35,31,43,74,P,8,12019,Regular
4JN17CS096,17CS36,37,26,63,P,7,12019,Regular
4JN17CS096,17CSL37,40,60,100,P,10,12019,Regular
4JN17CS096,17CSL38,39,59,98,P,10,12019,Regular
4JN17CS096,17KKM39,19,26,45,P,5,12019,Regular
4JN17CS099,17MAT31,40,56,96,P,10,12019,Regular
4JN17CS099,17CS32,35,37,72,P,8,12019,Regular
4JN17CS099,17CS33,34,39,73,P,8,12019,Regular
4JN17CS099,17CS34,34,28,62,P,7,12019,Regular
4JN17CS099,17CS35,31,27,58,P,6,12019,Regular
4JN17CS099,17CS36,38,26,64,P,7,12019,Regular
4JN17CS099,17CSL37,40,59,99,P,10,12019,Regular
4JN17CS099,17CSL38,39,59,98,P,10,12019,Regular
4JN17CS099,17KKM39,13,23,36,P,0,12019,Regular
4JN17CS100,17MAT31,38,50,88,P,9,12019,Regular
4JN17CS100,17CS32,38,40,78,P,8,12019,Regular
4JN17CS100,17CS33,35,42,77,P,8,12019,Regular
4JN17CS100,17CS34,38,38,76,P,8,12019,Regular
4JN17CS100,17CS35,33,45,78,P,8,12019,Regular
4JN17CS100,17CS36,40,39,79,P,8,12019,Regular
4JN17CS100,17CSL37,40,60,100,P,10,12019,Regular
4JN17CS100,17CSL38,37,51,88,P,9,12019,Regular
4JN17CS100,17KKM39,17,26,43,P,4,12019,Regular
4JN17CS101,17MAT31,25,36,61,P,7,12019,Regular
4JN17CS101,17CS32,30,28,58,P,6,12019,Regular
4JN17CS101,17CS33,27,24,51,P,6,12019,Regular
4JN17CS101,17CS34,23,21,44,P,4,12019,Regular
4JN17CS101,17CS35,23,36,59,P,6,12019,Regular
4JN17CS101,17CS36,32,7,39,F,0,12019,Regular
4JN17CS101,17CSL37,35,60,95,P,10,12019,Regular
4JN17CS101,17CSL38,38,30,68,P,7,12019,Regular
4JN17CS101,17KKM39,14,16,30,P,0,12019,Regular
4JN17CS101,17PCD23,33,24,57,P,6,12019,Backlog
4JN17CS102,17MAT31,22,29,51,P,6,12019,Regular
4JN17CS102,17CS32,29,32,61,P,7,12019,Regular
4JN17CS102,17CS33,30,33,63,P,7,12019,Regular
4JN17CS102,17CS34,27,23,50,P,6,12019,Regular
4JN17CS102,17CS35,22,22,44,P,4,12019,Regular
4JN17CS102,17CS36,33,21,54,P,6,12019,Regular
4JN17CS102,17CSL37,38,59,97,P,10,12019,Regular
4JN17CS102,17CSL38,38,42,80,P,9,12019,Regular
4JN17CS102,17KKM39,14,23,37,P,0,12019,Regular
4JN17CS105,17MAT31,38,43,81,P,9,12019,Regular
4JN17CS105,17CS32,29,47,76,P,8,12019,Regular
4JN17CS105,17CS33,33,33,66,P,7,12019,Regular
4JN17CS105,17CS34,30,28,58,P,6,12019,Regular
4JN17CS105,17CS35,28,30,58,P,6,12019,Regular
4JN17CS105,17CS36,36,32,68,P,7,12019,Regular
4JN17CS105,17CSL37,40,59,99,P,10,12019,Regular
4JN17CS105,17CSL38,40,38,78,P,8,12019,Regular
4JN17CS105,17KKM39,14,19,33,P,0,12019,Regular
4JN17CS106,17MAT31,36,40,76,P,8,12019,Regular
4JN17CS106,17CS32,37,41,78,P,8,12019,Regular
4JN17CS106,17CS33,32,32,64,P,7,12019,Regular
4JN17CS106,17CS34,36,31,67,P,7,12019,Regular
4JN17CS106,17CS35,29,36,65,P,7,12019,Regular
4JN17CS106,17CS36,38,24,62,P,7,12019,Regular
4JN17CS106,17CSL37,40,60,100,P,10,12019,Regular
4JN17CS106,17CSL38,39,30,69,P,7,12019,Regular
4JN17CS106,17KKM39,15,24,39,P,0,12019,Regular
4JN17CS107,17MAT31,37,48,85,P,9,12019,Regular
4JN17CS107,17CS32,40,40,80,P,9,12019,Regular
4JN17CS107,17CS33,39,32,71,P,8,12019,Regular
4JN17CS107,17CS34,36,43,79,P,8,12019,Regular
4JN17CS107,17CS35,37,45,82,P,9,12019,Regular
4JN17CS107,17CS36,40,47,87,P,9,12019,Regular
4JN17CS107,17CSL37,40,60,100,P,10,12019,Regular
4JN17CS107,17CSL38,40,60,100,P,10,12019,Regular
4JN17CS107,17KKM39,13,29,42,P,4,12019,Regular
4JN17CS111,17MAT31,24,33,57,P,6,12019,Regular
4JN17CS111,17CS32,30,46,76,P,8,12019,Regular
4JN17CS111,17CS33,33,37,70,P,8,12019,Regular
4JN17CS111,17CS34,33,34,67,P,7,12019,Regular
4JN17CS111,17CS35,31,54,85,P,9,12019,Regular
4JN17CS111,17CS36,33,21,54,P,6,12019,Regular
4JN17CS111,17CSL37,40,60,100,P,10,12019,Regular
4JN17CS111,17CSL38,38,39,77,P,8,12019,Regular
4JN17CS111,17KKM39,13,20,33,P,0,12019,Regular
4JN17CS112,17MAT31,34,39,73,P,8,12019,Regular
4JN17CS112,17CS32,29,27,56,P,6,12019,Regular
4JN17CS112,17CS33,31,23,54,P,6,12019,Regular
4JN17CS112,17CS34,31,24,55,P,6,12019,Regular
4JN17CS112,17CS35,25,33,58,P,6,12019,Regular
4JN17CS112,17CS36,37,27,64,P,7,12019,Regular
4JN17CS112,17CSL37,40,57,97,P,10,12019,Regular
4JN17CS112,17CSL38,36,27,63,P,7,12019,Regular
4JN17CS112,17KKM39,14,19,33,P,0,12019,Regular
4JN17CS113,17MAT31,32,41,73,P,8,12019,Regular
4JN17CS113,17CS32,26,38,64,P,7,12019,Regular
4JN17CS113,17CS33,29,28,57,P,6,12019,Regular
4JN17CS113,17CS34,31,27,58,P,6,12019,Regular
4JN17CS113,17CS35,31,40,71,P,8,12019,Regular
4JN17CS113,17CS36,31,29,60,P,7,12019,Regular
4JN17CS113,17CSL37,35,60,95,P,10,12019,Regular
4JN17CS113,17CSL38,34,27,61,P,7,12019,Regular
4JN17CS113,17KKM39,12,23,35,P,0,12019,Regular
4JN17CS116,17MAT31,31,39,70,P,8,12019,Regular
4JN17CS116,17CS32,37,40,77,P,8,12019,Regular
4JN17CS116,17CS33,37,35,72,P,8,12019,Regular
4JN17CS116,17CS34,34,33,67,P,7,12019,Regular
4JN17CS116,17CS35,34,36,70,P,8,12019,Regular
4JN17CS116,17CS36,37,30,67,P,7,12019,Regular
4JN17CS116,17CSL37,40,60,100,P,10,12019,Regular
4JN17CS116,17CSL38,38,57,95,P,10,12019,Regular
4JN17CS116,17KKM39,16,18,34,P,0,12019,Regular
4JN17CS117,17MAT31,31,47,78,P,8,12019,Regular
4JN17CS117,17CS32,34,37,71,P,8,12019,Regular
4JN17CS117,17CS33,33,28,61,P,7,12019,Regular
4JN17CS117,17CS34,29,31,60,P,7,12019,Regular
4JN17CS117,17CS35,31,47,78,P,8,12019,Regular
4JN17CS117,17CS36,38,42,80,P,9,12019,Regular
4JN17CS117,17CSL37,40,60,100,P,10,12019,Regular
4JN17CS117,17CSL38,35,27,62,P,7,12019,Regular
4JN17CS117,17KKM39,14,27,41,P,4,12019,Regular
4JN17CS118,17MAT31,32,46,78,P,8,12019,Regular
4JN17CS118,17CS32,33,44,77,P,8,12019,Regular
4JN17CS118,17CS33,37,29,66,P,7,12019,Regular
4JN17CS118,17CS34,30,23,53,P,6,12019,Regular
4JN17CS118,17CS35,33,33,66,P,7,12019,Regular
4JN17CS118,17CS36,37,33,70,P,8,12019,Regular
4JN17CS118,17CSL37,39,57,96,P,10,12019,Regular
4JN17CS118,17CSL38,37,57,94,P,10,12019,Regular
4JN17CS118,17KKM39,17,23,40,P,4,12019,Regular
4JN17CS119,17MAT31,32,35,67,P,7,12019,Regular
4JN17CS119,17CS32,32,39,71,P,8,12019,Regular
4JN17CS119,17CS33,36,26,62,P,7,12019,Regular
4JN17CS119,17CS34,23,40,63,P,7,12019,Regular
4JN17CS119,17CS35,27,21,48,P,5,12019,Regular
4JN17CS119,17CS36,37,36,73,P,8,12019,Regular
4JN17CS119,17CSL37,40,57,97,P,10,12019,Regular
4JN17CS119,17CSL38,33,39,72,P,8,12019,Regular
4JN17CS119,17KKM39,12,19,31,P,0,12019,Regular
4JN17CS120,17MAT31,37,36,73,P,8,12019,Regular
4JN17CS120,17CS32,31,27,58,P,6,12019,Regular
4JN17CS120,17CS33,30,26,56,P,6,12019,Regular
4JN17CS120,17CS34,31,26,57,P,6,12019,Regular
4JN17CS120,17CS35,25,30,55,P,6,12019,Regular
4JN17CS120,17CS36,36,21,57,P,6,12019,Regular
4JN17CS120,17CSL37,38,60,98,P,10,12019,Regular
4JN17CS120,17CSL38,37,42,79,P,8,12019,Regular
4JN17CS120,17KKM39,13,24,37,P,0,12019,Regular
4JN17CS121,17MAT31,25,25,50,P,6,12019,Regular
4JN17CS121,17CS32,32,32,64,P,7,12019,Regular
4JN17CS121,17CS33,26,18,44,F,0,12019,Regular
4JN17CS121,17CS34,21,15,36,F,0,12019,Regular
4JN17CS121,17CS35,21,21,42,P,4,12019,Regular
4JN17CS121,17CS36,32,25,57,P,6,12019,Regular
4JN17CS121,17CSL37,40,59,99,P,10,12019,Regular
4JN17CS121,17CSL38,38,48,86,P,9,12019,Regular
4JN17CS121,17KKM39,12,25,37,P,0,12019,Regular
4JN17CS125,17MAT31,32,37,69,P,7,12019,Regular
4JN17CS125,17CS32,30,33,63,P,7,12019,Regular
4JN17CS125,17CS33,32,26,58,P,6,12019,Regular
4JN17CS125,17CS34,23,21,44,P,4,12019,Regular
4JN17CS125,17CS35,27,21,48,P,5,12019,Regular
4JN17CS125,17CS36,36,21,57,P,6,12019,Regular
4JN17CS125,17CSL37,40,55,95,P,10,12019,Regular
4JN17CS125,17CSL38,37,45,82,P,9,12019,Regular
4JN17CS125,17KKM39,14,17,31,P,0,12019,Regular
4JN17CS126,17MAT31,25,15,40,F,0,12019,Regular
4JN17CS126,17CS32,24,27,51,P,6,12019,Regular
4JN17CS126,17CS33,23,32,55,P,6,12019,Regular
4JN17CS126,17CS34,28,26,54,P,6,12019,Regular
4JN17CS126,17CS35,27,44,71,P,8,12019,Regular
4JN17CS126,17CS36,35,21,56,P,6,12019,Regular
4JN17CS126,17CSL37,40,59,99,P,10,12019,Regular
4JN17CS126,17CSL38,36,27,63,P,7,12019,Regular
4JN17CS126,17KKM39,14,23,37,P,0,12019,Regular
4JN18CS402,17MATDIP31,0,8,8,F,0,12019,Regular
4JN18CS402,17MAT31,21,21,42,P,4,12019,Regular
4JN18CS402,17CS32,28,22,50,P,6,12019,Regular
4JN18CS402,17CS33,28,33,61,P,7,12019,Regular
4JN18CS402,17CS34,28,21,49,P,5,12019,Regular
4JN18CS402,17CS35,28,24,52,P,6,12019,Regular
4JN18CS402,17CS36,35,29,64,P,7,12019,Regular
4JN18CS402,17CSL37,35,30,65,P,7,12019,Regular
4JN18CS402,17CSL38,36,27,63,P,7,12019,Regular
4JN18CS402,17KKM39,16,21,37,P,0,12019,Regular
4JN18CS403,17MATDIP31,0,0,0,A,0,12019,Regular
4JN18CS403,17MAT31,24,17,41,F,0,12019,Regular
4JN18CS403,17CS32,29,27,56,P,6,12019,Regular
4JN18CS403,17CS33,33,23,56,P,6,12019,Regular
4JN18CS403,17CS34,28,24,52,P,6,12019,Regular
4JN18CS403,17CS35,31,34,65,P,7,12019,Regular
4JN18CS403,17CS36,32,21,53,P,6,12019,Regular
4JN18CS403,17CSL37,38,54,92,P,10,12019,Regular
4JN18CS403,17CSL38,36,27,63,P,7,12019,Regular
4JN18CS403,17KKM39,13,28,41,P,4,12019,Regular
4JN18CS405,17MATDIP31,0,0,0,A,0,12019,Regular
4JN18CS405,17MAT31,24,21,45,P,5,12019,Regular
4JN18CS405,17CS32,32,30,62,P,7,12019,Regular
4JN18CS405,17CS33,33,21,54,P,6,12019,Regular
4JN18CS405,17CS34,27,32,59,P,6,12019,Regular
4JN18CS405,17CS35,28,36,64,P,7,12019,Regular
4JN18CS405,17CS36,30,22,52,P,6,12019,Regular
4JN18CS405,17CSL37,35,54,89,P,9,12019,Regular
4JN18CS405,17CSL38,38,39,77,P,8,12019,Regular
4JN18CS405,17KKM39,16,24,40,P,4,12019,Regular
4JN18CS406,17MAT31,20,21,41,P,4,12019,Regular
4JN18CS406,17MATDIP31,0,3,3,F,0,12019,Regular
4JN18CS406,17CS32,27,25,52,P,6,12019,Regular
4JN18CS406,17CS33,25,18,43,F,0,12019,Regular
4JN18CS406,17CS34,29,12,41,F,0,12019,Regular
4JN18CS406,17CS35,27,31,58,P,6,12019,Regular
4JN18CS406,17CS36,28,11,39,F,0,12019,Regular
4JN18CS406,17CSL37,38,57,95,P,10,12019,Regular
4JN18CS406,17CSL38,34,50,84,P,9,12019,Regular
4JN18CS406,17KKM39,18,23,41,P,4,12019,Regular
4JN18CS407,17MATDIP31,0,0,0,A,0,12019,Regular
4JN18CS407,17MAT31,26,23,49,P,5,12019,Regular
4JN18CS407,17CS32,31,27,58,P,6,12019,Regular
4JN18CS407,17CS33,34,31,65,P,7,12019,Regular
4JN18CS407,17CS34,29,28,57,P,6,12019,Regular
4JN18CS407,17CS35,33,44,77,P,8,12019,Regular
4JN18CS407,17CS36,32,21,53,P,6,12019,Regular
4JN18CS407,17CSL37,35,54,89,P,9,12019,Regular
4JN18CS407,17CSL38,35,27,62,P,7,12019,Regular
4JN18CS407,17KKM39,16,22,38,P,0,12019,Regular
4JN18CS408,17MATDIP31,0,0,0,A,0,12019,Regular
4JN18CS408,17MAT31,19,7,26,F,0,12019,Regular
4JN18CS408,17CS32,27,24,51,P,6,12019,Regular
4JN18CS408,17CS33,24,23,47,P,5,12019,Regular
4JN18CS408,17CS34,23,10,33,F,0,12019,Regular
4JN18CS408,17CS35,28,24,52,P,6,12019,Regular
4JN18CS408,17CS36,26,15,41,F,0,12019,Regular
4JN18CS408,17CSL37,35,30,65,P,7,12019,Regular
4JN18CS408,17CSL38,33,36,69,P,7,12019,Regular
4JN18CS408,17KKM39,16,16,32,P,0,12019,Regular
4JN18CS410,17MATDIP31,0,21,21,P,0,12019,Regular
4JN18CS410,17MAT31,26,32,58,P,6,12019,Regular
4JN18CS410,17CS32,33,36,69,P,7,12019,Regular
4JN18CS410,17CS33,38,30,68,P,7,12019,Regular
4JN18CS410,17CS34,35,42,77,P,8,12019,Regular
4JN18CS410,17CS35,32,41,73,P,8,12019,Regular
4JN18CS410,17CS36,36,29,65,P,7,12019,Regular
4JN18CS410,17CSL37,37,48,85,P,9,12019,Regular
4JN18CS410,17CSL38,40,53,93,P,10,12019,Regular
4JN18CS410,17KKM39,15,26,41,P,4,12019,Regular
4JN18CS415,17MATDIP31,0,0,0,A,0,12019,Regular
4JN18CS415,17MAT31,22,17,39,F,0,12019,Regular
4JN18CS415,17CS32,27,21,48,P,5,12019,Regular
4JN18CS415,17CS33,37,26,63,P,7,12019,Regular
4JN18CS415,17CS34,28,23,51,P,6,12019,Regular
4JN18CS415,17CS35,30,27,57,P,6,12019,Regular
4JN18CS415,17CS36,27,14,41,F,0,12019,Regular
4JN18CS415,17CSL37,38,54,92,P,10,12019,Regular
4JN18CS415,17CSL38,37,25,62,P,7,12019,Regular
4JN18CS415,17KKM39,15,21,36,P,0,12019,Regular
4JN18CS417,17MAT31,30,23,53,P,6,12019,Regular
4JN18CS417,17MATDIP31,0,0,0,A,0,12019,Regular
4JN18CS417,17CS32,32,30,62,P,7,12019,Regular
4JN18CS417,17CS33,28,21,49,P,5,12019,Regular
4JN18CS417,17CS34,30,41,71,P,8,12019,Regular
4JN18CS417,17CS35,29,22,51,P,6,12019,Regular
4JN18CS417,17CS36,33,21,54,P,6,12019,Regular
4JN18CS417,17CSL37,38,30,68,P,7,12019,Regular
4JN18CS417,17CSL38,37,33,70,P,8,12019,Regular
4JN18CS417,17KKM39,16,27,43,P,4,12019,Regular
4JN18CS418,17MATDIP31,0,0,0,A,0,12019,Regular
4JN18CS418,17MAT31,26,21,47,P,5,12019,Regular
4JN18CS418,17CS32,35,33,68,P,7,12019,Regular
4JN18CS418,17CS33,35,21,56,P,6,12019,Regular
4JN18CS418,17CS34,30,32,62,P,7,12019,Regular
4JN18CS418,17CS35,30,26,56,P,6,12019,Regular
4JN18CS418,17CS36,37,30,67,P,7,12019,Regular
4JN18CS418,17CSL37,37,48,85,P,9,12019,Regular
4JN18CS418,17CSL38,40,42,82,P,9,12019,Regular
4JN18CS418,17KKM39,17,26,43,P,4,12019,Regular
4JN18CS419,17MATDIP31,0,0,0,A,0,12019,Regular
4JN18CS419,17MAT31,23,17,40,F,0,12019,Regular
4JN18CS419,17CS32,33,26,59,P,6,12019,Regular
4JN18CS419,17CS33,27,22,49,P,5,12019,Regular
4JN18CS419,17CS34,35,21,56,P,6,12019,Regular
4JN18CS419,17CS35,32,37,69,P,7,12019,Regular
4JN18CS419,17CS36,34,15,49,F,0,12019,Regular
4JN18CS419,17CSL37,35,54,89,P,9,12019,Regular
4JN18CS419,17CSL38,38,30,68,P,7,12019,Regular
4JN18CS419,17KKM39,17,22,39,P,0,12019,Regular
4JN18CS421,17MATDIP31,0,0,0,A,0,12019,Regular
4JN18CS421,17MAT31,19,17,36,F,0,12019,Regular
4JN18CS421,17CS32,28,21,49,P,5,12019,Regular
4JN18CS421,17CS33,30,23,53,P,6,12019,Regular
4JN18CS421,17CS34,27,28,55,P,6,12019,Regular
4JN18CS421,17CS35,24,27,51,P,6,12019,Regular
4JN18CS421,17CS36,27,9,36,F,0,12019,Regular
4JN18CS421,17CSL37,35,36,71,P,8,12019,Regular
4JN18CS421,17CSL38,36,26,62,P,7,12019,Regular
4JN18CS421,17KKM39,18,24,42,P,4,12019,Regular
4JN18CS424,17MATDIP31,0,0,0,A,0,12019,Regular
4JN18CS424,17MAT31,23,17,40,F,0,12019,Regular
4JN18CS424,17CS32,29,27,56,P,6,12019,Regular
4JN18CS424,17CS33,31,30,61,P,7,12019,Regular
4JN18CS424,17CS34,33,38,71,P,8,12019,Regular
4JN18CS424,17CS35,27,30,57,P,6,12019,Regular
4JN18CS424,17CS36,30,26,56,P,6,12019,Regular
4JN18CS424,17CSL37,35,57,92,P,10,12019,Regular
4JN18CS424,17CSL38,36,30,66,P,7,12019,Regular
4JN18CS424,17KKM39,16,26,42,P,4,12019,Regular
4JN14CS002,15CS51,16,44,60,P,7,12019,Regular
4JN14CS002,15CS552,12,39,51,P,6,12019,Regular
4JN14CS002,15CS52,18,33,51,P,6,12019,Regular
4JN14CS002,15CS53,12,19,31,F,0,12019,Regular
4JN14CS002,15CS564,15,31,46,P,5,12019,Regular
4JN14CS002,15CS54,12,34,46,P,5,12019,Regular
4JN14CS002,15CSL57,20,72,92,P,10,12019,Regular
4JN14CS002,15CSL58,15,55,70,P,8,12019,Regular
4JN14CS002,15MAT41,12,36,48,P,5,12019,Backlog
4JN14CS092,15CS51,13,36,49,P,5,12019,Regular
4JN14CS092,15CS52,15,18,33,F,0,12019,Regular
4JN14CS092,15CS553,13,9,22,F,0,12019,Regular
4JN14CS092,15CS53,12,24,36,F,0,12019,Regular
4JN14CS092,15CS54,12,30,42,P,4,12019,Regular
4JN14CS092,15CS564,13,28,41,P,4,12019,Regular
4JN14CS092,15CSL57,19,32,51,P,6,12019,Regular
4JN14CS092,15CSL58,15,76,91,P,10,12019,Regular
4JN14CS092,15CS45,12,16,28,F,0,12019,Backlog
4JN15CS025,15CS51,12,42,54,P,6,12019,Regular
4JN15CS025,15CS52,13,28,41,P,4,12019,Regular
4JN15CS025,15CS553,12,29,41,P,4,12019,Regular
4JN15CS025,15CS53,13,28,41,P,4,12019,Regular
4JN15CS025,15CS564,15,28,43,P,4,12019,Regular
4JN15CS025,15CS54,12,28,40,P,4,12019,Regular
4JN15CS025,15CSL57,19,32,51,P,6,12019,Regular
4JN15CS025,15CSL58,16,60,76,P,8,12019,Regular
4JN15CS041,15CS51,14,36,50,P,6,12019,Regular
4JN15CS041,15CS52,17,33,50,P,6,12019,Regular
4JN15CS041,15CS553,14,4,18,F,0,12019,Regular
4JN15CS041,15CS53,15,15,30,F,0,12019,Regular
4JN15CS041,15CS564,15,28,43,P,4,12019,Regular
4JN15CS041,15CS54,14,41,55,P,6,12019,Regular
4JN15CS041,15CSL57,19,62,81,P,9,12019,Regular
4JN15CS041,15CSL58,17,77,94,P,10,12019,Regular
4JN15CS041,15CS44,16,28,44,P,4,12019,Backlog
4JN15CS041,15CS45,14,38,52,P,6,12019,Backlog
4JN15CS049,15CS51,14,28,42,P,4,12019,Regular
4JN15CS049,15CS52,18,33,51,P,6,12019,Regular
4JN15CS049,15CS553,13,0,13,A,0,12019,Regular
4JN15CS049,15CS53,12,28,40,P,4,12019,Regular
4JN15CS049,15CS564,13,28,41,P,4,12019,Regular
4JN15CS049,15CS54,12,30,42,P,4,12019,Regular
4JN15CS049,15CSL57,19,21,40,F,0,12019,Regular
4JN15CS049,15CSL58,15,76,91,P,10,12019,Regular
4JN15CS049,15MAT41,14,0,14,A,0,12019,Backlog
4JN15CS049,15CS42,13,28,41,P,4,12019,Backlog
4JN15CS049,15MAT21,12,18,30,F,0,12019,Backlog
4JN15CS067,15CS51,14,55,69,P,7,12019,Regular
4JN15CS067,15CS552,12,43,55,P,6,12019,Regular
4JN15CS067,15CS52,13,43,56,P,6,12019,Regular
4JN15CS067,15CS53,16,28,44,P,4,12019,Regular
4JN15CS067,15CS564,15,12,27,F,0,12019,Regular
4JN15CS067,15CS54,12,36,48,P,5,12019,Regular
4JN15CS067,15CSL57,19,32,51,P,6,12019,Regular
4JN15CS067,15CSL58,17,60,77,P,8,12019,Regular
4JN15CS067,15CS46,13,40,53,P,6,12019,Backlog
4JN16CS003,15CS51,13,47,60,P,7,12019,Regular
4JN16CS003,15CS52,14,46,60,P,7,12019,Regular
4JN16CS003,15CS553,12,29,41,P,4,12019,Regular
4JN16CS003,15CS53,13,40,53,P,6,12019,Regular
4JN16CS003,15CS54,13,30,43,P,4,12019,Regular
4JN16CS003,15CS564,13,42,55,P,6,12019,Regular
4JN16CS003,15CSL57,19,32,51,P,6,12019,Regular
4JN16CS003,15CSL58,17,52,69,P,7,12019,Regular
4JN16CS008,15CS51,19,46,65,P,7,12019,Regular
4JN16CS008,15CS52,17,47,64,P,7,12019,Regular
4JN16CS008,15CS553,18,55,73,P,8,12019,Regular
4JN16CS008,15CS53,19,45,64,P,7,12019,Regular
4JN16CS008,15CS564,18,60,78,P,8,12019,Regular
4JN16CS008,15CS54,20,46,66,P,7,12019,Regular
4JN16CS008,15CSL57,20,75,95,P,10,12019,Regular
4JN16CS008,15CSL58,17,76,93,P,10,12019,Regular
4JN16CS010,15CS51,19,38,57,P,6,12019,Regular
4JN16CS010,15CS52,19,44,63,P,7,12019,Regular
4JN16CS010,15CS553,20,64,84,P,9,12019,Regular
4JN16CS010,15CS53,18,31,49,P,5,12019,Regular
4JN16CS010,15CS564,20,63,83,P,9,12019,Regular
4JN16CS010,15CS54,20,46,66,P,7,12019,Regular
4JN16CS010,15CSL57,20,79,99,P,10,12019,Regular
4JN16CS010,15CSL58,20,76,96,P,10,12019,Regular
4JN16CS011,15CS51,20,68,88,P,9,12019,Regular
4JN16CS011,15CS52,20,65,85,P,9,12019,Regular
4JN16CS011,15CS553,20,67,87,P,9,12019,Regular
4JN16CS011,15CS53,20,58,78,P,8,12019,Regular
4JN16CS011,15CS564,20,62,82,P,9,12019,Regular
4JN16CS011,15CS54,20,64,84,P,9,12019,Regular
4JN16CS011,15CSL57,20,79,99,P,10,12019,Regular
4JN16CS011,15CSL58,19,76,95,P,10,12019,Regular
4JN16CS012,15CS51,19,47,66,P,7,12019,Regular
4JN16CS012,15CS52,20,62,82,P,9,12019,Regular
4JN16CS012,15CS553,19,55,74,P,8,12019,Regular
4JN16CS012,15CS53,19,53,72,P,8,12019,Regular
4JN16CS012,15CS564,19,55,74,P,8,12019,Regular
4JN16CS012,15CS54,20,56,76,P,8,12019,Regular
4JN16CS012,15CSL57,20,76,96,P,10,12019,Regular
4JN16CS012,15CSL58,17,73,90,P,10,12019,Regular
4JN16CS013,15CS51,18,55,73,P,8,12019,Regular
4JN16CS013,15CS52,19,57,76,P,8,12019,Regular
4JN16CS013,15CS53,18,42,60,P,7,12019,Regular
4JN16CS013,15CS553,18,51,69,P,7,12019,Regular
4JN16CS013,15CS54,17,58,75,P,8,12019,Regular
4JN16CS013,15CS564,19,56,75,P,8,12019,Regular
4JN16CS013,15CSL57,20,78,98,P,10,12019,Regular
4JN16CS013,15CSL58,17,77,94,P,10,12019,Regular
4JN16CS014,15CS51,20,49,69,P,7,12019,Regular
4JN16CS014,15CS52,20,68,88,P,9,12019,Regular
4JN16CS014,15CS553,20,61,81,P,9,12019,Regular
4JN16CS014,15CS53,20,41,61,P,7,12019,Regular
4JN16CS014,15CS564,20,70,90,P,10,12019,Regular
4JN16CS014,15CS54,20,58,78,P,8,12019,Regular
4JN16CS014,15CSL57,20,80,100,P,10,12019,Regular
4JN16CS014,15CSL58,18,76,94,P,10,12019,Regular
4JN16CS015,15CS51,14,30,44,P,4,12019,Regular
4JN16CS015,15CS52,16,47,63,P,7,12019,Regular
4JN16CS015,15CS553,16,49,65,P,7,12019,Regular
4JN16CS015,15CS53,18,28,46,P,5,12019,Regular
4JN16CS015,15CS54,18,34,52,P,6,12019,Regular
4JN16CS015,15CS564,15,40,55,P,6,12019,Regular
4JN16CS015,15CSL57,19,75,94,P,10,12019,Regular
4JN16CS015,15CSL58,17,75,92,P,10,12019,Regular
4JN16CS015,15CS46,15,32,47,P,5,12019,Backlog
4JN16CS016,15CS51,18,53,71,P,8,12019,Regular
4JN16CS016,15CS52,19,49,68,P,7,12019,Regular
4JN16CS016,15CS553,19,50,69,P,7,12019,Regular
4JN16CS016,15CS53,18,46,64,P,7,12019,Regular
4JN16CS016,15CS564,20,53,73,P,8,12019,Regular
4JN16CS016,15CS54,20,46,66,P,7,12019,Regular
4JN16CS016,15CSL57,20,79,99,P,10,12019,Regular
4JN16CS016,15CSL58,15,76,91,P,10,12019,Regular
4JN16CS019,15CS51,20,63,83,P,9,12019,Regular
4JN16CS019,15CS52,20,60,80,P,9,12019,Regular
4JN16CS019,15CS553,20,58,78,P,8,12019,Regular
4JN16CS019,15CS53,20,35,55,P,6,12019,Regular
4JN16CS019,15CS564,20,65,85,P,9,12019,Regular
4JN16CS019,15CS54,20,52,72,P,8,12019,Regular
4JN16CS019,15CSL57,20,74,94,P,10,12019,Regular
4JN16CS019,15CSL58,20,78,98,P,10,12019,Regular
4JN16CS020,15CS51,18,37,55,P,6,12019,Regular
4JN16CS020,15CS52,18,45,63,P,7,12019,Regular
4JN16CS020,15CS553,17,47,64,P,7,12019,Regular
4JN16CS020,15CS53,18,41,59,P,6,12019,Regular
4JN16CS020,15CS564,19,28,47,P,5,12019,Regular
4JN16CS020,15CS54,17,44,61,P,7,12019,Regular
4JN16CS020,15CSL57,20,70,90,P,10,12019,Regular
4JN16CS020,15CSL58,16,76,92,P,10,12019,Regular
4JN16CS021,15CS51,17,53,70,P,8,12019,Regular
4JN16CS021,15CS52,18,55,73,P,8,12019,Regular
4JN16CS021,15CS553,20,50,70,P,8,12019,Regular
4JN16CS021,15CS53,18,46,64,P,7,12019,Regular
4JN16CS021,15CS564,18,61,79,P,8,12019,Regular
4JN16CS021,15CS54,20,47,67,P,7,12019,Regular
4JN16CS021,15CSL57,19,79,98,P,10,12019,Regular
4JN16CS021,15CSL58,19,77,96,P,10,12019,Regular
4JN16CS022,15CS51,20,28,48,P,5,12019,Regular
4JN16CS022,15CS52,20,43,63,P,7,12019,Regular
4JN16CS022,15CS553,20,58,78,P,8,12019,Regular
4JN16CS022,15CS53,20,47,67,P,7,12019,Regular
4JN16CS022,15CS564,19,51,70,P,8,12019,Regular
4JN16CS022,15CS54,20,47,67,P,7,12019,Regular
4JN16CS022,15CSL57,20,80,100,P,10,12019,Regular
4JN16CS022,15CSL58,20,75,95,P,10,12019,Regular
4JN16CS023,15CS51,20,37,57,P,6,12019,Regular
4JN16CS023,15CS552,19,57,76,P,8,12019,Regular
4JN16CS023,15CS52,20,67,87,P,9,12019,Regular
4JN16CS023,15CS53,20,50,70,P,8,12019,Regular
4JN16CS023,15CS564,20,56,76,P,8,12019,Regular
4JN16CS023,15CS54,20,52,72,P,8,12019,Regular
4JN16CS023,15CSL57,20,78,98,P,10,12019,Regular
4JN16CS023,15CSL58,20,77,97,P,10,12019,Regular
4JN16CS024,15CS51,19,61,80,P,9,12019,Regular
4JN16CS024,15CS52,19,56,75,P,8,12019,Regular
4JN16CS024,15CS553,19,53,72,P,8,12019,Regular
4JN16CS024,15CS53,18,50,68,P,7,12019,Regular
4JN16CS024,15CS54,20,43,63,P,7,12019,Regular
4JN16CS024,15CS564,19,49,68,P,7,12019,Regular
4JN16CS024,15CSL57,20,78,98,P,10,12019,Regular
4JN16CS024,15CSL58,20,75,95,P,10,12019,Regular
4JN16CS027,15CS51,18,44,62,P,7,12019,Regular
4JN16CS027,15CS52,18,66,84,P,9,12019,Regular
4JN16CS027,15CS53,18,45,63,P,7,12019,Regular
4JN16CS027,15CS553,20,55,75,P,8,12019,Regular
4JN16CS027,15CS54,20,57,77,P,8,12019,Regular
4JN16CS027,15CS564,20,59,79,P,8,12019,Regular
4JN16CS027,15CSL57,20,78,98,P,10,12019,Regular
4JN16CS027,15CSL58,20,74,94,P,10,12019,Regular
4JN16CS028,15CS51,20,44,64,P,7,12019,Regular
4JN16CS028,15CS52,19,39,58,P,6,12019,Regular
4JN16CS028,15CS553,20,41,61,P,7,12019,Regular
4JN16CS028,15CS53,20,49,69,P,7,12019,Regular
4JN16CS028,15CS564,20,63,83,P,9,12019,Regular
4JN16CS028,15CS54,20,50,70,P,8,12019,Regular
4JN16CS028,15CSL57,20,80,100,P,10,12019,Regular
4JN16CS028,15CSL58,19,76,95,P,10,12019,Regular
4JN16CS029,15CS51,20,39,59,P,6,12019,Regular
4JN16CS029,15CS52,20,51,71,P,8,12019,Regular
4JN16CS029,15CS553,20,61,81,P,9,12019,Regular
4JN16CS029,15CS53,20,37,57,P,6,12019,Regular
4JN16CS029,15CS564,20,50,70,P,8,12019,Regular
4JN16CS029,15CS54,20,47,67,P,7,12019,Regular
4JN16CS029,15CSL57,20,70,90,P,10,12019,Regular
4JN16CS029,15CSL58,18,73,91,P,10,12019,Regular
4JN16CS030,15CS51,20,49,69,P,7,12019,Regular
4JN16CS030,15CS52,20,42,62,P,7,12019,Regular
4JN16CS030,15CS53,19,46,65,P,7,12019,Regular
4JN16CS030,15CS553,20,72,92,P,10,12019,Regular
4JN16CS030,15CS54,19,50,69,P,7,12019,Regular
4JN16CS030,15CS564,20,49,69,P,7,12019,Regular
4JN16CS030,15CSL57,20,79,99,P,10,12019,Regular
4JN16CS030,15CSL58,18,76,94,P,10,12019,Regular
4JN16CS032,15CS51,20,52,72,P,8,12019,Regular
4JN16CS032,15CS52,20,51,71,P,8,12019,Regular
4JN16CS032,15CS553,20,52,72,P,8,12019,Regular
4JN16CS032,15CS53,18,41,59,P,6,12019,Regular
4JN16CS032,15CS564,18,50,68,P,7,12019,Regular
4JN16CS032,15CS54,19,28,47,P,5,12019,Regular
4JN16CS032,15CSL57,20,78,98,P,10,12019,Regular
4JN16CS032,15CSL58,20,78,98,P,10,12019,Regular
4JN16CS034,15CS51,19,41,60,P,7,12019,Regular
4JN16CS034,15CS52,19,29,48,P,5,12019,Regular
4JN16CS034,15CS553,19,63,82,P,9,12019,Regular
4JN16CS034,15CS53,18,40,58,P,6,12019,Regular
4JN16CS034,15CS564,20,43,63,P,7,12019,Regular
4JN16CS034,15CS54,17,43,60,P,7,12019,Regular
4JN16CS034,15CSL57,19,79,98,P,10,12019,Regular
4JN16CS034,15CSL58,20,66,86,P,9,12019,Regular
4JN16CS036,15CS51,12,55,67,P,7,12019,Regular
4JN16CS036,15CS52,14,63,77,P,8,12019,Regular
4JN16CS036,15CS553,13,44,57,P,6,12019,Regular
4JN16CS036,15CS53,13,43,56,P,6,12019,Regular
4JN16CS036,15CS564,13,54,67,P,7,12019,Regular
4JN16CS036,15CS54,13,38,51,P,6,12019,Regular
4JN16CS036,15CSL57,20,40,60,P,7,12019,Regular
4JN16CS036,15CSL58,16,78,94,P,10,12019,Regular
4JN16CS037,15CS51,19,53,72,P,8,12019,Regular
4JN16CS037,15CS52,19,54,73,P,8,12019,Regular
4JN16CS037,15CS553,19,32,51,P,6,12019,Regular
4JN16CS037,15CS53,17,59,76,P,8,12019,Regular
4JN16CS037,15CS564,19,52,71,P,8,12019,Regular
4JN16CS037,15CS54,19,43,62,P,7,12019,Regular
4JN16CS037,15CSL57,19,78,97,P,10,12019,Regular
4JN16CS037,15CSL58,17,78,95,P,10,12019,Regular
4JN16CS040,15CS51,14,44,58,P,6,12019,Regular
4JN16CS040,15CS562,12,28,40,P,4,12019,Regular
4JN16CS040,15CS52,16,37,53,P,6,12019,Regular
4JN16CS040,15CS553,14,41,55,P,6,12019,Regular
4JN16CS040,15CS53,15,30,45,P,5,12019,Regular
4JN16CS040,15CS54,15,45,60,P,7,12019,Regular
4JN16CS040,15CSL57,20,33,53,P,6,12019,Regular
4JN16CS040,15CSL58,17,63,80,P,9,12019,Regular
4JN16CS041,15CS51,15,41,56,P,6,12019,Regular
4JN16CS041,15CS552,15,42,57,P,6,12019,Regular
4JN16CS041,15CS52,16,51,67,P,7,12019,Regular
4JN16CS041,15CS53,15,28,43,P,4,12019,Regular
4JN16CS041,15CS564,15,46,61,P,7,12019,Regular
4JN16CS041,15CS54,12,31,43,P,4,12019,Regular
4JN16CS041,15CSL57,20,51,71,P,8,12019,Regular
4JN16CS041,15CSL58,17,66,83,P,9,12019,Regular
4JN16CS044,15CS51,20,58,78,P,8,12019,Regular
4JN16CS044,15CS52,19,58,77,P,8,12019,Regular
4JN16CS044,15CS553,20,55,75,P,8,12019,Regular
4JN16CS044,15CS53,20,31,51,P,6,12019,Regular
4JN16CS044,15CS564,18,46,64,P,7,12019,Regular
4JN16CS044,15CS54,20,57,77,P,8,12019,Regular
4JN16CS044,15CSL57,20,74,94,P,10,12019,Regular
4JN16CS044,15CSL58,20,79,99,P,10,12019,Regular
4JN16CS046,15CS51,17,47,64,P,7,12019,Regular
4JN16CS046,15CS52,18,34,52,P,6,12019,Regular
4JN16CS046,15CS553,14,40,54,P,6,12019,Regular
4JN16CS046,15CS53,18,32,50,P,6,12019,Regular
4JN16CS046,15CS564,16,52,68,P,7,12019,Regular
4JN16CS046,15CS54,19,54,73,P,8,12019,Regular
4JN16CS046,15CSL57,20,44,64,P,7,12019,Regular
4JN16CS046,15CSL58,17,74,91,P,10,12019,Regular
4JN16CS051,15CS51,19,65,84,P,9,12019,Regular
4JN16CS051,15CS52,20,70,90,P,10,12019,Regular
4JN16CS051,15CS553,20,57,77,P,8,12019,Regular
4JN16CS051,15CS53,19,53,72,P,8,12019,Regular
4JN16CS051,15CS564,19,55,74,P,8,12019,Regular
4JN16CS051,15CS54,20,51,71,P,8,12019,Regular
4JN16CS051,15CSL57,20,80,100,P,10,12019,Regular
4JN16CS051,15CSL58,20,75,95,P,10,12019,Regular
4JN16CS053,15CS51,20,47,67,P,7,12019,Regular
4JN16CS053,15CS52,20,47,67,P,7,12019,Regular
4JN16CS053,15CS553,20,45,65,P,7,12019,Regular
4JN16CS053,15CS53,20,60,80,P,9,12019,Regular
4JN16CS053,15CS564,20,29,49,P,5,12019,Regular
4JN16CS053,15CS54,20,47,67,P,7,12019,Regular
4JN16CS053,15CSL57,20,80,100,P,10,12019,Regular
4JN16CS053,15CSL58,20,78,98,P,10,12019,Regular
4JN16CS054,15CS51,20,45,65,P,7,12019,Regular
4JN16CS054,15CS52,20,64,84,P,9,12019,Regular
4JN16CS054,15CS553,19,58,77,P,8,12019,Regular
4JN16CS054,15CS53,20,45,65,P,7,12019,Regular
4JN16CS054,15CS564,19,53,72,P,8,12019,Regular
4JN16CS054,15CS54,18,49,67,P,7,12019,Regular
4JN16CS054,15CSL57,20,78,98,P,10,12019,Regular
4JN16CS054,15CSL58,17,71,88,P,9,12019,Regular
4JN16CS055,15CS51,18,53,71,P,8,12019,Regular
4JN16CS055,15CS52,18,41,59,P,6,12019,Regular
4JN16CS055,15CS553,16,54,70,P,8,12019,Regular
4JN16CS055,15CS53,20,53,73,P,8,12019,Regular
4JN16CS055,15CS564,15,47,62,P,7,12019,Regular
4JN16CS055,15CS54,19,36,55,P,6,12019,Regular
4JN16CS055,15CSL57,20,78,98,P,10,12019,Regular
4JN16CS055,15CSL58,16,71,87,P,9,12019,Regular
4JN16CS057,15CS51,15,47,62,P,7,12019,Regular
4JN16CS057,15CS52,18,60,78,P,8,12019,Regular
4JN16CS057,15CS553,16,29,45,P,5,12019,Regular
4JN16CS057,15CS53,15,51,66,P,7,12019,Regular
4JN16CS057,15CS564,15,45,60,P,7,12019,Regular
4JN16CS057,15CS54,15,36,51,P,6,12019,Regular
4JN16CS057,15CSL57,20,74,94,P,10,12019,Regular
4JN16CS057,15CSL58,20,73,93,P,10,12019,Regular
4JN16CS057,15CSL47,18,63,81,P,9,12019,Backlog
4JN16CS058,15CS51,18,36,54,P,6,12019,Regular
4JN16CS058,15CS52,19,43,62,P,7,12019,Regular
4JN16CS058,15CS53,18,36,54,P,6,12019,Regular
4JN16CS058,15CS553,20,46,66,P,7,12019,Regular
4JN16CS058,15CS54,19,44,63,P,7,12019,Regular
4JN16CS058,15CS564,20,41,61,P,7,12019,Regular
4JN16CS058,15CSL57,20,79,99,P,10,12019,Regular
4JN16CS058,15CSL58,17,77,94,P,10,12019,Regular
4JN16CS058,15CS42,12,49,61,P,7,12019,Backlog
4JN16CS059,15CS51,19,59,78,P,8,12019,Regular
4JN16CS059,15CS52,19,59,78,P,8,12019,Regular
4JN16CS059,15CS553,20,43,63,P,7,12019,Regular
4JN16CS059,15CS53,19,45,64,P,7,12019,Regular
4JN16CS059,15CS564,20,48,68,P,7,12019,Regular
4JN16CS059,15CS54,17,57,74,P,8,12019,Regular
4JN16CS059,15CSL57,19,80,99,P,10,12019,Regular
4JN16CS059,15CSL58,19,74,93,P,10,12019,Regular
4JN16CS062,15CS51,18,38,56,P,6,12019,Regular
4JN16CS062,15CS52,17,28,45,P,5,12019,Regular
4JN16CS062,15CS53,17,29,46,P,5,12019,Regular
4JN16CS062,15CS553,15,35,50,P,6,12019,Regular
4JN16CS062,15CS54,17,30,47,P,5,12019,Regular
4JN16CS062,15CS564,16,22,38,F,0,12019,Regular
4JN16CS062,15CSL57,20,54,74,P,8,12019,Regular
4JN16CS062,15CSL58,20,68,88,P,9,12019,Regular
4JN16CS062,15CS42,14,28,42,P,4,12019,Backlog
4JN16CS062,15CS46,13,30,43,P,4,12019,Backlog
4JN16CS064,15CS51,19,48,67,P,7,12019,Regular
4JN16CS064,15CS52,20,42,62,P,7,12019,Regular
4JN16CS064,15CS553,18,45,63,P,7,12019,Regular
4JN16CS064,15CS53,18,40,58,P,6,12019,Regular
4JN16CS064,15CS564,20,41,61,P,7,12019,Regular
4JN16CS064,15CS54,19,45,64,P,7,12019,Regular
4JN16CS064,15CSL57,20,78,98,P,10,12019,Regular
4JN16CS064,15CSL58,17,56,73,P,8,12019,Regular
4JN16CS074,15CS51,20,58,78,P,8,12019,Regular
4JN16CS074,15CS52,20,62,82,P,9,12019,Regular
4JN16CS074,15CS553,20,59,79,P,8,12019,Regular
4JN16CS074,15CS53,20,49,69,P,7,12019,Regular
4JN16CS074,15CS54,20,51,71,P,8,12019,Regular
4JN16CS074,15CS564,20,58,78,P,8,12019,Regular
4JN16CS074,15CSL57,20,78,98,P,10,12019,Regular
4JN16CS074,15CSL58,17,74,91,P,10,12019,Regular
4JN16CS075,15CS51,20,48,68,P,7,12019,Regular
4JN16CS075,15CS52,20,69,89,P,9,12019,Regular
4JN16CS075,15CS553,20,64,84,P,9,12019,Regular
4JN16CS075,15CS53,20,49,69,P,7,12019,Regular
4JN16CS075,15CS564,20,60,80,P,9,12019,Regular
4JN16CS075,15CS54,20,70,90,P,10,12019,Regular
4JN16CS075,15CSL57,20,78,98,P,10,12019,Regular
4JN16CS075,15CSL58,20,79,99,P,10,12019,Regular
4JN16CS078,15CS51,17,47,64,P,7,12019,Regular
4JN16CS078,15CS52,19,57,76,P,8,12019,Regular
4JN16CS078,15CS553,18,52,70,P,8,12019,Regular
4JN16CS078,15CS53,18,41,59,P,6,12019,Regular
4JN16CS078,15CS564,19,56,75,P,8,12019,Regular
4JN16CS078,15CS54,20,46,66,P,7,12019,Regular
4JN16CS078,15CSL57,20,78,98,P,10,12019,Regular
4JN16CS078,15CSL58,17,74,91,P,10,12019,Regular
4JN16CS079,15CS51,17,54,71,P,8,12019,Regular
4JN16CS079,15CS52,17,45,62,P,7,12019,Regular
4JN16CS079,15CS553,12,37,49,P,5,12019,Regular
4JN16CS079,15CS53,14,40,54,P,6,12019,Regular
4JN16CS079,15CS564,16,49,65,P,7,12019,Regular
4JN16CS079,15CS54,14,43,57,P,6,12019,Regular
4JN16CS079,15CSL57,19,75,94,P,10,12019,Regular
4JN16CS079,15CSL58,18,78,96,P,10,12019,Regular
4JN16CS079,15CS45,12,40,52,P,6,12019,Backlog
4JN16CS079,15CSL47,14,62,76,P,8,12019,Backlog
4JN16CS082,15CS51,17,41,58,P,6,12019,Regular
4JN16CS082,15CS52,20,57,77,P,8,12019,Regular
4JN16CS082,15CS53,15,43,58,P,6,12019,Regular
4JN16CS082,15CS553,15,48,63,P,7,12019,Regular
4JN16CS082,15CS54,14,42,56,P,6,12019,Regular
4JN16CS082,15CS564,15,47,62,P,7,12019,Regular
4JN16CS082,15CSL57,19,74,93,P,10,12019,Regular
4JN16CS082,15CSL58,18,67,85,P,9,12019,Regular
4JN16CS082,15CS46,13,40,53,P,6,12019,Backlog
4JN16CS084,15CS51,20,50,70,P,8,12019,Regular
4JN16CS084,15CS52,19,61,80,P,9,12019,Regular
4JN16CS084,15CS553,20,60,80,P,9,12019,Regular
4JN16CS084,15CS53,20,48,68,P,7,12019,Regular
4JN16CS084,15CS54,20,54,74,P,8,12019,Regular
4JN16CS084,15CS564,20,47,67,P,7,12019,Regular
4JN16CS084,15CSL57,20,80,100,P,10,12019,Regular
4JN16CS084,15CSL58,20,75,95,P,10,12019,Regular
4JN16CS096,15CS51,20,45,65,P,7,12019,Regular
4JN16CS096,15CS52,19,64,83,P,9,12019,Regular
4JN16CS096,15CS53,19,35,54,P,6,12019,Regular
4JN16CS096,15CS553,19,45,64,P,7,12019,Regular
4JN16CS096,15CS54,20,43,63,P,7,12019,Regular
4JN16CS096,15CS564,18,58,76,P,8,12019,Regular
4JN16CS096,15CSL57,20,80,100,P,10,12019,Regular
4JN16CS096,15CSL58,20,78,98,P,10,12019,Regular
4JN16CS097,15CS51,20,54,74,P,8,12019,Regular
4JN16CS097,15CS52,20,35,55,P,6,12019,Regular
4JN16CS097,15CS553,17,29,46,P,5,12019,Regular
4JN16CS097,15CS53,19,36,55,P,6,12019,Regular
4JN16CS097,15CS564,20,43,63,P,7,12019,Regular
4JN16CS097,15CS54,17,50,67,P,7,12019,Regular
4JN16CS097,15CSL57,20,48,68,P,7,12019,Regular
4JN16CS097,15CSL58,17,64,81,P,9,12019,Regular
4JN16CS104,15CS51,20,55,75,P,8,12019,Regular
4JN16CS104,15CS52,20,70,90,P,10,12019,Regular
4JN16CS104,15CS553,20,53,73,P,8,12019,Regular
4JN16CS104,15CS53,20,58,78,P,8,12019,Regular
4JN16CS104,15CS564,20,56,76,P,8,12019,Regular
4JN16CS104,15CS54,19,58,77,P,8,12019,Regular
4JN16CS104,15CSL57,20,80,100,P,10,12019,Regular
4JN16CS104,15CSL58,18,78,96,P,10,12019,Regular
4JN16CS106,15CS51,18,42,60,P,7,12019,Regular
4JN16CS106,15CS52,20,64,84,P,9,12019,Regular
4JN16CS106,15CS553,19,56,75,P,8,12019,Regular
4JN16CS106,15CS53,18,28,46,P,5,12019,Regular
4JN16CS106,15CS564,20,49,69,P,7,12019,Regular
4JN16CS106,15CS54,19,51,70,P,8,12019,Regular
4JN16CS106,15CSL57,20,78,98,P,10,12019,Regular
4JN16CS106,15CSL58,20,73,93,P,10,12019,Regular
4JN16CS107,15CS51,18,44,62,P,7,12019,Regular
4JN16CS107,15CS52,18,53,71,P,8,12019,Regular
4JN16CS107,15CS553,17,63,80,P,9,12019,Regular
4JN16CS107,15CS53,18,32,50,P,6,12019,Regular
4JN16CS107,15CS564,18,47,65,P,7,12019,Regular
4JN16CS107,15CS54,18,40,58,P,6,12019,Regular
4JN16CS107,15CSL57,19,52,71,P,8,12019,Regular
4JN16CS107,15CSL58,20,72,92,P,10,12019,Regular
4JN16CS107,15CS45,12,45,57,P,6,12019,Backlog
4JN16CS110,15CS51,14,35,49,P,5,12019,Regular
4JN16CS110,15CS552,14,35,49,P,5,12019,Regular
4JN16CS110,15CS52,16,15,31,F,0,12019,Regular
4JN16CS110,15CS53,15,36,51,P,6,12019,Regular
4JN16CS110,15CS54,15,30,45,P,5,12019,Regular
4JN16CS110,15CS564,15,39,54,P,6,12019,Regular
4JN16CS110,15CSL57,20,71,91,P,10,12019,Regular
4JN16CS110,15CSL58,16,72,88,P,9,12019,Regular
4JN16CS118,15CS51,17,58,75,P,8,12019,Regular
4JN16CS118,15CS52,19,54,73,P,8,12019,Regular
4JN16CS118,15CS552,15,47,62,P,7,12019,Regular
4JN16CS118,15CS53,17,40,57,P,6,12019,Regular
4JN16CS118,15CS54,18,37,55,P,6,12019,Regular
4JN16CS118,15CS564,15,30,45,P,5,12019,Regular
4JN16CS118,15CSL57,19,77,96,P,10,12019,Regular
4JN16CS118,15CSL58,16,75,91,P,10,12019,Regular
4JN16CS122,15CS51,12,34,46,P,5,12019,Regular
4JN16CS122,15CS52,17,36,53,P,6,12019,Regular
4JN16CS122,15CS553,13,28,41,P,4,12019,Regular
4JN16CS122,15CS53,15,30,45,P,5,12019,Regular
4JN16CS122,15CS564,14,28,42,P,4,12019,Regular
4JN16CS122,15CS54,13,36,49,P,5,12019,Regular
4JN16CS122,15CSL57,20,57,77,P,8,12019,Regular
4JN16CS122,15CSL58,17,78,95,P,10,12019,Regular
4JN16CS122,15CS43,13,30,43,P,4,12019,Backlog
4JN16CS122,15CS45,12,32,44,P,4,12019,Backlog
4JN16CS122,15CS46,15,33,48,P,5,12019,Backlog
4JN16CS127,15CS51,17,61,78,P,8,12019,Regular
4JN16CS127,15CS52,18,59,77,P,8,12019,Regular
4JN16CS127,15CS53,18,46,64,P,7,12019,Regular
4JN16CS127,15CS553,18,56,74,P,8,12019,Regular
4JN16CS127,15CS54,14,50,64,P,7,12019,Regular
4JN16CS127,15CS564,17,56,73,P,8,12019,Regular
4JN16CS127,15CSL57,20,79,99,P,10,12019,Regular
4JN16CS127,15CSL58,18,78,96,P,10,12019,Regular
4JN16CS128,15CS51,18,60,78,P,8,12019,Regular
4JN16CS128,15CS52,19,64,83,P,9,12019,Regular
4JN16CS128,15CS553,20,38,58,P,6,12019,Regular
4JN16CS128,15CS53,18,45,63,P,7,12019,Regular
4JN16CS128,15CS564,19,48,67,P,7,12019,Regular
4JN16CS128,15CS54,19,34,53,P,6,12019,Regular
4JN16CS128,15CSL57,20,56,76,P,8,12019,Regular
4JN16CS128,15CSL58,17,78,95,P,10,12019,Regular
4JN16CS130,15CS51,16,45,61,P,7,12019,Regular
4JN16CS130,15CS52,17,60,77,P,8,12019,Regular
4JN16CS130,15CS53,19,45,64,P,7,12019,Regular
4JN16CS130,15CS553,16,59,75,P,8,12019,Regular
4JN16CS130,15CS54,13,64,77,P,8,12019,Regular
4JN16CS130,15CS564,17,61,78,P,8,12019,Regular
4JN16CS130,15CSL57,20,60,80,P,9,12019,Regular
4JN16CS130,15CSL58,17,72,89,P,9,12019,Regular
4JN17CS400,15CS51,12,34,46,P,5,12019,Regular
4JN17CS400,15CS52,19,36,55,P,6,12019,Regular
4JN17CS400,15CS553,15,45,60,P,7,12019,Regular
4JN17CS400,15CS53,16,33,49,P,5,12019,Regular
4JN17CS400,15CS564,16,56,72,P,8,12019,Regular
4JN17CS400,15CS54,12,28,40,P,4,12019,Regular
4JN17CS400,15CSL57,19,68,87,P,9,12019,Regular
4JN17CS400,15CSL58,20,77,97,P,10,12019,Regular
4JN17CS400,15MATDIP31,0,24,24,F,0,12019,Backlog
4JN17CS401,15CS51,17,45,62,P,7,12019,Regular
4JN17CS401,15CS552,12,48,60,P,7,12019,Regular
4JN17CS401,15CS52,19,38,57,P,6,12019,Regular
4JN17CS401,15CS53,14,28,42,P,4,12019,Regular
4JN17CS401,15CS564,14,33,47,P,5,12019,Regular
4JN17CS401,15CS54,12,28,40,P,4,12019,Regular
4JN17CS401,15CSL57,19,42,61,P,7,12019,Regular
4JN17CS401,15CSL58,17,60,77,P,8,12019,Regular
4JN17CS401,15MAT41,9,28,37,F,0,12019,Backlog
4JN17CS401,15CS44,12,32,44,P,4,12019,Backlog
4JN17CS404,15CS51,13,32,45,P,5,12019,Regular
4JN17CS404,15CS562,11,30,41,P,4,12019,Regular
4JN17CS404,15CS52,18,48,66,P,7,12019,Regular
4JN17CS404,15CS553,12,46,58,P,6,12019,Regular
4JN17CS404,15CS53,14,41,55,P,6,12019,Regular
4JN17CS404,15CS54,13,28,41,P,4,12019,Regular
4JN17CS404,15CSL57,19,32,51,P,6,12019,Regular
4JN17CS404,15CSL58,17,76,93,P,10,12019,Regular
4JN17CS404,15MATDIP31,0,28,28,P,0,12019,Backlog
4JN17CS404,15MAT31,12,22,34,F,0,12019,Backlog
4JN17CS405,15CS51,17,38,55,P,6,12019,Regular
4JN17CS405,15CS52,19,53,72,P,8,12019,Regular
4JN17CS405,15CS53,16,42,58,P,6,12019,Regular
4JN17CS405,15CS553,17,34,51,P,6,12019,Regular
4JN17CS405,15CS54,15,28,43,P,4,12019,Regular
4JN17CS405,15CS564,18,31,49,P,5,12019,Regular
4JN17CS405,15CSL57,20,55,75,P,8,12019,Regular
4JN17CS405,15CSL58,16,62,78,P,8,12019,Regular
4JN17CS405,15CS43,14,37,51,P,6,12019,Backlog
4JN17CS406,15CS51,13,30,43,P,4,12019,Regular
4JN17CS406,15CS52,15,42,57,P,6,12019,Regular
4JN17CS406,15CS553,12,37,49,P,5,12019,Regular
4JN17CS406,15CS53,16,32,48,P,5,12019,Regular
4JN17CS406,15CS564,14,34,48,P,5,12019,Regular
4JN17CS406,15CS54,12,41,53,P,6,12019,Regular
4JN17CS406,15CSL57,19,32,51,P,6,12019,Regular
4JN17CS406,15CSL58,19,70,89,P,9,12019,Regular
4JN17CS406,15MATDIP31,0,13,13,F,0,12019,Backlog
4JN17CS406,15CS36,13,28,41,P,4,12019,Backlog
4JN17CS408,15CS51,15,30,45,P,5,12019,Regular
4JN17CS408,15CS52,16,29,45,P,5,12019,Regular
4JN17CS408,15CS553,14,38,52,P,6,12019,Regular
4JN17CS408,15CS53,18,31,49,P,5,12019,Regular
4JN17CS408,15CS564,15,34,49,P,5,12019,Regular
4JN17CS408,15CS54,12,32,44,P,4,12019,Regular
4JN17CS408,15CSL57,20,22,42,F,0,12019,Regular
4JN17CS408,15CSL58,17,77,94,P,10,12019,Regular
4JN17CS408,15MATDIP31,0,0,0,A,0,12019,Backlog
4JN17CS410,15CS51,12,29,41,P,4,12019,Regular
4JN17CS410,15CS562,11,30,41,P,4,12019,Regular
4JN17CS410,15CS52,15,40,55,P,6,12019,Regular
4JN17CS410,15CS553,12,21,33,F,0,12019,Regular
4JN17CS410,15CS53,12,29,41,P,4,12019,Regular
4JN17CS410,15CS54,12,35,47,P,5,12019,Regular
4JN17CS410,15CSL57,19,68,87,P,9,12019,Regular
4JN17CS410,15CSL58,16,76,92,P,10,12019,Regular
4JN17CS410,15CS44,12,29,41,P,4,12019,Backlog
4JN17CS410,15MATDIP31,0,12,12,F,0,12019,Backlog
4JN17CS410,15CS36,13,30,43,P,4,12019,Backlog
4JN17CS411,15CS51,17,48,65,P,7,12019,Regular
4JN17CS411,15CS52,19,41,60,P,7,12019,Regular
4JN17CS411,15CS53,18,28,46,P,5,12019,Regular
4JN17CS411,15CS553,13,36,49,P,5,12019,Regular
4JN17CS411,15CS54,13,34,47,P,5,12019,Regular
4JN17CS411,15CS564,13,31,44,P,4,12019,Regular
4JN17CS411,15CSL57,20,58,78,P,8,12019,Regular
4JN17CS411,15CSL58,20,77,97,P,10,12019,Regular
4JN17CS411,15MATDIP41,0,28,28,P,0,12019,Backlog
4JN17CS411,15MAT41,13,48,61,P,7,12019,Backlog
4JN17CS411,15CS36,13,38,51,P,6,12019,Backlog
4JN17CS413,15CS51,18,38,56,P,6,12019,Regular
4JN17CS413,15CS52,20,49,69,P,7,12019,Regular
4JN17CS413,15CS53,15,46,61,P,7,12019,Regular
4JN17CS413,15CS553,19,49,68,P,7,12019,Regular
4JN17CS413,15CS54,15,48,63,P,7,12019,Regular
4JN17CS413,15CS564,17,28,45,P,5,12019,Regular
4JN17CS413,15CSL57,20,58,78,P,8,12019,Regular
4JN17CS413,15CSL58,19,76,95,P,10,12019,Regular
4JN17CS414,15CS51,14,28,42,P,4,12019,Regular
4JN17CS414,15CS52,14,28,42,P,4,12019,Regular
4JN17CS414,15CS553,12,34,46,P,5,12019,Regular
4JN17CS414,15CS53,16,16,32,F,0,12019,Regular
4JN17CS414,15CS564,14,29,43,P,4,12019,Regular
4JN17CS414,15CS54,14,31,45,P,5,12019,Regular
4JN17CS414,15CSL57,19,32,51,P,6,12019,Regular
4JN17CS414,15CSL58,17,66,83,P,9,12019,Regular
4JN17CS414,15MAT41,12,28,40,P,4,12019,Backlog
4JN17CS414,15CS45,12,33,45,P,5,12019,Backlog
4JN17CS414,15MAT31,12,28,40,P,4,12019,Backlog
4JN17CS414,15CS36,16,28,44,P,4,12019,Backlog
4JN17CS417,15CS51,14,37,51,P,6,12019,Regular
4JN17CS417,15CS552,14,46,60,P,7,12019,Regular
4JN17CS417,15CS52,17,55,72,P,8,12019,Regular
4JN17CS417,15CS53,17,36,53,P,6,12019,Regular
4JN17CS417,15CS564,15,44,59,P,6,12019,Regular
4JN17CS417,15CS54,14,28,42,P,4,12019,Regular
4JN17CS417,15CSL57,19,59,78,P,8,12019,Regular
4JN17CS417,15CSL58,17,71,88,P,9,12019,Regular
4JN17CS417,15MAT41,13,33,46,P,5,12019,Backlog
4JN17CS417,15MATDIP41,0,19,19,F,0,12019,Backlog
4JN17CS417,15MAT31,12,31,43,P,4,12019,Backlog
4JN17CS420,15CS51,17,46,63,P,7,12019,Regular
4JN17CS420,15CS552,13,33,46,P,5,12019,Regular
4JN17CS420,15CS52,16,61,77,P,8,12019,Regular
4JN17CS420,15CS53,16,40,56,P,6,12019,Regular
4JN17CS420,15CS564,16,35,51,P,6,12019,Regular
4JN17CS420,15CS54,13,28,41,P,4,12019,Regular
4JN17CS420,15CSL57,19,22,41,F,0,12019,Regular
4JN17CS420,15CSL58,16,60,76,P,8,12019,Regular
4JN17CS420,15MATDIP41,0,18,18,F,0,12019,Backlog
4JN17CS420,15MAT31,12,29,41,P,4,12019,Backlog
4JN17CS420,15CS35,12,35,47,P,5,12019,Backlog
4JN17CS422,15CS51,15,46,61,P,7,12019,Regular
4JN17CS422,15CS552,13,56,69,P,7,12019,Regular
4JN17CS422,15CS52,17,34,51,P,6,12019,Regular
4JN17CS422,15CS53,16,35,51,P,6,12019,Regular
4JN17CS422,15CS564,12,28,40,P,4,12019,Regular
4JN17CS422,15CS54,12,29,41,P,4,12019,Regular
4JN17CS422,15CSL57,19,53,72,P,8,12019,Regular
4JN17CS422,15CSL58,17,60,77,P,8,12019,Regular
4JN17CS422,15MAT41,12,0,12,A,0,12019,Backlog
4JN17CS422,15MATDIP41,0,0,0,A,0,12019,Backlog
4JN17CS424,15CS51,12,37,49,P,5,12019,Regular
4JN17CS424,15CS52,14,22,36,F,0,12019,Regular
4JN17CS424,15CS553,13,50,63,P,7,12019,Regular
4JN17CS424,15CS53,16,17,33,F,0,12019,Regular
4JN17CS424,15CS564,12,28,40,P,4,12019,Regular
4JN17CS424,15CS54,12,30,42,P,4,12019,Regular
4JN17CS424,15CSL57,19,28,47,F,0,12019,Regular
4JN17CS424,15CSL58,16,64,80,P,9,12019,Regular
4JN17CS424,15MAT41,7,0,7,A,0,12019,Backlog
4JN17CS424,15CS44,12,29,41,P,4,12019,Backlog
4JN17CS424,15MATDIP31,0,3,3,F,0,12019,Backlog
4JN17CS424,15MAT31,12,9,21,F,0,12019,Backlog
4JN17CS424,15CS36,12,15,27,F,0,12019,Backlog
4JN17CS425,15CS51,14,35,49,P,5,12019,Regular
4JN17CS425,15CS52,18,46,64,P,7,12019,Regular
4JN17CS425,15CS553,14,28,42,P,4,12019,Regular
4JN17CS425,15CS53,12,30,42,P,4,12019,Regular
4JN17CS425,15CS564,17,35,52,P,6,12019,Regular
4JN17CS425,15CS54,12,28,40,P,4,12019,Regular
4JN17CS425,15CSL57,20,32,52,P,6,12019,Regular
4JN17CS425,15CSL58,16,63,79,P,8,12019,Regular
4JN17CS425,15CS32,12,49,61,P,7,12019,Backlog
4JN17CS425,15CS36,14,28,42,P,4,12019,Backlog
4JN17CS427,15CS51,19,43,62,P,7,12019,Regular
4JN17CS427,15CS52,19,40,59,P,6,12019,Regular
4JN17CS427,15CS553,19,52,71,P,8,12019,Regular
4JN17CS427,15CS53,13,42,55,P,6,12019,Regular
4JN17CS427,15CS564,20,52,72,P,8,12019,Regular
4JN17CS427,15CS54,12,31,43,P,4,12019,Regular
4JN17CS427,15CSL57,20,54,74,P,8,12019,Regular
4JN17CS427,15CSL58,17,67,84,P,9,12019,Regular
4JN14CS133,15CS51,19,52,71,P,8,12019,Regular
4JN14CS133,15CS552,12,33,45,P,5,12019,Regular
4JN14CS133,15CS52,13,42,55,P,6,12019,Regular
4JN14CS133,15CS53,13,35,48,P,5,12019,Regular
4JN14CS133,15CS564,14,29,43,P,4,12019,Regular
4JN14CS133,15CS54,14,29,43,P,4,12019,Regular
4JN14CS133,15CSL57,17,32,49,P,5,12019,Regular
4JN14CS133,15CSL58,19,62,81,P,9,12019,Regular
4JN16CS001,15CS51,20,42,62,P,7,12019,Regular
4JN16CS001,15CS52,15,33,48,P,5,12019,Regular
4JN16CS001,15CS53,18,28,46,P,5,12019,Regular
4JN16CS001,15CS553,12,34,46,P,5,12019,Regular
4JN16CS001,15CS54,17,35,52,P,6,12019,Regular
4JN16CS001,15CS564,17,30,47,P,5,12019,Regular
4JN16CS001,15CSL57,18,70,88,P,9,12019,Regular
4JN16CS001,15CSL58,20,78,98,P,10,12019,Regular
4JN16CS005,15CS51,19,43,62,P,7,12019,Regular
4JN16CS005,15CS52,12,42,54,P,6,12019,Regular
4JN16CS005,15CS562,10,54,64,P,7,12019,Regular
4JN16CS005,15CS552,12,38,50,P,6,12019,Regular
4JN16CS005,15CS53,12,29,41,P,4,12019,Regular
4JN16CS005,15CS54,12,39,51,P,6,12019,Regular
4JN16CS005,15CSL57,17,32,49,P,5,12019,Regular
4JN16CS005,15CSL58,19,65,84,P,9,12019,Regular
4JN16CS005,15CS46,12,41,53,P,6,12019,Backlog
4JN16CS006,15CS51,19,51,70,P,8,12019,Regular
4JN16CS006,15CS52,16,59,75,P,8,12019,Regular
4JN16CS006,15CS553,14,47,61,P,7,12019,Regular
4JN16CS006,15CS53,15,33,48,P,5,12019,Regular
4JN16CS006,15CS564,18,52,70,P,8,12019,Regular
4JN16CS006,15CS54,18,47,65,P,7,12019,Regular
4JN16CS006,15CSL57,17,78,95,P,10,12019,Regular
4JN16CS006,15CSL58,20,78,98,P,10,12019,Regular
4JN16CS007,15CS51,20,39,59,P,6,12019,Regular
4JN16CS007,15CS52,17,59,76,P,8,12019,Regular
4JN16CS007,15CS553,15,45,60,P,7,12019,Regular
4JN16CS007,15CS53,18,32,50,P,6,12019,Regular
4JN16CS007,15CS564,19,44,63,P,7,12019,Regular
4JN16CS007,15CS54,20,68,88,P,9,12019,Regular
4JN16CS007,15CSL57,18,78,96,P,10,12019,Regular
4JN16CS007,15CSL58,20,79,99,P,10,12019,Regular
4JN16CS009,15CS51,17,41,58,P,6,12019,Regular
4JN16CS009,15CS562,10,36,46,P,5,12019,Regular
4JN16CS009,15CS552,12,28,40,P,4,12019,Regular
4JN16CS009,15CS52,12,28,40,P,4,12019,Regular
4JN16CS009,15CS53,15,35,50,P,6,12019,Regular
4JN16CS009,15CS54,13,28,41,P,4,12019,Regular
4JN16CS009,15CSL57,18,44,62,P,7,12019,Regular
4JN16CS009,15CSL58,19,64,83,P,9,12019,Regular
4JN16CS009,15CS45,13,37,50,P,6,12019,Backlog
4JN16CS017,15CS51,17,32,49,P,5,12019,Regular
4JN16CS017,15CS562,12,42,54,P,6,12019,Regular
4JN16CS017,15CS552,13,28,41,P,4,12019,Regular
4JN16CS017,15CS52,12,46,58,P,6,12019,Regular
4JN16CS017,15CS53,16,38,54,P,6,12019,Regular
4JN16CS017,15CS54,15,28,43,P,4,12019,Regular
4JN16CS017,15CSL57,18,53,71,P,8,12019,Regular
4JN16CS017,15CSL58,20,63,83,P,9,12019,Regular
4JN16CS017,15CS46,13,35,48,P,5,12019,Backlog
4JN16CS017,15CSL47,19,34,53,P,6,12019,Backlog
4JN16CS018,15CS51,20,51,71,P,8,12019,Regular
4JN16CS018,15CS52,14,66,80,P,9,12019,Regular
4JN16CS018,15CS553,13,45,58,P,6,12019,Regular
4JN16CS018,15CS53,19,32,51,P,6,12019,Regular
4JN16CS018,15CS564,15,39,54,P,6,12019,Regular
4JN16CS018,15CS54,17,44,61,P,7,12019,Regular
4JN16CS018,15CSL57,18,70,88,P,9,12019,Regular
4JN16CS018,15CSL58,20,75,95,P,10,12019,Regular
4JN16CS026,15CS51,18,36,54,P,6,12019,Regular
4JN16CS026,15CS552,12,28,40,P,4,12019,Regular
4JN16CS026,15CS52,12,28,40,P,4,12019,Regular
4JN16CS026,15CS53,15,32,47,P,5,12019,Regular
4JN16CS026,15CS564,12,29,41,P,4,12019,Regular
4JN16CS026,15CS54,13,28,41,P,4,12019,Regular
4JN16CS026,15CSL57,17,20,37,F,0,12019,Regular
4JN16CS026,15CSL58,18,64,82,P,9,12019,Regular
4JN16CS026,15CSL47,15,36,51,P,6,12019,Backlog
4JN16CS031,15CS51,17,34,51,P,6,12019,Regular
4JN16CS031,15CS52,13,35,48,P,5,12019,Regular
4JN16CS031,15CS53,17,45,62,P,7,12019,Regular
4JN16CS031,15CS553,12,56,68,P,7,12019,Regular
4JN16CS031,15CS54,17,42,59,P,6,12019,Regular
4JN16CS031,15CS564,15,42,57,P,6,12019,Regular
4JN16CS031,15CSL57,18,56,74,P,8,12019,Regular
4JN16CS031,15CSL58,19,65,84,P,9,12019,Regular
4JN16CS031,15CS45,12,41,53,P,6,12019,Backlog
4JN16CS031,15CSL48,12,54,66,P,7,12019,Backlog
4JN16CS033,15CS51,20,42,62,P,7,12019,Regular
4JN16CS033,15CS52,20,62,82,P,9,12019,Regular
4JN16CS033,15CS53,18,46,64,P,7,12019,Regular
4JN16CS033,15CS553,18,50,68,P,7,12019,Regular
4JN16CS033,15CS54,20,64,84,P,9,12019,Regular
4JN16CS033,15CS564,20,58,78,P,8,12019,Regular
4JN16CS033,15CSL57,20,76,96,P,10,12019,Regular
4JN16CS033,15CSL58,20,75,95,P,10,12019,Regular
4JN16CS035,15CS51,17,42,59,P,6,12019,Regular
4JN16CS035,15CS52,17,45,62,P,7,12019,Regular
4JN16CS035,15CS553,12,57,69,P,7,12019,Regular
4JN16CS035,15CS53,16,38,54,P,6,12019,Regular
4JN16CS035,15CS564,18,52,70,P,8,12019,Regular
4JN16CS035,15CS54,18,37,55,P,6,12019,Regular
4JN16CS035,15CSL57,17,40,57,P,6,12019,Regular
4JN16CS035,15CSL58,20,79,99,P,10,12019,Regular
4JN16CS038,15CS51,20,40,60,P,7,12019,Regular
4JN16CS038,15CS52,16,65,81,P,9,12019,Regular
4JN16CS038,15CS553,19,55,74,P,8,12019,Regular
4JN16CS038,15CS53,20,48,68,P,7,12019,Regular
4JN16CS038,15CS564,20,60,80,P,9,12019,Regular
4JN16CS038,15CS54,20,44,64,P,7,12019,Regular
4JN16CS038,15CSL57,18,77,95,P,10,12019,Regular
4JN16CS038,15CSL58,20,75,95,P,10,12019,Regular
4JN16CS039,15CS51,17,28,45,P,5,12019,Regular
4JN16CS039,15CS52,15,40,55,P,6,12019,Regular
4JN16CS039,15CS553,12,30,42,P,4,12019,Regular
4JN16CS039,15CS53,13,28,41,P,4,12019,Regular
4JN16CS039,15CS564,15,36,51,P,6,12019,Regular
4JN16CS039,15CS54,16,36,52,P,6,12019,Regular
4JN16CS039,15CSL57,18,60,78,P,8,12019,Regular
4JN16CS039,15CSL58,20,69,89,P,9,12019,Regular
4JN16CS039,15CS42,14,36,50,P,6,12019,Backlog
4JN16CS039,15CS44,15,36,51,P,6,12019,Backlog
4JN16CS042,15CS51,19,52,71,P,8,12019,Regular
4JN16CS042,15CS562,14,62,76,P,8,12019,Regular
4JN16CS042,15CS52,16,70,86,P,9,12019,Regular
4JN16CS042,15CS553,14,48,62,P,7,12019,Regular
4JN16CS042,15CS53,19,35,54,P,6,12019,Regular
4JN16CS042,15CS54,17,42,59,P,6,12019,Regular
4JN16CS042,15CSL57,18,59,77,P,8,12019,Regular
4JN16CS042,15CSL58,20,78,98,P,10,12019,Regular
4JN16CS045,15CS51,16,22,38,F,0,12019,Regular
4JN16CS045,15CS552,12,35,47,P,5,12019,Regular
4JN16CS045,15CS52,12,29,41,P,4,12019,Regular
4JN16CS045,15CS53,14,28,42,P,4,12019,Regular
4JN16CS045,15CS564,12,28,40,P,4,12019,Regular
4JN16CS045,15CS54,14,28,42,P,4,12019,Regular
4JN16CS045,15CSL57,17,22,39,F,0,12019,Regular
4JN16CS045,15CSL58,18,52,70,P,8,12019,Regular
4JN16CS045,15MAT41,9,31,40,P,4,12019,Backlog
4JN16CS045,15CS45,15,31,46,P,5,12019,Backlog
4JN16CS045,15CS36,13,28,41,P,4,12019,Backlog
4JN16CS047,15CS51,19,35,54,P,6,12019,Regular
4JN16CS047,15CS552,16,42,58,P,6,12019,Regular
4JN16CS047,15CS52,16,49,65,P,7,12019,Regular
4JN16CS047,15CS53,16,44,60,P,7,12019,Regular
4JN16CS047,15CS564,15,37,52,P,6,12019,Regular
4JN16CS047,15CS54,15,42,57,P,6,12019,Regular
4JN16CS047,15CSL57,19,50,69,P,7,12019,Regular
4JN16CS047,15CSL58,19,62,81,P,9,12019,Regular
4JN16CS048,15CS51,20,41,61,P,7,12019,Regular
4JN16CS048,15CS52,18,55,73,P,8,12019,Regular
4JN16CS048,15CS553,19,55,74,P,8,12019,Regular
4JN16CS048,15CS53,20,50,70,P,8,12019,Regular
4JN16CS048,15CS54,19,46,65,P,7,12019,Regular
4JN16CS048,15CS564,19,58,77,P,8,12019,Regular
4JN16CS048,15CSL57,19,66,85,P,9,12019,Regular
4JN16CS048,15CSL58,20,74,94,P,10,12019,Regular
4JN16CS049,15CS51,20,37,57,P,6,12019,Regular
4JN16CS049,15CS52,15,52,67,P,7,12019,Regular
4JN16CS049,15CS553,12,46,58,P,6,12019,Regular
4JN16CS049,15CS53,17,32,49,P,5,12019,Regular
4JN16CS049,15CS564,17,43,60,P,7,12019,Regular
4JN16CS049,15CS54,14,28,42,P,4,12019,Regular
4JN16CS049,15CSL57,17,20,37,F,0,12019,Regular
4JN16CS049,15CSL58,18,66,84,P,9,12019,Regular
4JN16CS049,15MAT31,12,17,29,F,0,12019,Backlog
4JN16CS049,15CED24,20,28,48,P,5,12019,Backlog
4JN16CS052,15CS51,19,36,55,P,6,12019,Regular
4JN16CS052,15CS52,16,34,50,P,6,12019,Regular
4JN16CS052,15CS552,12,28,40,P,4,12019,Regular
4JN16CS052,15CS53,13,18,31,F,0,12019,Regular
4JN16CS052,15CS54,12,45,57,P,6,12019,Regular
4JN16CS052,15CS564,14,28,42,P,4,12019,Regular
4JN16CS052,15CSL57,17,45,62,P,7,12019,Regular
4JN16CS052,15CSL58,20,70,90,P,10,12019,Regular
4JN16CS052,15CS44,13,0,13,A,0,12019,Backlog
4JN16CS052,15CS45,14,23,37,F,0,12019,Backlog
4JN16CS052,15CS33,12,31,43,P,4,12019,Backlog
4JN16CS056,15CS51,19,42,61,P,7,12019,Regular
4JN16CS056,15CS52,13,43,56,P,6,12019,Regular
4JN16CS056,15CS53,15,44,59,P,6,12019,Regular
4JN16CS056,15CS553,12,20,32,F,0,12019,Regular
4JN16CS056,15CS54,16,54,70,P,8,12019,Regular
4JN16CS056,15CS564,15,28,43,P,4,12019,Regular
4JN16CS056,15CSL57,17,51,68,P,7,12019,Regular
4JN16CS056,15CSL58,19,70,89,P,9,12019,Regular
4JN16CS056,15MAT41,14,33,47,P,5,12019,Backlog
4JN16CS056,15CS45,15,34,49,P,5,12019,Backlog
4JN16CS056,15CS46,16,55,71,P,8,12019,Backlog
4JN16CS056,15CSL47,14,35,49,P,5,12019,Backlog
4JN16CS060,15CS51,20,43,63,P,7,12019,Regular
4JN16CS060,15CS52,15,35,50,P,6,12019,Regular
4JN16CS060,15CS553,12,45,57,P,6,12019,Regular
4JN16CS060,15CS53,15,43,58,P,6,12019,Regular
4JN16CS060,15CS54,18,39,57,P,6,12019,Regular
4JN16CS060,15CS564,18,39,57,P,6,12019,Regular
4JN16CS060,15CSL57,20,76,96,P,10,12019,Regular
4JN16CS060,15CSL58,20,70,90,P,10,12019,Regular
4JN16CS061,15CS51,19,49,68,P,7,12019,Regular
4JN16CS061,15CS52,19,66,85,P,9,12019,Regular
4JN16CS061,15CS553,18,54,72,P,8,12019,Regular
4JN16CS061,15CS53,19,46,65,P,7,12019,Regular
4JN16CS061,15CS564,20,61,81,P,9,12019,Regular
4JN16CS061,15CS54,20,42,62,P,7,12019,Regular
4JN16CS061,15CSL57,17,75,92,P,10,12019,Regular
4JN16CS061,15CSL58,20,75,95,P,10,12019,Regular
4JN16CS063,15CS51,17,41,58,P,6,12019,Regular
4JN16CS063,15CS52,15,52,67,P,7,12019,Regular
4JN16CS063,15CS553,13,28,41,P,4,12019,Regular
4JN16CS063,15CS53,15,42,57,P,6,12019,Regular
4JN16CS063,15CS564,17,33,50,P,6,12019,Regular
4JN16CS063,15CS54,16,28,44,P,4,12019,Regular
4JN16CS063,15CSL57,17,60,77,P,8,12019,Regular
4JN16CS063,15CSL58,20,65,85,P,9,12019,Regular
4JN16CS063,15CS45,16,30,46,P,5,12019,Backlog
4JN16CS063,15CS46,13,41,54,P,6,12019,Backlog
4JN16CS065,15CS51,20,54,74,P,8,12019,Regular
4JN16CS065,15CS52,19,45,64,P,7,12019,Regular
4JN16CS065,15CS553,13,48,61,P,7,12019,Regular
4JN16CS065,15CS53,19,50,69,P,7,12019,Regular
4JN16CS065,15CS564,20,48,68,P,7,12019,Regular
4JN16CS065,15CS54,16,33,49,P,5,12019,Regular
4JN16CS065,15CSL57,19,67,86,P,9,12019,Regular
4JN16CS065,15CSL58,20,75,95,P,10,12019,Regular
4JN16CS066,15CS51,19,43,62,P,7,12019,Regular
4JN16CS066,15CS52,16,48,64,P,7,12019,Regular
4JN16CS066,15CS53,15,31,46,P,5,12019,Regular
4JN16CS066,15CS553,14,48,62,P,7,12019,Regular
4JN16CS066,15CS54,14,52,66,P,7,12019,Regular
4JN16CS066,15CS564,14,44,58,P,6,12019,Regular
4JN16CS066,15CSL57,19,76,95,P,10,12019,Regular
4JN16CS066,15CSL58,20,76,96,P,10,12019,Regular
4JN16CS067,15CS51,16,34,50,P,6,12019,Regular
4JN16CS067,15CS552,13,28,41,P,4,12019,Regular
4JN16CS067,15CS52,12,40,52,P,6,12019,Regular
4JN16CS067,15CS53,15,28,43,P,4,12019,Regular
4JN16CS067,15CS564,15,28,43,P,4,12019,Regular
4JN16CS067,15CS54,15,29,44,P,4,12019,Regular
4JN16CS067,15CSL57,17,32,49,P,5,12019,Regular
4JN16CS067,15CSL58,18,60,78,P,8,12019,Regular
4JN16CS067,15CS45,14,34,48,P,5,12019,Backlog
4JN16CS070,15CS51,16,29,45,P,5,12019,Regular
4JN16CS070,15CS52,13,30,43,P,4,12019,Regular
4JN16CS070,15CS553,13,38,51,P,6,12019,Regular
4JN16CS070,15CS53,13,29,42,P,4,12019,Regular
4JN16CS070,15CS564,16,46,62,P,7,12019,Regular
4JN16CS070,15CS54,18,46,64,P,7,12019,Regular
4JN16CS070,15CSL57,18,75,93,P,10,12019,Regular
4JN16CS070,15CSL58,20,72,92,P,10,12019,Regular
4JN16CS070,15CS46,12,29,41,P,4,12019,Backlog
4JN16CS071,15CS51,17,29,46,P,5,12019,Regular
4JN16CS071,15CS52,14,38,52,P,6,12019,Regular
4JN16CS071,15CS553,12,28,40,P,4,12019,Regular
4JN16CS071,15CS53,15,28,43,P,4,12019,Regular
4JN16CS071,15CS564,17,40,57,P,6,12019,Regular
4JN16CS071,15CS54,16,36,52,P,6,12019,Regular
4JN16CS071,15CSL57,18,76,94,P,10,12019,Regular
4JN16CS071,15CSL58,20,76,96,P,10,12019,Regular
4JN16CS071,15CS44,15,38,53,P,6,12019,Backlog
4JN16CS071,15CS45,16,31,47,P,5,12019,Backlog
4JN16CS072,15CS51,20,55,75,P,8,12019,Regular
4JN16CS072,15CS52,17,49,66,P,7,12019,Regular
4JN16CS072,15CS53,19,42,61,P,7,12019,Regular
4JN16CS072,15CS553,16,55,71,P,8,12019,Regular
4JN16CS072,15CS54,20,50,70,P,8,12019,Regular
4JN16CS072,15CS564,19,57,76,P,8,12019,Regular
4JN16CS072,15CSL57,19,78,97,P,10,12019,Regular
4JN16CS072,15CSL58,20,78,98,P,10,12019,Regular
4JN16CS073,15CS51,19,41,60,P,7,12019,Regular
4JN16CS073,15CS52,15,55,70,P,8,12019,Regular
4JN16CS073,15CS553,12,46,58,P,6,12019,Regular
4JN16CS073,15CS53,16,29,45,P,5,12019,Regular
4JN16CS073,15CS564,15,51,66,P,7,12019,Regular
4JN16CS073,15CS54,18,60,78,P,8,12019,Regular
4JN16CS073,15CSL57,17,64,81,P,9,12019,Regular
4JN16CS073,15CSL58,19,74,93,P,10,12019,Regular
4JN16CS077,15CS51,20,42,62,P,7,12019,Regular
4JN16CS077,15CS52,19,62,81,P,9,12019,Regular
4JN16CS077,15CS553,15,67,82,P,9,12019,Regular
4JN16CS077,15CS53,19,56,75,P,8,12019,Regular
4JN16CS077,15CS564,19,59,78,P,8,12019,Regular
4JN16CS077,15CS54,18,58,76,P,8,12019,Regular
4JN16CS077,15CSL57,13,78,91,P,10,12019,Regular
4JN16CS077,15CSL58,20,75,95,P,10,12019,Regular
4JN16CS080,15CS51,20,35,55,P,6,12019,Regular
4JN16CS080,15CS52,17,48,65,P,7,12019,Regular
4JN16CS080,15CS53,18,39,57,P,6,12019,Regular
4JN16CS080,15CS553,12,33,45,P,5,12019,Regular
4JN16CS080,15CS564,15,49,64,P,7,12019,Regular
4JN16CS080,15CS54,17,48,65,P,7,12019,Regular
4JN16CS080,15CSL57,16,74,90,P,10,12019,Regular
4JN16CS080,15CSL58,20,75,95,P,10,12019,Regular
4JN16CS083,15CS51,18,58,76,P,8,12019,Regular
4JN16CS083,15CS52,16,45,61,P,7,12019,Regular
4JN16CS083,15CS553,15,31,46,P,5,12019,Regular
4JN16CS083,15CS53,17,39,56,P,6,12019,Regular
4JN16CS083,15CS54,16,28,44,P,4,12019,Regular
4JN16CS083,15CS564,15,28,43,P,4,12019,Regular
4JN16CS083,15CSL57,18,50,68,P,7,12019,Regular
4JN16CS083,15CSL58,20,68,88,P,9,12019,Regular
4JN16CS083,15MAT41,14,18,32,F,0,12019,Backlog
4JN16CS083,15CS45,13,37,50,P,6,12019,Backlog
4JN16CS085,15CS51,19,54,73,P,8,12019,Regular
4JN16CS085,15CS52,16,46,62,P,7,12019,Regular
4JN16CS085,15CS53,17,29,46,P,5,12019,Regular
4JN16CS085,15CS553,14,34,48,P,5,12019,Regular
4JN16CS085,15CS54,15,46,61,P,7,12019,Regular
4JN16CS085,15CS564,16,50,66,P,7,12019,Regular
4JN16CS085,15CSL57,17,66,83,P,9,12019,Regular
4JN16CS085,15CSL58,20,74,94,P,10,12019,Regular
4JN16CS087,15CS51,20,47,67,P,7,12019,Regular
4JN16CS087,15CS52,15,49,64,P,7,12019,Regular
4JN16CS087,15CS553,14,35,49,P,5,12019,Regular
4JN16CS087,15CS53,18,31,49,P,5,12019,Regular
4JN16CS087,15CS54,18,45,63,P,7,12019,Regular
4JN16CS087,15CS564,18,46,64,P,7,12019,Regular
4JN16CS087,15CSL57,18,44,62,P,7,12019,Regular
4JN16CS087,15CSL58,20,72,92,P,10,12019,Regular
4JN16CS088,15CS51,17,29,46,P,5,12019,Regular
4JN16CS088,15CS52,12,38,50,P,6,12019,Regular
4JN16CS088,15CS553,13,43,56,P,6,12019,Regular
4JN16CS088,15CS53,16,31,47,P,5,12019,Regular
4JN16CS088,15CS564,16,33,49,P,5,12019,Regular
4JN16CS088,15CS54,17,36,53,P,6,12019,Regular
4JN16CS088,15CSL57,17,66,83,P,9,12019,Regular
4JN16CS088,15CSL58,20,60,80,P,9,12019,Regular
4JN16CS089,15CS51,20,56,76,P,8,12019,Regular
4JN16CS089,15CS562,18,54,72,P,8,12019,Regular
4JN16CS089,15CS52,18,55,73,P,8,12019,Regular
4JN16CS089,15CS553,19,55,74,P,8,12019,Regular
4JN16CS089,15CS53,20,47,67,P,7,12019,Regular
4JN16CS089,15CS54,20,59,79,P,8,12019,Regular
4JN16CS089,15CSL57,19,76,95,P,10,12019,Regular
4JN16CS089,15CSL58,20,79,99,P,10,12019,Regular
4JN16CS090,15CS51,19,37,56,P,6,12019,Regular
4JN16CS090,15CS52,15,52,67,P,7,12019,Regular
4JN16CS090,15CS53,17,49,66,P,7,12019,Regular
4JN16CS090,15CS553,12,36,48,P,5,12019,Regular
4JN16CS090,15CS54,19,39,58,P,6,12019,Regular
4JN16CS090,15CS564,17,28,45,P,5,12019,Regular
4JN16CS090,15CSL57,20,68,88,P,9,12019,Regular
4JN16CS090,15CSL58,20,72,92,P,10,12019,Regular
4JN16CS091,15CS51,20,34,54,P,6,12019,Regular
4JN16CS091,15CS52,19,66,85,P,9,12019,Regular
4JN16CS091,15CS562,16,59,75,P,8,12019,Regular
4JN16CS091,15CS53,19,33,52,P,6,12019,Regular
4JN16CS091,15CS553,19,50,69,P,7,12019,Regular
4JN16CS091,15CS54,19,50,69,P,7,12019,Regular
4JN16CS091,15CSL57,18,78,96,P,10,12019,Regular
4JN16CS091,15CSL58,20,77,97,P,10,12019,Regular
4JN16CS093,15CS51,16,31,47,P,5,12019,Regular
4JN16CS093,15CS52,13,35,48,P,5,12019,Regular
4JN16CS093,15CS53,15,30,45,P,5,12019,Regular
4JN16CS093,15CS553,13,33,46,P,5,12019,Regular
4JN16CS093,15CS54,14,42,56,P,6,12019,Regular
4JN16CS093,15CS564,14,35,49,P,5,12019,Regular
4JN16CS093,15CSL57,19,53,72,P,8,12019,Regular
4JN16CS093,15CSL58,20,72,92,P,10,12019,Regular
4JN16CS094,15CS51,20,62,82,P,9,12019,Regular
4JN16CS094,15CS552,12,45,57,P,6,12019,Regular
4JN16CS094,15CS52,17,59,76,P,8,12019,Regular
4JN16CS094,15CS53,19,41,60,P,7,12019,Regular
4JN16CS094,15CS564,16,48,64,P,7,12019,Regular
4JN16CS094,15CS54,14,47,61,P,7,12019,Regular
4JN16CS094,15CSL57,19,78,97,P,10,12019,Regular
4JN16CS094,15CSL58,20,79,99,P,10,12019,Regular
4JN16CS095,15CS51,18,38,56,P,6,12019,Regular
4JN16CS095,15CS552,16,37,53,P,6,12019,Regular
4JN16CS095,15CS52,16,47,63,P,7,12019,Regular
4JN16CS095,15CS53,15,32,47,P,5,12019,Regular
4JN16CS095,15CS564,15,28,43,P,4,12019,Regular
4JN16CS095,15CS54,18,54,72,P,8,12019,Regular
4JN16CS095,15CSL57,18,78,96,P,10,12019,Regular
4JN16CS095,15CSL58,20,70,90,P,10,12019,Regular
4JN16CS099,15CS51,18,39,57,P,6,12019,Regular
4JN16CS099,15CS552,14,38,52,P,6,12019,Regular
4JN16CS099,15CS52,14,47,61,P,7,12019,Regular
4JN16CS099,15CS53,19,30,49,P,5,12019,Regular
4JN16CS099,15CS564,15,38,53,P,6,12019,Regular
4JN16CS099,15CS54,18,55,73,P,8,12019,Regular
4JN16CS099,15CSL57,18,78,96,P,10,12019,Regular
4JN16CS099,15CSL58,20,78,98,P,10,12019,Regular
4JN16CS100,15CS51,20,50,70,P,8,12019,Regular
4JN16CS100,15CS52,17,54,71,P,8,12019,Regular
4JN16CS100,15CS553,15,58,73,P,8,12019,Regular
4JN16CS100,15CS53,19,30,49,P,5,12019,Regular
4JN16CS100,15CS564,16,44,60,P,7,12019,Regular
4JN16CS100,15CS54,20,44,64,P,7,12019,Regular
4JN16CS100,15CSL57,18,50,68,P,7,12019,Regular
4JN16CS100,15CSL58,20,75,95,P,10,12019,Regular
4JN16CS101,15CS51,17,38,55,P,6,12019,Regular
4JN16CS101,15CS52,14,30,44,P,4,12019,Regular
4JN16CS101,15CS553,12,54,66,P,7,12019,Regular
4JN16CS101,15CS53,16,36,52,P,6,12019,Regular
4JN16CS101,15CS564,17,39,56,P,6,12019,Regular
4JN16CS101,15CS54,15,55,70,P,8,12019,Regular
4JN16CS101,15CSL57,17,48,65,P,7,12019,Regular
4JN16CS101,15CSL58,19,68,87,P,9,12019,Regular
4JN16CS102,15CS51,20,40,60,P,7,12019,Regular
4JN16CS102,15CS52,17,49,66,P,7,12019,Regular
4JN16CS102,15CS553,14,57,71,P,8,12019,Regular
4JN16CS102,15CS53,19,48,67,P,7,12019,Regular
4JN16CS102,15CS564,20,54,74,P,8,12019,Regular
4JN16CS102,15CS54,19,56,75,P,8,12019,Regular
4JN16CS102,15CSL57,16,79,95,P,10,12019,Regular
4JN16CS102,15CSL58,20,75,95,P,10,12019,Regular
4JN16CS103,15CS51,20,45,65,P,7,12019,Regular
4JN16CS103,15CS562,17,58,75,P,8,12019,Regular
4JN16CS103,15CS52,17,62,79,P,8,12019,Regular
4JN16CS103,15CS553,17,63,80,P,9,12019,Regular
4JN16CS103,15CS53,19,55,74,P,8,12019,Regular
4JN16CS103,15CS54,19,38,57,P,6,12019,Regular
4JN16CS103,15CSL57,19,78,97,P,10,12019,Regular
4JN16CS103,15CSL58,20,78,98,P,10,12019,Regular
4JN16CS105,15CS51,18,49,67,P,7,12019,Regular
4JN16CS105,15CS552,14,37,51,P,6,12019,Regular
4JN16CS105,15CS52,14,45,59,P,6,12019,Regular
4JN16CS105,15CS53,14,35,49,P,5,12019,Regular
4JN16CS105,15CS564,16,47,63,P,7,12019,Regular
4JN16CS105,15CS54,18,37,55,P,6,12019,Regular
4JN16CS105,15CSL57,17,54,71,P,8,12019,Regular
4JN16CS105,15CSL58,18,63,81,P,9,12019,Regular
4JN16CS108,15CS51,19,42,61,P,7,12019,Regular
4JN16CS108,15CS52,13,47,60,P,7,12019,Regular
4JN16CS108,15CS553,17,56,73,P,8,12019,Regular
4JN16CS108,15CS53,19,41,60,P,7,12019,Regular
4JN16CS108,15CS564,18,40,58,P,6,12019,Regular
4JN16CS108,15CS54,18,43,61,P,7,12019,Regular
4JN16CS108,15CSL57,18,72,90,P,10,12019,Regular
4JN16CS108,15CSL58,19,65,84,P,9,12019,Regular
4JN16CS109,15CS51,16,33,49,P,5,12019,Regular
4JN16CS109,15CS52,12,29,41,P,4,12019,Regular
4JN16CS109,15CS552,12,40,52,P,6,12019,Regular
4JN16CS109,15CS53,13,28,41,P,4,12019,Regular
4JN16CS109,15CS54,13,33,46,P,5,12019,Regular
4JN16CS109,15CS564,14,33,47,P,5,12019,Regular
4JN16CS109,15CSL57,18,19,37,F,0,12019,Regular
4JN16CS109,15CSL58,18,56,74,P,8,12019,Regular
4JN16CS109,15CS45,15,37,52,P,6,12019,Backlog
4JN16CS109,15MAT31,14,12,26,F,0,12019,Backlog
4JN16CS109,15CS33,12,37,49,P,5,12019,Backlog
4JN16CS109,15CS34,12,29,41,P,4,12019,Backlog
4JN16CS112,15CS51,20,40,60,P,7,12019,Regular
4JN16CS112,15CS52,15,45,60,P,7,12019,Regular
4JN16CS112,15CS553,15,45,60,P,7,12019,Regular
4JN16CS112,15CS53,17,28,45,P,5,12019,Regular
4JN16CS112,15CS564,20,44,64,P,7,12019,Regular
4JN16CS112,15CS54,19,47,66,P,7,12019,Regular
4JN16CS112,15CSL57,19,55,74,P,8,12019,Regular
4JN16CS112,15CSL58,20,79,99,P,10,12019,Regular
4JN16CS113,15CS51,19,61,80,P,9,12019,Regular
4JN16CS113,15CS52,16,48,64,P,7,12019,Regular
4JN16CS113,15CS553,12,33,45,P,5,12019,Regular
4JN16CS113,15CS53,17,42,59,P,6,12019,Regular
4JN16CS113,15CS564,14,40,54,P,6,12019,Regular
4JN16CS113,15CS54,16,43,59,P,6,12019,Regular
4JN16CS113,15CSL57,17,63,80,P,9,12019,Regular
4JN16CS113,15CSL58,20,70,90,P,10,12019,Regular
4JN16CS114,15CS51,20,49,69,P,7,12019,Regular
4JN16CS114,15CS562,13,41,54,P,6,12019,Regular
4JN16CS114,15CS552,18,59,77,P,8,12019,Regular
4JN16CS114,15CS52,17,63,80,P,9,12019,Regular
4JN16CS114,15CS53,17,53,70,P,8,12019,Regular
4JN16CS114,15CS54,17,46,63,P,7,12019,Regular
4JN16CS114,15CSL57,20,77,97,P,10,12019,Regular
4JN16CS114,15CSL58,20,77,97,P,10,12019,Regular
4JN16CS115,15CS51,18,30,48,P,5,12019,Regular
4JN16CS115,15CS52,13,48,61,P,7,12019,Regular
4JN16CS115,15CS53,14,34,48,P,5,12019,Regular
4JN16CS115,15CS553,12,53,65,P,7,12019,Regular
4JN16CS115,15CS54,12,28,40,P,4,12019,Regular
4JN16CS115,15CS564,15,48,63,P,7,12019,Regular
4JN16CS115,15CSL57,18,60,78,P,8,12019,Regular
4JN16CS115,15CSL58,18,60,78,P,8,12019,Regular
4JN16CS116,15CS51,18,39,57,P,6,12019,Regular
4JN16CS116,15CS52,12,42,54,P,6,12019,Regular
4JN16CS116,15CS53,13,32,45,P,5,12019,Regular
4JN16CS116,15CS553,12,30,42,P,4,12019,Regular
4JN16CS116,15CS54,16,21,37,F,0,12019,Regular
4JN16CS116,15CS564,10,30,40,P,4,12019,Regular
4JN16CS116,15CSL57,18,17,35,F,0,12019,Regular
4JN16CS116,15CSL58,19,64,83,P,9,12019,Regular
4JN16CS116,15CS42,14,37,51,P,6,12019,Backlog
4JN16CS117,15CS51,16,46,62,P,7,12019,Regular
4JN16CS117,15CS552,12,38,50,P,6,12019,Regular
4JN16CS117,15CS52,12,35,47,P,5,12019,Regular
4JN16CS117,15CS53,14,29,43,P,4,12019,Regular
4JN16CS117,15CS564,12,28,40,P,4,12019,Regular
4JN16CS117,15CS54,15,33,48,P,5,12019,Regular
4JN16CS117,15CSL57,17,18,35,F,0,12019,Regular
4JN16CS117,15CSL58,18,62,80,P,9,12019,Regular
4JN16CS117,15CS44,12,28,40,P,4,12019,Backlog
4JN16CS117,15CS45,13,30,43,P,4,12019,Backlog
4JN16CS117,15MAT31,10,30,40,P,4,12019,Backlog
4JN16CS117,15CS33,12,29,41,P,4,12019,Backlog
4JN16CS119,15CS51,19,39,58,P,6,12019,Regular
4JN16CS119,15CS552,13,40,53,P,6,12019,Regular
4JN16CS119,15CS52,15,46,61,P,7,12019,Regular
4JN16CS119,15CS53,15,34,49,P,5,12019,Regular
4JN16CS119,15CS564,18,42,60,P,7,12019,Regular
4JN16CS119,15CS54,14,37,51,P,6,12019,Regular
4JN16CS119,15CSL57,18,50,68,P,7,12019,Regular
4JN16CS119,15CSL58,20,78,98,P,10,12019,Regular
4JN16CS120,15CS51,20,60,80,P,9,12019,Regular
4JN16CS120,15CS52,17,41,58,P,6,12019,Regular
4JN16CS120,15CS553,15,34,49,P,5,12019,Regular
4JN16CS120,15CS53,18,55,73,P,8,12019,Regular
4JN16CS120,15CS564,18,44,62,P,7,12019,Regular
4JN16CS120,15CS54,19,57,76,P,8,12019,Regular
4JN16CS120,15CSL57,19,79,98,P,10,12019,Regular
4JN16CS120,15CSL58,20,79,99,P,10,12019,Regular
4JN16CS121,15CS51,18,36,54,P,6,12019,Regular
4JN16CS121,15CS52,15,38,53,P,6,12019,Regular
4JN16CS121,15CS553,13,28,41,P,4,12019,Regular
4JN16CS121,15CS53,18,38,56,P,6,12019,Regular
4JN16CS121,15CS564,18,38,56,P,6,12019,Regular
4JN16CS121,15CS54,15,30,45,P,5,12019,Regular
4JN16CS121,15CSL57,18,35,53,P,6,12019,Regular
4JN16CS121,15CSL58,19,60,79,P,8,12019,Regular
4JN16CS123,15CS51,18,35,53,P,6,12019,Regular
4JN16CS123,15CS52,16,40,56,P,6,12019,Regular
4JN16CS123,15CS553,13,37,50,P,6,12019,Regular
4JN16CS123,15CS53,14,28,42,P,4,12019,Regular
4JN16CS123,15CS564,15,39,54,P,6,12019,Regular
4JN16CS123,15CS54,14,35,49,P,5,12019,Regular
4JN16CS123,15CSL57,16,45,61,P,7,12019,Regular
4JN16CS123,15CSL58,20,70,90,P,10,12019,Regular
4JN16CS124,15CS51,20,61,81,P,9,12019,Regular
4JN16CS124,15CS52,20,61,81,P,9,12019,Regular
4JN16CS124,15CS553,18,54,72,P,8,12019,Regular
4JN16CS124,15CS53,20,55,75,P,8,12019,Regular
4JN16CS124,15CS564,20,52,72,P,8,12019,Regular
4JN16CS124,15CS54,18,64,82,P,9,12019,Regular
4JN16CS124,15CSL57,19,79,98,P,10,12019,Regular
4JN16CS124,15CSL58,20,79,99,P,10,12019,Regular
4JN16CS125,15CS51,20,60,80,P,9,12019,Regular
4JN16CS125,15CS52,19,63,82,P,9,12019,Regular
4JN16CS125,15CS562,17,47,64,P,7,12019,Regular
4JN16CS125,15CS553,17,58,75,P,8,12019,Regular
4JN16CS125,15CS53,20,41,61,P,7,12019,Regular
4JN16CS125,15CS54,20,53,73,P,8,12019,Regular
4JN16CS125,15CSL57,18,76,94,P,10,12019,Regular
4JN16CS125,15CSL58,20,79,99,P,10,12019,Regular
4JN16CS126,15CS51,20,56,76,P,8,12019,Regular
4JN16CS126,15CS52,19,60,79,P,8,12019,Regular
4JN16CS126,15CS562,18,48,66,P,7,12019,Regular
4JN16CS126,15CS553,19,55,74,P,8,12019,Regular
4JN16CS126,15CS53,20,42,62,P,7,12019,Regular
4JN16CS126,15CS54,20,57,77,P,8,12019,Regular
4JN16CS126,15CSL57,20,78,98,P,10,12019,Regular
4JN16CS126,15CSL58,20,78,98,P,10,12019,Regular
4JN16CS129,15CS51,20,46,66,P,7,12019,Regular
4JN16CS129,15CS52,17,38,55,P,6,12019,Regular
4JN16CS129,15CS53,19,47,66,P,7,12019,Regular
4JN16CS129,15CS553,16,58,74,P,8,12019,Regular
4JN16CS129,15CS54,19,38,57,P,6,12019,Regular
4JN16CS129,15CS564,20,52,72,P,8,12019,Regular
4JN16CS129,15CSL57,18,59,77,P,8,12019,Regular
4JN16CS129,15CSL58,20,79,99,P,10,12019,Regular
4JN16CS131,15CS51,18,59,77,P,8,12019,Regular
4JN16CS131,15CS52,17,60,77,P,8,12019,Regular
4JN16CS131,15CS553,17,53,70,P,8,12019,Regular
4JN16CS131,15CS53,18,42,60,P,7,12019,Regular
4JN16CS131,15CS564,19,52,71,P,8,12019,Regular
4JN16CS131,15CS54,19,40,59,P,6,12019,Regular
4JN16CS131,15CSL57,18,72,90,P,10,12019,Regular
4JN16CS131,15CSL58,20,78,98,P,10,12019,Regular
4JN16CS132,15CS51,19,44,63,P,7,12019,Regular
4JN16CS132,15CS52,13,43,56,P,6,12019,Regular
4JN16CS132,15CS562,14,37,51,P,6,12019,Regular
4JN16CS132,15CS553,12,28,40,P,4,12019,Regular
4JN16CS132,15CS53,18,45,63,P,7,12019,Regular
4JN16CS132,15CS54,14,37,51,P,6,12019,Regular
4JN16CS132,15CSL57,17,32,49,P,5,12019,Regular
4JN16CS132,15CSL58,20,78,98,P,10,12019,Regular
4JN17CS402,15CS51,20,50,70,P,8,12019,Regular
4JN17CS402,15CS52,12,34,46,P,5,12019,Regular
4JN17CS402,15CS552,16,47,63,P,7,12019,Regular
4JN17CS402,15CS53,16,37,53,P,6,12019,Regular
4JN17CS402,15CS54,12,40,52,P,6,12019,Regular
4JN17CS402,15CS564,16,35,51,P,6,12019,Regular
4JN17CS402,15CSL57,17,60,77,P,8,12019,Regular
4JN17CS402,15CSL58,20,65,85,P,9,12019,Regular
4JN17CS402,15MATDIP41,0,28,28,P,0,12019,Backlog
4JN17CS402,15MAT41,10,30,40,P,4,12019,Backlog
4JN17CS403,15CS51,17,51,68,P,7,12019,Regular
4JN17CS403,15CS552,16,30,46,P,5,12019,Regular
4JN17CS403,15CS52,14,70,84,P,9,12019,Regular
4JN17CS403,15CS53,16,40,56,P,6,12019,Regular
4JN17CS403,15CS564,14,47,61,P,7,12019,Regular
4JN17CS403,15CS54,14,42,56,P,6,12019,Regular
4JN17CS403,15CSL57,18,64,82,P,9,12019,Regular
4JN17CS403,15CSL58,20,60,80,P,9,12019,Regular
4JN17CS403,15MATDIP41,0,16,16,F,0,12019,Backlog
4JN17CS407,15CS51,15,0,15,A,0,12019,Regular
4JN17CS407,15CS552,14,30,44,P,4,12019,Regular
4JN17CS407,15CS52,13,57,70,P,8,12019,Regular
4JN17CS407,15CS53,18,39,57,P,6,12019,Regular
4JN17CS407,15CS564,19,0,19,A,0,12019,Regular
4JN17CS407,15CS54,16,7,23,F,0,12019,Regular
4JN17CS407,15CSL57,18,0,18,A,0,12019,Regular
4JN17CS407,15CSL58,20,62,82,P,9,12019,Regular
4JN17CS407,15MAT41,12,0,12,A,0,12019,Backlog
4JN17CS407,15MAT31,12,0,12,A,0,12019,Backlog
4JN17CS412,15CS51,18,54,72,P,8,12019,Regular
4JN17CS412,15CS552,14,29,43,P,4,12019,Regular
4JN17CS412,15CS52,14,30,44,P,4,12019,Regular
4JN17CS412,15CS53,17,28,45,P,5,12019,Regular
4JN17CS412,15CS564,15,48,63,P,7,12019,Regular
4JN17CS412,15CS54,14,33,47,P,5,12019,Regular
4JN17CS412,15CSL57,18,47,65,P,7,12019,Regular
4JN17CS412,15CSL58,20,70,90,P,10,12019,Regular
4JN17CS412,15MATDIP41,0,28,28,P,0,12019,Backlog
4JN17CS412,15MATDIP31,0,20,20,F,0,12019,Backlog
4JN17CS416,15CS51,17,17,34,F,0,12019,Regular
4JN17CS416,15CS552,14,28,42,P,4,12019,Regular
4JN17CS416,15CS52,12,32,44,P,4,12019,Regular
4JN17CS416,15CS53,13,31,44,P,4,12019,Regular
4JN17CS416,15CS54,13,34,47,P,5,12019,Regular
4JN17CS416,15CS564,13,28,41,P,4,12019,Regular
4JN17CS416,15CSL57,18,35,53,P,6,12019,Regular
4JN17CS416,15CSL58,20,60,80,P,9,12019,Regular
4JN17CS416,15MAT41,9,11,20,F,0,12019,Backlog
4JN17CS416,15CS45,13,37,50,P,6,12019,Backlog
4JN17CS416,15CS46,12,35,47,P,5,12019,Backlog
4JN17CS416,15MAT31,12,14,26,F,0,12019,Backlog
4JN17CS418,15CS51,18,49,67,P,7,12019,Regular
4JN17CS418,15CS552,14,60,74,P,8,12019,Regular
4JN17CS418,15CS52,15,46,61,P,7,12019,Regular
4JN17CS418,15CS53,17,38,55,P,6,12019,Regular
4JN17CS418,15CS564,16,37,53,P,6,12019,Regular
4JN17CS418,15CS54,15,41,56,P,6,12019,Regular
4JN17CS418,15CSL57,17,74,91,P,10,12019,Regular
4JN17CS418,15CSL58,20,71,91,P,10,12019,Regular
4JN17CS418,15MATDIP31,0,25,25,F,0,12019,Backlog
4JN17CS419,15CS51,18,53,71,P,8,12019,Regular
4JN17CS419,15CS552,14,69,83,P,9,12019,Regular
4JN17CS419,15CS52,17,50,67,P,7,12019,Regular
4JN17CS419,15CS53,18,33,51,P,6,12019,Regular
4JN17CS419,15CS564,16,43,59,P,6,12019,Regular
4JN17CS419,15CS54,19,38,57,P,6,12019,Regular
4JN17CS419,15CSL57,18,40,58,P,6,12019,Regular
4JN17CS419,15CSL58,20,65,85,P,9,12019,Regular
4JN17CS419,15MATDIP31,0,35,35,P,0,12019,Backlog
4JN17CS423,15CS51,18,37,55,P,6,12019,Regular
4JN17CS423,15CS552,12,30,42,P,4,12019,Regular
4JN17CS423,15CS52,14,31,45,P,5,12019,Regular
4JN17CS423,15CS53,16,36,52,P,6,12019,Regular
4JN17CS423,15CS564,14,34,48,P,5,12019,Regular
4JN17CS423,15CS54,15,28,43,P,4,12019,Regular
4JN17CS423,15CSL57,17,32,49,P,5,12019,Regular
4JN17CS423,15CSL58,20,62,82,P,9,12019,Regular
4JN17CS423,15MAT41,12,28,40,P,4,12019,Backlog
4JN17CS423,15CS36,15,21,36,F,0,12019,Backlog
4JN14CS121,15CS71,16,35,51,P,6,12019,Regular
4JN14CS121,15CS72,16,21,37,F,0,12019,Regular
4JN14CS121,15CS73,16,28,44,P,4,12019,Regular
4JN14CS121,15CS754,15,43,58,P,6,12019,Regular
4JN14CS121,15CS744,15,32,47,P,5,12019,Regular
4JN14CS121,15CSL76,18,70,88,P,9,12019,Regular
4JN14CS121,15CSL77,19,61,80,P,9,12019,Regular
4JN14CS121,15CSP78,91,0,91,P,10,12019,Regular
4JN15CS001,15CS71,17,46,63,P,7,12019,Regular
4JN15CS001,15CS72,18,36,54,P,6,12019,Regular
4JN15CS001,15CS73,17,42,59,P,6,12019,Regular
4JN15CS001,15CS754,19,41,60,P,7,12019,Regular
4JN15CS001,15CSL76,20,74,94,P,10,12019,Regular
4JN15CS001,15CSL77,20,75,95,P,10,12019,Regular
4JN15CS001,15CSP78,93,0,93,P,10,12019,Regular
4JN15CS001,15CS742,16,50,66,P,7,12019,Regular
4JN15CS002,15CS71,18,49,67,P,7,12019,Regular
4JN15CS002,15CS72,16,28,44,P,4,12019,Regular
4JN15CS002,15CS73,12,38,50,P,6,12019,Regular
4JN15CS002,15CS754,15,40,55,P,6,12019,Regular
4JN15CS002,15CSL76,20,60,80,P,9,12019,Regular
4JN15CS002,15CSL77,20,46,66,P,7,12019,Regular
4JN15CS002,15CSP78,97,0,97,P,10,12019,Regular
4JN15CS002,15CS742,15,28,43,P,4,12019,Regular
4JN15CS003,15CS71,20,57,77,P,8,12019,Regular
4JN15CS003,15CS72,20,46,66,P,7,12019,Regular
4JN15CS003,15CS73,16,43,59,P,6,12019,Regular
4JN15CS003,15CS754,18,56,74,P,8,12019,Regular
4JN15CS003,15CS744,19,51,70,P,8,12019,Regular
4JN15CS003,15CSL76,19,74,93,P,10,12019,Regular
4JN15CS003,15CSL77,20,60,80,P,9,12019,Regular
4JN15CS003,15CSP78,95,0,95,P,10,12019,Regular
4JN15CS004,15CS71,16,39,55,P,6,12019,Regular
4JN15CS004,15CS72,19,33,52,P,6,12019,Regular
4JN15CS004,15CS73,16,57,73,P,8,12019,Regular
4JN15CS004,15CS754,18,35,53,P,6,12019,Regular
4JN15CS004,15CSL76,20,75,95,P,10,12019,Regular
4JN15CS004,15CSL77,20,72,92,P,10,12019,Regular
4JN15CS004,15CSP78,95,0,95,P,10,12019,Regular
4JN15CS004,15CS742,16,28,44,P,4,12019,Regular
4JN15CS005,15CS71,20,34,54,P,6,12019,Regular
4JN15CS005,15CS72,19,43,62,P,7,12019,Regular
4JN15CS005,15CS73,20,53,73,P,8,12019,Regular
4JN15CS005,15CS754,20,47,67,P,7,12019,Regular
4JN15CS005,15CSL76,20,77,97,P,10,12019,Regular
4JN15CS005,15CSL77,20,70,90,P,10,12019,Regular
4JN15CS005,15CSP78,98,0,98,P,10,12019,Regular
4JN15CS005,15CS742,20,52,72,P,8,12019,Regular
4JN15CS007,15CS71,20,46,66,P,7,12019,Regular
4JN15CS007,15CS72,20,44,64,P,7,12019,Regular
4JN15CS007,15CS73,18,47,65,P,7,12019,Regular
4JN15CS007,15CS754,19,52,71,P,8,12019,Regular
4JN15CS007,15CSL76,20,77,97,P,10,12019,Regular
4JN15CS007,15CSL77,20,72,92,P,10,12019,Regular
4JN15CS007,15CSP78,98,0,98,P,10,12019,Regular
4JN15CS007,15CS742,18,46,64,P,7,12019,Regular
4JN15CS008,15CS71,19,48,67,P,7,12019,Regular
4JN15CS008,15CS72,17,30,47,P,5,12019,Regular
4JN15CS008,15CS73,18,46,64,P,7,12019,Regular
4JN15CS008,15CS754,20,47,67,P,7,12019,Regular
4JN15CS008,15CS744,20,42,62,P,7,12019,Regular
4JN15CS008,15CSL76,20,70,90,P,10,12019,Regular
4JN15CS008,15CSL77,20,75,95,P,10,12019,Regular
4JN15CS008,15CSP78,99,0,99,P,10,12019,Regular
4JN15CS009,15CS71,20,60,80,P,9,12019,Regular
4JN15CS009,15CS72,20,51,71,P,8,12019,Regular
4JN15CS009,15CS73,20,56,76,P,8,12019,Regular
4JN15CS009,15CS754,20,68,88,P,9,12019,Regular
4JN15CS009,15CSL76,20,72,92,P,10,12019,Regular
4JN15CS009,15CSL77,18,69,87,P,9,12019,Regular
4JN15CS009,15CSP78,100,0,100,P,10,12019,Regular
4JN15CS009,15CS742,20,50,70,P,8,12019,Regular
4JN15CS011,15CS71,15,40,55,P,6,12019,Regular
4JN15CS011,15CS72,17,31,48,P,5,12019,Regular
4JN15CS011,15CS73,14,31,45,P,5,12019,Regular
4JN15CS011,15CS754,18,47,65,P,7,12019,Regular
4JN15CS011,15CS744,18,43,61,P,7,12019,Regular
4JN15CS011,15CSL76,20,77,97,P,10,12019,Regular
4JN15CS011,15CSL77,20,72,92,P,10,12019,Regular
4JN15CS011,15CSP78,88,0,88,P,9,12019,Regular
4JN15CS012,15CS71,18,52,70,P,8,12019,Regular
4JN15CS012,15CS72,14,46,60,P,7,12019,Regular
4JN15CS012,15CS73,17,29,46,P,5,12019,Regular
4JN15CS012,15CS754,18,60,78,P,8,12019,Regular
4JN15CS012,15CS744,17,50,67,P,7,12019,Regular
4JN15CS012,15CSL76,20,72,92,P,10,12019,Regular
4JN15CS012,15CSL77,20,64,84,P,9,12019,Regular
4JN15CS012,15CSP78,99,0,99,P,10,12019,Regular
4JN15CS014,15CS71,20,43,63,P,7,12019,Regular
4JN15CS014,15CS72,18,55,73,P,8,12019,Regular
4JN15CS014,15CS73,17,50,67,P,7,12019,Regular
4JN15CS014,15CS754,19,58,77,P,8,12019,Regular
4JN15CS014,15CSL76,20,69,89,P,9,12019,Regular
4JN15CS014,15CSL77,20,71,91,P,10,12019,Regular
4JN15CS014,15CSP78,93,0,93,P,10,12019,Regular
4JN15CS014,15CS742,19,58,77,P,8,12019,Regular
4JN15CS015,15CS71,18,51,69,P,7,12019,Regular
4JN15CS015,15CS72,16,32,48,P,5,12019,Regular
4JN15CS015,15CS73,18,57,75,P,8,12019,Regular
4JN15CS015,15CS754,18,42,60,P,7,12019,Regular
4JN15CS015,15CSL76,20,74,94,P,10,12019,Regular
4JN15CS015,15CSL77,20,72,92,P,10,12019,Regular
4JN15CS015,15CSP78,94,0,94,P,10,12019,Regular
4JN15CS015,15CS742,18,49,67,P,7,12019,Regular
4JN15CS016,15CS71,18,57,75,P,8,12019,Regular
4JN15CS016,15CS72,18,33,51,P,6,12019,Regular
4JN15CS016,15CS73,19,48,67,P,7,12019,Regular
4JN15CS016,15CS754,19,44,63,P,7,12019,Regular
4JN15CS016,15CSL76,19,72,91,P,10,12019,Regular
4JN15CS016,15CSL77,19,51,70,P,8,12019,Regular
4JN15CS016,15CSP78,93,0,93,P,10,12019,Regular
4JN15CS016,15CS742,17,41,58,P,6,12019,Regular
4JN15CS021,15CS71,18,53,71,P,8,12019,Regular
4JN15CS021,15CS72,17,36,53,P,6,12019,Regular
4JN15CS021,15CS73,17,59,76,P,8,12019,Regular
4JN15CS021,15CS754,19,51,70,P,8,12019,Regular
4JN15CS021,15CSL76,20,73,93,P,10,12019,Regular
4JN15CS021,15CSL77,20,71,91,P,10,12019,Regular
4JN15CS021,15CSP78,94,0,94,P,10,12019,Regular
4JN15CS021,15CS742,17,50,67,P,7,12019,Regular
4JN15CS022,15CS71,20,50,70,P,8,12019,Regular
4JN15CS022,15CS72,18,29,47,P,5,12019,Regular
4JN15CS022,15CS73,18,38,56,P,6,12019,Regular
4JN15CS022,15CS754,17,41,58,P,6,12019,Regular
4JN15CS022,15CSL76,19,73,92,P,10,12019,Regular
4JN15CS022,15CSL77,19,72,91,P,10,12019,Regular
4JN15CS022,15CSP78,92,0,92,P,10,12019,Regular
4JN15CS022,15CS742,17,48,65,P,7,12019,Regular
4JN15CS023,15CS71,13,28,41,P,4,12019,Regular
4JN15CS023,15CS72,17,28,45,P,5,12019,Regular
4JN15CS023,15CS73,18,38,56,P,6,12019,Regular
4JN15CS023,15CS754,14,36,50,P,6,12019,Regular
4JN15CS023,15CSL76,19,70,89,P,9,12019,Regular
4JN15CS023,15CSL77,19,51,70,P,8,12019,Regular
4JN15CS023,15CSP78,89,0,89,P,9,12019,Regular
4JN15CS023,15CS742,16,33,49,P,5,12019,Regular
4JN15CS024,15CS71,15,22,37,F,0,12019,Regular
4JN15CS024,15CS72,16,16,32,F,0,12019,Regular
4JN15CS024,15CS73,16,49,65,P,7,12019,Regular
4JN15CS024,15CS754,12,37,49,P,5,12019,Regular
4JN15CS024,15CSL76,19,73,92,P,10,12019,Regular
4JN15CS024,15CSL77,19,45,64,P,7,12019,Regular
4JN15CS024,15CSP78,95,0,95,P,10,12019,Regular
4JN15CS024,15CS742,12,18,30,F,0,12019,Regular
4JN15CS026,15CS71,20,37,57,P,6,12019,Regular
4JN15CS026,15CS72,17,40,57,P,6,12019,Regular
4JN15CS026,15CS73,19,45,64,P,7,12019,Regular
4JN15CS026,15CS754,20,42,62,P,7,12019,Regular
4JN15CS026,15CSL76,20,70,90,P,10,12019,Regular
4JN15CS026,15CSL77,20,67,87,P,9,12019,Regular
4JN15CS026,15CSP78,92,0,92,P,10,12019,Regular
4JN15CS026,15CS742,20,45,65,P,7,12019,Regular
4JN15CS027,15CS71,20,58,78,P,8,12019,Regular
4JN15CS027,15CS72,18,62,80,P,9,12019,Regular
4JN15CS027,15CS73,19,53,72,P,8,12019,Regular
4JN15CS027,15CS754,19,70,89,P,9,12019,Regular
4JN15CS027,15CSL76,20,74,94,P,10,12019,Regular
4JN15CS027,15CSL77,20,75,95,P,10,12019,Regular
4JN15CS027,15CSP78,100,0,100,P,10,12019,Regular
4JN15CS027,15CS742,18,53,71,P,8,12019,Regular
4JN15CS028,15CS71,19,41,60,P,7,12019,Regular
4JN15CS028,15CS72,20,52,72,P,8,12019,Regular
4JN15CS028,15CS73,19,48,67,P,7,12019,Regular
4JN15CS028,15CS754,19,57,76,P,8,12019,Regular
4JN15CS028,15CSL76,20,75,95,P,10,12019,Regular
4JN15CS028,15CSL77,19,71,90,P,10,12019,Regular
4JN15CS028,15CSP78,96,0,96,P,10,12019,Regular
4JN15CS028,15CS742,19,47,66,P,7,12019,Regular
4JN15CS029,15CS71,20,57,77,P,8,12019,Regular
4JN15CS029,15CS72,18,51,69,P,7,12019,Regular
4JN15CS029,15CS73,19,47,66,P,7,12019,Regular
4JN15CS029,15CS754,19,37,56,P,6,12019,Regular
4JN15CS029,15CS744,18,57,75,P,8,12019,Regular
4JN15CS029,15CSL76,20,77,97,P,10,12019,Regular
4JN15CS029,15CSL77,20,76,96,P,10,12019,Regular
4JN15CS029,15CSP78,73,0,73,P,8,12019,Regular
4JN15CS030,15CS71,20,46,66,P,7,12019,Regular
4JN15CS030,15CS72,19,39,58,P,6,12019,Regular
4JN15CS030,15CS73,16,60,76,P,8,12019,Regular
4JN15CS030,15CS754,18,36,54,P,6,12019,Regular
4JN15CS030,15CS744,20,44,64,P,7,12019,Regular
4JN15CS030,15CSL76,20,60,80,P,9,12019,Regular
4JN15CS030,15CSL77,19,60,79,P,8,12019,Regular
4JN15CS030,15CSP78,95,0,95,P,10,12019,Regular
4JN15CS031,15CS71,20,46,66,P,7,12019,Regular
4JN15CS031,15CS72,20,28,48,P,5,12019,Regular
4JN15CS031,15CS73,19,39,58,P,6,12019,Regular
4JN15CS031,15CS754,20,58,78,P,8,12019,Regular
4JN15CS031,15CS744,20,49,69,P,7,12019,Regular
4JN15CS031,15CSL76,19,72,91,P,10,12019,Regular
4JN15CS031,15CSL77,20,68,88,P,9,12019,Regular
4JN15CS031,15CSP78,99,0,99,P,10,12019,Regular
4JN15CS032,15CS71,19,58,77,P,8,12019,Regular
4JN15CS032,15CS72,20,44,64,P,7,12019,Regular
4JN15CS032,15CS73,18,53,71,P,8,12019,Regular
4JN15CS032,15CS754,18,48,66,P,7,12019,Regular
4JN15CS032,15CSL76,20,75,95,P,10,12019,Regular
4JN15CS032,15CSL77,20,72,92,P,10,12019,Regular
4JN15CS032,15CSP78,98,0,98,P,10,12019,Regular
4JN15CS032,15CS742,18,47,65,P,7,12019,Regular
4JN15CS033,15CS71,18,54,72,P,8,12019,Regular
4JN15CS033,15CS72,16,50,66,P,7,12019,Regular
4JN15CS033,15CS73,16,35,51,P,6,12019,Regular
4JN15CS033,15CS754,17,45,62,P,7,12019,Regular
4JN15CS033,15CS744,19,50,69,P,7,12019,Regular
4JN15CS033,15CSL76,19,65,84,P,9,12019,Regular
4JN15CS033,15CSL77,20,61,81,P,9,12019,Regular
4JN15CS033,15CSP78,99,0,99,P,10,12019,Regular
4JN15CS034,15CS71,20,48,68,P,7,12019,Regular
4JN15CS034,15CS72,18,28,46,P,5,12019,Regular
4JN15CS034,15CS73,17,33,50,P,6,12019,Regular
4JN15CS034,15CS754,18,42,60,P,7,12019,Regular
4JN15CS034,15CSL76,20,70,90,P,10,12019,Regular
4JN15CS034,15CSL77,20,75,95,P,10,12019,Regular
4JN15CS034,15CSP78,98,0,98,P,10,12019,Regular
4JN15CS034,15CS742,17,36,53,P,6,12019,Regular
4JN15CS035,15CS71,20,51,71,P,8,12019,Regular
4JN15CS035,15CS72,19,67,86,P,9,12019,Regular
4JN15CS035,15CS73,20,60,80,P,9,12019,Regular
4JN15CS035,15CS754,20,59,79,P,8,12019,Regular
4JN15CS035,15CSL76,20,77,97,P,10,12019,Regular
4JN15CS035,15CSL77,20,73,93,P,10,12019,Regular
4JN15CS035,15CSP78,99,0,99,P,10,12019,Regular
4JN15CS035,15CS742,20,55,75,P,8,12019,Regular
4JN15CS036,15CS71,18,53,71,P,8,12019,Regular
4JN15CS036,15CS72,19,59,78,P,8,12019,Regular
4JN15CS036,15CS73,20,42,62,P,7,12019,Regular
4JN15CS036,15CS754,19,66,85,P,9,12019,Regular
4JN15CS036,15CSL76,20,77,97,P,10,12019,Regular
4JN15CS036,15CSL77,19,61,80,P,9,12019,Regular
4JN15CS036,15CSP78,98,0,98,P,10,12019,Regular
4JN15CS036,15CS742,19,56,75,P,8,12019,Regular
4JN15CS037,15CS71,17,32,49,P,5,12019,Regular
4JN15CS037,15CS72,16,37,53,P,6,12019,Regular
4JN15CS037,15CS73,17,28,45,P,5,12019,Regular
4JN15CS037,15CS754,18,43,61,P,7,12019,Regular
4JN15CS037,15CS744,17,30,47,P,5,12019,Regular
4JN15CS037,15CSL76,20,64,84,P,9,12019,Regular
4JN15CS037,15CSL77,20,67,87,P,9,12019,Regular
4JN15CS037,15CSP78,99,0,99,P,10,12019,Regular
4JN15CS038,15CS71,17,40,57,P,6,12019,Regular
4JN15CS038,15CS72,19,44,63,P,7,12019,Regular
4JN15CS038,15CS73,17,40,57,P,6,12019,Regular
4JN15CS038,15CS754,17,48,65,P,7,12019,Regular
4JN15CS038,15CS744,17,54,71,P,8,12019,Regular
4JN15CS038,15CSL76,20,70,90,P,10,12019,Regular
4JN15CS038,15CSL77,20,65,85,P,9,12019,Regular
4JN15CS038,15CSP78,88,0,88,P,9,12019,Regular
4JN15CS043,15CS71,19,73,92,P,10,12019,Regular
4JN15CS043,15CS72,19,39,58,P,6,12019,Regular
4JN15CS043,15CS73,18,49,67,P,7,12019,Regular
4JN15CS043,15CS754,19,40,59,P,6,12019,Regular
4JN15CS043,15CSL76,19,75,94,P,10,12019,Regular
4JN15CS043,15CSL77,19,73,92,P,10,12019,Regular
4JN15CS043,15CSP78,99,0,99,P,10,12019,Regular
4JN15CS043,15CS742,18,61,79,P,8,12019,Regular
4JN15CS044,15CS71,19,56,75,P,8,12019,Regular
4JN15CS044,15CS72,20,45,65,P,7,12019,Regular
4JN15CS044,15CS73,17,55,72,P,8,12019,Regular
4JN15CS044,15CS754,19,48,67,P,7,12019,Regular
4JN15CS044,15CSL76,20,60,80,P,9,12019,Regular
4JN15CS044,15CSL77,20,73,93,P,10,12019,Regular
4JN15CS044,15CSP78,95,0,95,P,10,12019,Regular
4JN15CS044,15CS742,19,42,61,P,7,12019,Regular
4JN15CS045,15CS71,19,70,89,P,9,12019,Regular
4JN15CS045,15CS72,20,54,74,P,8,12019,Regular
4JN15CS045,15CS73,18,68,86,P,9,12019,Regular
4JN15CS045,15CS754,18,44,62,P,7,12019,Regular
4JN15CS045,15CSL76,19,74,93,P,10,12019,Regular
4JN15CS045,15CSL77,20,73,93,P,10,12019,Regular
4JN15CS045,15CSP78,90,0,90,P,10,12019,Regular
4JN15CS045,15CS742,20,58,78,P,8,12019,Regular
4JN15CS047,15CS71,19,49,68,P,7,12019,Regular
4JN15CS047,15CS72,17,28,45,P,5,12019,Regular
4JN15CS047,15CS73,18,33,51,P,6,12019,Regular
4JN15CS047,15CS754,16,39,55,P,6,12019,Regular
4JN15CS047,15CSL76,20,72,92,P,10,12019,Regular
4JN15CS047,15CSL77,19,61,80,P,9,12019,Regular
4JN15CS047,15CSP78,95,0,95,P,10,12019,Regular
4JN15CS047,15CS742,16,45,61,P,7,12019,Regular
4JN15CS048,15CS71,17,53,70,P,8,12019,Regular
4JN15CS048,15CS72,17,58,75,P,8,12019,Regular
4JN15CS048,15CS73,18,55,73,P,8,12019,Regular
4JN15CS048,15CS754,20,49,69,P,7,12019,Regular
4JN15CS048,15CS744,18,61,79,P,8,12019,Regular
4JN15CS048,15CSL76,18,75,93,P,10,12019,Regular
4JN15CS048,15CSL77,20,71,91,P,10,12019,Regular
4JN15CS048,15CSP78,88,0,88,P,9,12019,Regular
4JN15CS050,15CS71,20,50,70,P,8,12019,Regular
4JN15CS050,15CS72,19,37,56,P,6,12019,Regular
4JN15CS050,15CS73,19,43,62,P,7,12019,Regular
4JN15CS050,15CS754,18,51,69,P,7,12019,Regular
4JN15CS050,15CS744,16,50,66,P,7,12019,Regular
4JN15CS050,15CSL76,20,77,97,P,10,12019,Regular
4JN15CS050,15CSL77,20,73,93,P,10,12019,Regular
4JN15CS050,15CSP78,99,0,99,P,10,12019,Regular
4JN15CS051,15CS71,19,44,63,P,7,12019,Regular
4JN15CS051,15CS72,20,44,64,P,7,12019,Regular
4JN15CS051,15CS73,18,55,73,P,8,12019,Regular
4JN15CS051,15CS754,20,54,74,P,8,12019,Regular
4JN15CS051,15CS744,20,43,63,P,7,12019,Regular
4JN15CS051,15CSL76,20,75,95,P,10,12019,Regular
4JN15CS051,15CSL77,20,74,94,P,10,12019,Regular
4JN15CS051,15CSP78,100,0,100,P,10,12019,Regular
4JN15CS053,15CS71,17,32,49,P,5,12019,Regular
4JN15CS053,15CS72,18,41,59,P,6,12019,Regular
4JN15CS053,15CS73,18,48,66,P,7,12019,Regular
4JN15CS053,15CS754,18,40,58,P,6,12019,Regular
4JN15CS053,15CSL76,20,73,93,P,10,12019,Regular
4JN15CS053,15CSL77,20,65,85,P,9,12019,Regular
4JN15CS053,15CSP78,97,0,97,P,10,12019,Regular
4JN15CS053,15CS742,15,46,61,P,7,12019,Regular
4JN17CS094,18CHE22,23,30,53,P,6,72019,Regular
4JN17CS094,18MAT21,24,21,45,P,5,72019,Regular
4JN17CS094,18CPS23,27,22,49,P,5,72019,Regular
4JN17CS094,18ELN24,19,7,26,F,0,72019,Regular
4JN17CS094,18ME25,27,21,48,P,5,72019,Regular
4JN17CS094,18CHEL26,36,40,76,P,8,72019,Regular
4JN17CS094,18CPL27,32,29,61,P,7,72019,Regular
4JN17CS094,18EGH28,28,36,64,P,7,72019,Regular
4JN17CS094,18ELE13,23,11,34,F,0,72019,Backlog
4JN17CS094,18CIV14,30,16,46,F,0,72019,Backlog
4JN17CS094,18EGDL15,37,27,64,P,7,72019,Backlog
4JN17CS094,18PHYL16,31,24,55,P,6,72019,Backlog
4JN18CS002,18MAT21,39,51,90,P,10,72019,Regular
4JN18CS002,18CHE22,38,40,78,P,8,72019,Regular
4JN18CS002,18CPS23,37,38,75,P,8,72019,Regular
4JN18CS002,18ELN24,35,36,71,P,8,72019,Regular
4JN18CS002,18ME25,35,35,70,P,8,72019,Regular
4JN18CS002,18CHEL26,37,56,93,P,10,72019,Regular
4JN18CS002,18CPL27,40,57,97,P,10,72019,Regular
4JN18CS002,18EGH28,32,33,65,P,7,72019,Regular
4JN18CS003,18MAT21,34,54,88,P,9,72019,Regular
4JN18CS003,18CHE22,39,53,92,P,10,72019,Regular
4JN18CS003,18CPS23,37,32,69,P,7,72019,Regular
4JN18CS003,18ELN24,33,29,62,P,7,72019,Regular
4JN18CS003,18ME25,35,33,68,P,7,72019,Regular
4JN18CS003,18CHEL26,39,57,96,P,10,72019,Regular
4JN18CS003,18CPL27,40,57,97,P,10,72019,Regular
4JN18CS003,18EGH28,30,35,65,P,7,72019,Regular
4JN18CS004,18MAT21,19,21,40,P,4,72019,Regular
4JN18CS004,18CHE22,24,17,41,F,0,72019,Regular
4JN18CS004,18CPS23,32,10,42,F,0,72019,Regular
4JN18CS004,18ELN24,21,13,34,F,0,72019,Regular
4JN18CS004,18ME25,30,26,56,P,6,72019,Regular
4JN18CS004,18CHEL26,38,46,84,P,9,72019,Regular
4JN18CS004,18CPL27,38,38,76,P,8,72019,Regular
4JN18CS004,18EGH28,30,22,52,P,6,72019,Regular
4JN18CS005,18MAT21,26,21,47,P,5,72019,Regular
4JN18CS005,18CHE22,27,27,54,P,6,72019,Regular
4JN18CS005,18CPS23,36,40,76,P,8,72019,Regular
4JN18CS005,18ELN24,24,24,48,P,5,72019,Regular
4JN18CS005,18ME25,33,29,62,P,7,72019,Regular
4JN18CS005,18CHEL26,37,48,85,P,9,72019,Regular
4JN18CS005,18CPL27,40,54,94,P,10,72019,Regular
4JN18CS005,18EGH28,28,29,57,P,6,72019,Regular
4JN18CS005,18CIV14,24,24,48,P,5,72019,Backlog
4JN18CS006,18MAT21,34,45,79,P,8,72019,Regular
4JN18CS006,18CHE22,35,35,70,P,8,72019,Regular
4JN18CS006,18CPS23,31,25,56,P,6,72019,Regular
4JN18CS006,18ELN24,29,34,63,P,7,72019,Regular
4JN18CS006,18ME25,39,39,78,P,8,72019,Regular
4JN18CS006,18CHEL26,39,42,81,P,9,72019,Regular
4JN18CS006,18CPL27,39,47,86,P,9,72019,Regular
4JN18CS006,18EGH28,28,36,64,P,7,72019,Regular
4JN18CS007,18MAT21,21,24,45,P,5,72019,Regular
4JN18CS007,18CHE22,27,27,54,P,6,72019,Regular
4JN18CS007,18CPS23,26,34,60,P,7,72019,Regular
4JN18CS007,18ELN24,22,21,43,P,4,72019,Regular
4JN18CS007,18ME25,27,25,52,P,6,72019,Regular
4JN18CS007,18CHEL26,36,42,78,P,8,72019,Regular
4JN18CS007,18CPL27,35,39,74,P,8,72019,Regular
4JN18CS007,18EGH28,28,26,54,P,6,72019,Regular
4JN18CS008,18MAT21,33,46,79,P,8,72019,Regular
4JN18CS008,18CHE22,39,34,73,P,8,72019,Regular
4JN18CS008,18CPS23,35,33,68,P,7,72019,Regular
4JN18CS008,18ELN24,33,23,56,P,6,72019,Regular
4JN18CS008,18ME25,35,22,57,P,6,72019,Regular
4JN18CS008,18CHEL26,39,39,78,P,8,72019,Regular
4JN18CS008,18CPL27,40,56,96,P,10,72019,Regular
4JN18CS008,18EGH28,28,23,51,P,6,72019,Regular
4JN18CS008,18EGDL15,37,37,74,P,8,72019,Backlog
4JN18CS009,18MAT21,32,48,80,P,9,72019,Regular
4JN18CS009,18CHE22,38,47,85,P,9,72019,Regular
4JN18CS009,18CPS23,38,42,80,P,9,72019,Regular
4JN18CS009,18ELN24,32,25,57,P,6,72019,Regular
4JN18CS009,18ME25,36,41,77,P,8,72019,Regular
4JN18CS009,18CHEL26,37,57,94,P,10,72019,Regular
4JN18CS009,18CPL27,40,55,95,P,10,72019,Regular
4JN18CS009,18EGH28,34,25,59,P,6,72019,Regular
4JN18CS010,18MAT21,33,38,71,P,8,72019,Regular
4JN18CS010,18CHE22,33,48,81,P,9,72019,Regular
4JN18CS010,18CPS23,37,30,67,P,7,72019,Regular
4JN18CS010,18ELN24,31,26,57,P,6,72019,Regular
4JN18CS010,18ME25,34,42,76,P,8,72019,Regular
4JN18CS010,18CHEL26,37,41,78,P,8,72019,Regular
4JN18CS010,18CPL27,40,57,97,P,10,72019,Regular
4JN18CS010,18EGH28,36,46,82,P,9,72019,Regular
4JN18CS010,18EGDL15,37,38,75,P,8,72019,Backlog
4JN18CS011,18MAT21,39,52,91,P,10,72019,Regular
4JN18CS011,18CHE22,40,45,85,P,9,72019,Regular
4JN18CS011,18CPS23,40,33,73,P,8,72019,Regular
4JN18CS011,18ELN24,38,35,73,P,8,72019,Regular
4JN18CS011,18ME25,37,30,67,P,7,72019,Regular
4JN18CS011,18CHEL26,40,41,81,P,9,72019,Regular
4JN18CS011,18CPL27,40,57,97,P,10,72019,Regular
4JN18CS011,18EGH28,32,39,71,P,8,72019,Regular
4JN18CS012,18MAT21,32,35,67,P,7,72019,Regular
4JN18CS012,18CHE22,21,27,48,P,5,72019,Regular
4JN18CS012,18CPS23,32,28,60,P,7,72019,Regular
4JN18CS012,18ELN24,26,33,59,P,6,72019,Regular
4JN18CS012,18ME25,35,41,76,P,8,72019,Regular
4JN18CS012,18CHEL26,35,56,91,P,10,72019,Regular
4JN18CS012,18CPL27,36,45,81,P,9,72019,Regular
4JN18CS012,18EGH28,25,31,56,P,6,72019,Regular
4JN18CS014,18MAT21,40,58,98,P,10,72019,Regular
4JN18CS014,18CHE22,40,53,93,P,10,72019,Regular
4JN18CS014,18CPS23,40,33,73,P,8,72019,Regular
4JN18CS014,18ELN24,35,33,68,P,7,72019,Regular
4JN18CS014,18ME25,40,35,75,P,8,72019,Regular
4JN18CS014,18CHEL26,39,59,98,P,10,72019,Regular
4JN18CS014,18CPL27,40,56,96,P,10,72019,Regular
4JN18CS014,18EGH28,30,36,66,P,7,72019,Regular
4JN18CS015,18MAT21,38,53,91,P,10,72019,Regular
4JN18CS015,18CHE22,40,54,94,P,10,72019,Regular
4JN18CS015,18CPS23,36,33,69,P,7,72019,Regular
4JN18CS015,18ELN24,34,29,63,P,7,72019,Regular
4JN18CS015,18ME25,37,23,60,P,7,72019,Regular
4JN18CS015,18CHEL26,38,54,92,P,10,72019,Regular
4JN18CS015,18CPL27,40,54,94,P,10,72019,Regular
4JN18CS015,18EGH28,28,34,62,P,7,72019,Regular
4JN18CS016,18MAT21,33,53,86,P,9,72019,Regular
4JN18CS016,18CHE22,34,45,79,P,8,72019,Regular
4JN18CS016,18CPS23,34,32,66,P,7,72019,Regular
4JN18CS016,18ELN24,31,23,54,P,6,72019,Regular
4JN18CS016,18ME25,38,42,80,P,9,72019,Regular
4JN18CS016,18CHEL26,39,48,87,P,9,72019,Regular
4JN18CS016,18CPL27,40,49,89,P,9,72019,Regular
4JN18CS016,18EGH28,32,36,68,P,7,72019,Regular
4JN18CS017,18MAT21,28,21,49,P,5,72019,Regular
4JN18CS017,18CHE22,26,29,55,P,6,72019,Regular
4JN18CS017,18CPS23,38,29,67,P,7,72019,Regular
4JN18CS017,18ELN24,27,21,48,P,5,72019,Regular
4JN18CS017,18ME25,32,32,64,P,7,72019,Regular
4JN18CS017,18CHEL26,37,52,89,P,9,72019,Regular
4JN18CS017,18CPL27,40,56,96,P,10,72019,Regular
4JN18CS017,18EGH28,24,26,50,P,6,72019,Regular
4JN18CS017,18ELE13,30,29,59,P,6,72019,Backlog
4JN18CS018,18MAT21,27,29,56,P,6,72019,Regular
4JN18CS018,18CHE22,31,24,55,P,6,72019,Regular
4JN18CS018,18CPS23,33,29,62,P,7,72019,Regular
4JN18CS018,18ELN24,26,15,41,F,0,72019,Regular
4JN18CS018,18ME25,34,22,56,P,6,72019,Regular
4JN18CS018,18CHEL26,37,42,79,P,8,72019,Regular
4JN18CS018,18CPL27,38,43,81,P,9,72019,Regular
4JN18CS018,18EGH28,28,23,51,P,6,72019,Regular
4JN18CS018,18EGDL15,37,24,61,P,7,72019,Backlog
4JN18CS019,18MAT21,40,60,100,P,10,72019,Regular
4JN18CS019,18CHE22,40,45,85,P,9,72019,Regular
4JN18CS019,18CPS23,39,51,90,P,10,72019,Regular
4JN18CS019,18ELN24,38,38,76,P,8,72019,Regular
4JN18CS019,18ME25,38,48,86,P,9,72019,Regular
4JN18CS019,18CHEL26,40,59,99,P,10,72019,Regular
4JN18CS019,18CPL27,40,57,97,P,10,72019,Regular
4JN18CS019,18EGH28,33,35,68,P,7,72019,Regular
4JN18CS020,18MAT21,37,53,90,P,10,72019,Regular
4JN18CS020,18CHE22,37,49,86,P,9,72019,Regular
4JN18CS020,18CPS23,38,36,74,P,8,72019,Regular
4JN18CS020,18ELN24,31,28,59,P,6,72019,Regular
4JN18CS020,18ME25,36,29,65,P,7,72019,Regular
4JN18CS020,18CHEL26,37,44,81,P,9,72019,Regular
4JN18CS020,18CPL27,40,57,97,P,10,72019,Regular
4JN18CS020,18EGH28,30,35,65,P,7,72019,Regular
4JN18CS021,18MAT21,40,59,99,P,10,72019,Regular
4JN18CS021,18CHE22,40,51,91,P,10,72019,Regular
4JN18CS021,18CPS23,39,36,75,P,8,72019,Regular
4JN18CS021,18ELN24,39,42,81,P,9,72019,Regular
4JN18CS021,18ME25,40,35,75,P,8,72019,Regular
4JN18CS021,18CHEL26,36,54,90,P,10,72019,Regular
4JN18CS021,18CPL27,40,48,88,P,9,72019,Regular
4JN18CS021,18EGH28,30,30,60,P,7,72019,Regular
4JN18CS022,18MAT21,35,51,86,P,9,72019,Regular
4JN18CS022,18CHE22,37,50,87,P,9,72019,Regular
4JN18CS022,18CPS23,36,39,75,P,8,72019,Regular
4JN18CS022,18ELN24,29,30,59,P,6,72019,Regular
4JN18CS022,18ME25,38,41,79,P,8,72019,Regular
4JN18CS022,18CHEL26,37,55,92,P,10,72019,Regular
4JN18CS022,18CPL27,40,51,91,P,10,72019,Regular
4JN18CS022,18EGH28,30,35,65,P,7,72019,Regular
4JN18CS026,18MAT21,31,42,73,P,8,72019,Regular
4JN18CS026,18CHE22,30,42,72,P,8,72019,Regular
4JN18CS026,18CPS23,34,23,57,P,6,72019,Regular
4JN18CS026,18ELN24,26,21,47,P,5,72019,Regular
4JN18CS026,18ME25,33,35,68,P,7,72019,Regular
4JN18CS026,18CHEL26,37,50,87,P,9,72019,Regular
4JN18CS026,18CPL27,28,50,78,P,8,72019,Regular
4JN18CS026,18EGH28,28,32,60,P,7,72019,Regular
4JN18CS028,18MAT21,22,24,46,P,5,72019,Regular
4JN18CS028,18CHE22,22,26,48,P,5,72019,Regular
4JN18CS028,18CPS23,27,27,54,P,6,72019,Regular
4JN18CS028,18ELN24,20,39,59,P,6,72019,Regular
4JN18CS028,18ME25,25,27,52,P,6,72019,Regular
4JN18CS028,18CHEL26,39,34,73,P,8,72019,Regular
4JN18CS028,18CPL27,28,40,68,P,7,72019,Regular
4JN18CS028,18EGH28,25,26,51,P,6,72019,Regular
4JN18CS030,18MAT21,40,55,95,P,10,72019,Regular
4JN18CS030,18CHE22,35,41,76,P,8,72019,Regular
4JN18CS030,18CPS23,40,38,78,P,8,72019,Regular
4JN18CS030,18ELN24,34,38,72,P,8,72019,Regular
4JN18CS030,18ME25,30,35,65,P,7,72019,Regular
4JN18CS030,18CHEL26,36,56,92,P,10,72019,Regular
4JN18CS030,18CPL27,40,59,99,P,10,72019,Regular
4JN18CS030,18EGH28,32,32,64,P,7,72019,Regular
4JN18CS031,18MAT21,40,59,99,P,10,72019,Regular
4JN18CS031,18CHE22,40,48,88,P,9,72019,Regular
4JN18CS031,18CPS23,40,39,79,P,8,72019,Regular
4JN18CS031,18ELN24,36,33,69,P,7,72019,Regular
4JN18CS031,18ME25,37,39,76,P,8,72019,Regular
4JN18CS031,18CHEL26,37,54,91,P,10,72019,Regular
4JN18CS031,18CPL27,40,59,99,P,10,72019,Regular
4JN18CS031,18EGH28,29,28,57,P,6,72019,Regular
4JN18CS034,18MAT21,37,44,81,P,9,72019,Regular
4JN18CS034,18CHE22,40,51,91,P,10,72019,Regular
4JN18CS034,18CPS23,40,46,86,P,9,72019,Regular
4JN18CS034,18ELN24,39,40,79,P,8,72019,Regular
4JN18CS034,18ME25,40,43,83,P,9,72019,Regular
4JN18CS034,18CHEL26,37,52,89,P,9,72019,Regular
4JN18CS034,18CPL27,40,59,99,P,10,72019,Regular
4JN18CS034,18EGH28,34,39,73,P,8,72019,Regular
4JN18CS035,18MAT21,27,32,59,P,6,72019,Regular
4JN18CS035,18CHE22,23,32,55,P,6,72019,Regular
4JN18CS035,18CPS23,31,38,69,P,7,72019,Regular
4JN18CS035,18ELN24,20,15,35,F,0,72019,Regular
4JN18CS035,18ME25,26,26,52,P,6,72019,Regular
4JN18CS035,18CHEL26,35,54,89,P,9,72019,Regular
4JN18CS035,18CPL27,40,55,95,P,10,72019,Regular
4JN18CS035,18EGH28,26,30,56,P,6,72019,Regular
4JN18CS035,18ELE13,22,21,43,P,4,72019,Backlog
4JN18CS040,18MAT21,30,33,63,P,7,72019,Regular
4JN18CS040,18CHE22,30,35,65,P,7,72019,Regular
4JN18CS040,18CPS23,37,26,63,P,7,72019,Regular
4JN18CS040,18ELN24,26,21,47,P,5,72019,Regular
4JN18CS040,18ME25,26,35,61,P,7,72019,Regular
4JN18CS040,18CHEL26,37,50,87,P,9,72019,Regular
4JN18CS040,18CPL27,40,57,97,P,10,72019,Regular
4JN18CS040,18EGH28,30,30,60,P,7,72019,Regular
4JN18CS040,18ELE13,29,24,53,P,6,72019,Backlog
4JN18CS044,18MAT21,33,44,77,P,8,72019,Regular
4JN18CS044,18CHE22,37,30,67,P,7,72019,Regular
4JN18CS044,18CPS23,33,26,59,P,6,72019,Regular
4JN18CS044,18ELN24,32,30,62,P,7,72019,Regular
4JN18CS044,18ME25,34,29,63,P,7,72019,Regular
4JN18CS044,18CHEL26,37,44,81,P,9,72019,Regular
4JN18CS044,18CPL27,40,57,97,P,10,72019,Regular
4JN18CS044,18EGH28,24,30,54,P,6,72019,Regular
4JN18CS044,18EGDL15,38,58,96,P,10,72019,Backlog
4JN18CS046,18MAT21,38,50,88,P,9,72019,Regular
4JN18CS046,18CHE22,36,54,90,P,10,72019,Regular
4JN18CS046,18CPS23,35,35,70,P,8,72019,Regular
4JN18CS046,18ELN24,32,32,64,P,7,72019,Regular
4JN18CS046,18ME25,37,44,81,P,9,72019,Regular
4JN18CS046,18CHEL26,36,51,87,P,9,72019,Regular
4JN18CS046,18CPL27,40,59,99,P,10,72019,Regular
4JN18CS046,18EGH28,25,27,52,P,6,72019,Regular
4JN18CS046,18EGDL15,38,33,71,P,8,72019,Backlog
4JN18CS067,18MAT21,22,27,49,P,5,72019,Regular
4JN18CS067,18CHE22,26,28,54,P,6,72019,Regular
4JN18CS067,18CPS23,31,26,57,P,6,72019,Regular
4JN18CS067,18ELN24,25,15,40,F,0,72019,Regular
4JN18CS067,18ME25,20,31,51,P,6,72019,Regular
4JN18CS067,18CHEL26,30,53,83,P,9,72019,Regular
4JN18CS067,18CPL27,36,39,75,P,8,72019,Regular
4JN18CS067,18EGH28,24,29,53,P,6,72019,Regular
4JN18CS068,18MAT21,35,56,91,P,10,72019,Regular
4JN18CS068,18CHE22,37,41,78,P,8,72019,Regular
4JN18CS068,18CPS23,36,26,62,P,7,72019,Regular
4JN18CS068,18ELN24,31,48,79,P,8,72019,Regular
4JN18CS068,18ME25,37,48,85,P,9,72019,Regular
4JN18CS068,18CHEL26,34,47,81,P,9,72019,Regular
4JN18CS068,18CPL27,40,58,98,P,10,72019,Regular
4JN18CS068,18EGH28,28,29,57,P,6,72019,Regular
4JN18CS072,18MAT21,38,55,93,P,10,72019,Regular
4JN18CS072,18CHE22,37,55,92,P,10,72019,Regular
4JN18CS072,18CPS23,40,47,87,P,9,72019,Regular
4JN18CS072,18ELN24,33,36,69,P,7,72019,Regular
4JN18CS072,18ME25,39,35,74,P,8,72019,Regular
4JN18CS072,18CHEL26,35,48,83,P,9,72019,Regular
4JN18CS072,18CPL27,40,60,100,P,10,72019,Regular
4JN18CS072,18EGH28,33,35,68,P,7,72019,Regular
4JN18CS089,18MAT21,34,35,69,P,7,72019,Regular
4JN18CS089,18CHE22,33,48,81,P,9,72019,Regular
4JN18CS089,18CPS23,35,39,74,P,8,72019,Regular
4JN18CS089,18ELN24,23,24,47,P,5,72019,Regular
4JN18CS089,18ME25,29,27,56,P,6,72019,Regular
4JN18CS089,18CHEL26,37,52,89,P,9,72019,Regular
4JN18CS089,18CPL27,40,57,97,P,10,72019,Regular
4JN18CS089,18EGH28,29,35,64,P,7,72019,Regular
4JN18CS023,18MAT21,31,36,67,P,7,72019,Regular
4JN18CS023,18CHE22,30,41,71,P,8,72019,Regular
4JN18CS023,18CPS23,22,30,52,P,6,72019,Regular
4JN18CS023,18ELN24,30,37,67,P,7,72019,Regular
4JN18CS023,18ME25,28,33,61,P,7,72019,Regular
4JN18CS023,18CHEL26,37,42,79,P,8,72019,Regular
4JN18CS023,18CPL27,29,43,72,P,8,72019,Regular
4JN18CS023,18EGH28,26,21,47,P,5,72019,Regular
4JN18CS024,18MAT21,33,32,65,P,7,72019,Regular
4JN18CS024,18CHE22,30,29,59,P,6,72019,Regular
4JN18CS024,18CPS23,27,33,60,P,7,72019,Regular
4JN18CS024,18ELN24,28,15,43,F,0,72019,Regular
4JN18CS024,18ME25,30,24,54,P,6,72019,Regular
4JN18CS024,18CHEL26,35,41,76,P,8,72019,Regular
4JN18CS024,18CPL27,35,50,85,P,9,72019,Regular
4JN18CS024,18EGH28,22,28,50,P,6,72019,Regular
4JN18CS024,18ELE13,20,21,41,P,4,72019,Backlog
4JN18CS025,18MAT21,36,50,86,P,9,72019,Regular
4JN18CS025,18CHE22,28,21,49,P,5,72019,Regular
4JN18CS025,18CPS23,34,23,57,P,6,72019,Regular
4JN18CS025,18ELN24,24,23,47,P,5,72019,Regular
4JN18CS025,18ME25,26,39,65,P,7,72019,Regular
4JN18CS025,18CHEL26,34,52,86,P,9,72019,Regular
4JN18CS025,18CPL27,39,54,93,P,10,72019,Regular
4JN18CS025,18EGH28,25,35,60,P,7,72019,Regular
4JN18CS027,18MAT21,20,5,25,F,0,72019,Regular
4JN18CS027,18CHE22,17,23,40,P,4,72019,Regular
4JN18CS027,18CPS23,18,19,37,F,0,72019,Regular
4JN18CS027,18ELN24,20,14,34,F,0,72019,Regular
4JN18CS027,18ME25,16,21,37,F,0,72019,Regular
4JN18CS027,18CHEL26,33,48,81,P,9,72019,Regular
4JN18CS027,18CPL27,22,26,48,P,5,72019,Regular
4JN18CS027,18EGH28,22,24,46,P,5,72019,Regular
4JN18CS027,18MAT11,27,15,42,F,0,72019,Backlog
4JN18CS027,18ELE13,20,22,42,P,4,72019,Backlog
4JN18CS027,18PHYL16,25,42,67,P,7,72019,Backlog
4JN18CS029,18MAT21,31,41,72,P,8,72019,Regular
4JN18CS029,18CHE22,30,26,56,P,6,72019,Regular
4JN18CS029,18CPS23,25,21,46,P,5,72019,Regular
4JN18CS029,18ELN24,31,33,64,P,7,72019,Regular
4JN18CS029,18ME25,27,24,51,P,6,72019,Regular
4JN18CS029,18CHEL26,37,55,92,P,10,72019,Regular
4JN18CS029,18CPL27,29,34,63,P,7,72019,Regular
4JN18CS029,18EGH28,24,27,51,P,6,72019,Regular
4JN18CS032,18MAT21,38,57,95,P,10,72019,Regular
4JN18CS032,18CHE22,39,52,91,P,10,72019,Regular
4JN18CS032,18CPS23,39,36,75,P,8,72019,Regular
4JN18CS032,18ELN24,38,44,82,P,9,72019,Regular
4JN18CS032,18ME25,35,44,79,P,8,72019,Regular
4JN18CS032,18CHEL26,37,42,79,P,8,72019,Regular
4JN18CS032,18CPL27,38,59,97,P,10,72019,Regular
4JN18CS032,18EGH28,29,39,68,P,7,72019,Regular
4JN18CS033,18MAT21,29,26,55,P,6,72019,Regular
4JN18CS033,18CHE22,24,21,45,P,5,72019,Regular
4JN18CS033,18CPS23,29,38,67,P,7,72019,Regular
4JN18CS033,18ELN24,30,21,51,P,6,72019,Regular
4JN18CS033,18ME25,24,38,62,P,7,72019,Regular
4JN18CS033,18CHEL26,36,50,86,P,9,72019,Regular
4JN18CS033,18CPL27,32,44,76,P,8,72019,Regular
4JN18CS033,18EGH28,22,26,48,P,5,72019,Regular
4JN18CS036,18MAT21,35,49,84,P,9,72019,Regular
4JN18CS036,18CHE22,36,47,83,P,9,72019,Regular
4JN18CS036,18CPS23,37,35,72,P,8,72019,Regular
4JN18CS036,18ELN24,33,35,68,P,7,72019,Regular
4JN18CS036,18ME25,31,37,68,P,7,72019,Regular
4JN18CS036,18CHEL26,39,45,84,P,9,72019,Regular
4JN18CS036,18CPL27,39,57,96,P,10,72019,Regular
4JN18CS036,18EGH28,28,41,69,P,7,72019,Regular
4JN18CS037,18MAT21,39,56,95,P,10,72019,Regular
4JN18CS037,18CHE22,40,47,87,P,9,72019,Regular
4JN18CS037,18CPS23,37,43,80,P,9,72019,Regular
4JN18CS037,18ELN24,40,33,73,P,8,72019,Regular
4JN18CS037,18ME25,32,40,72,P,8,72019,Regular
4JN18CS037,18CHEL26,37,55,92,P,10,72019,Regular
4JN18CS037,18CPL27,40,59,99,P,10,72019,Regular
4JN18CS037,18EGH28,27,36,63,P,7,72019,Regular
4JN18CS038,18MAT21,34,46,80,P,9,72019,Regular
4JN18CS038,18CHE22,31,41,72,P,8,72019,Regular
4JN18CS038,18CPS23,26,33,59,P,6,72019,Regular
4JN18CS038,18ELN24,27,15,42,F,0,72019,Regular
4JN18CS038,18ME25,31,41,72,P,8,72019,Regular
4JN18CS038,18CHEL26,39,51,90,P,10,72019,Regular
4JN18CS038,18CPL27,29,24,53,P,6,72019,Regular
4JN18CS038,18EGH28,27,34,61,P,7,72019,Regular
4JN18CS039,18MAT21,19,18,37,F,0,72019,Regular
4JN18CS039,18CHE22,16,0,16,F,0,72019,Regular
4JN18CS039,18CPS23,5,0,5,X,0,72019,Regular
4JN18CS039,18ELN24,26,2,28,F,0,72019,Regular
4JN18CS039,18ME25,20,0,20,A,0,72019,Regular
4JN18CS039,18CHEL26,33,0,33,A,0,72019,Regular
4JN18CS039,18CPL27,22,0,22,A,0,72019,Regular
4JN18CS039,18EGH28,24,21,45,P,5,72019,Regular
4JN18CS039,18MAT11,20,0,20,F,0,72019,Backlog
4JN18CS039,18PHY12,16,3,19,F,0,72019,Backlog
4JN18CS039,18ELE13,20,2,22,F,0,72019,Backlog
4JN18CS039,18CIV14,21,7,28,F,0,72019,Backlog
4JN18CS039,18EGDL15,33,6,39,F,0,72019,Backlog
4JN18CS039,18PHYL16,27,0,27,A,0,72019,Backlog
4JN18CS041,18MAT21,20,16,36,F,0,72019,Regular
4JN18CS041,18CHE22,23,22,45,P,5,72019,Regular
4JN18CS041,18CPS23,17,10,27,F,0,72019,Regular
4JN18CS041,18ELN24,23,5,28,F,0,72019,Regular
4JN18CS041,18ME25,20,21,41,P,4,72019,Regular
4JN18CS041,18CHEL26,36,45,81,P,9,72019,Regular
4JN18CS041,18CPL27,25,39,64,P,7,72019,Regular
4JN18CS041,18EGH28,22,22,44,P,4,72019,Regular
4JN18CS041,18MAT11,30,12,42,F,0,72019,Backlog
4JN18CS041,18ELE13,18,14,32,F,0,72019,Backlog
4JN18CS041,18CIV14,26,17,43,F,0,72019,Backlog
4JN18CS041,18EGDL15,32,0,32,A,0,72019,Backlog
4JN18CS042,18MAT21,38,57,95,P,10,72019,Regular
4JN18CS042,18CHE22,36,30,66,P,7,72019,Regular
4JN18CS042,18CPS23,34,33,67,P,7,72019,Regular
4JN18CS042,18ELN24,37,25,62,P,7,72019,Regular
4JN18CS042,18ME25,35,35,70,P,8,72019,Regular
4JN18CS042,18CHEL26,37,55,92,P,10,72019,Regular
4JN18CS042,18CPL27,40,57,97,P,10,72019,Regular
4JN18CS042,18EGH28,23,35,58,P,6,72019,Regular
4JN18CS043,18MAT21,28,28,56,P,6,72019,Regular
4JN18CS043,18CHE22,32,30,62,P,7,72019,Regular
4JN18CS043,18CPS23,30,25,55,P,6,72019,Regular
4JN18CS043,18ELN24,31,29,60,P,7,72019,Regular
4JN18CS043,18ME25,29,38,67,P,7,72019,Regular
4JN18CS043,18CHEL26,35,41,76,P,8,72019,Regular
4JN18CS043,18CPL27,37,56,93,P,10,72019,Regular
4JN18CS043,18EGH28,24,27,51,P,6,72019,Regular
4JN18CS045,18MAT21,26,38,64,P,7,72019,Regular
4JN18CS045,18CHE22,24,36,60,P,7,72019,Regular
4JN18CS045,18CPS23,18,18,36,F,0,72019,Regular
4JN18CS045,18ELN24,20,10,30,F,0,72019,Regular
4JN18CS045,18ME25,16,26,42,P,4,72019,Regular
4JN18CS045,18CHEL26,38,38,76,P,8,72019,Regular
4JN18CS045,18CPL27,28,53,81,P,9,72019,Regular
4JN18CS045,18EGH28,23,33,56,P,6,72019,Regular
4JN18CS047,18MAT21,21,18,39,F,0,72019,Regular
4JN18CS047,18CHE22,26,24,50,P,6,72019,Regular
4JN18CS047,18CPS23,17,24,41,P,4,72019,Regular
4JN18CS047,18ELN24,23,14,37,F,0,72019,Regular
4JN18CS047,18ME25,22,30,52,P,6,72019,Regular
4JN18CS047,18CHEL26,37,45,82,P,9,72019,Regular
4JN18CS047,18CPL27,25,24,49,P,5,72019,Regular
4JN18CS047,18EGH28,22,32,54,P,6,72019,Regular
4JN18CS047,18MAT11,19,9,28,F,0,72019,Backlog
4JN18CS047,18ELE13,16,13,29,F,0,72019,Backlog
4JN18CS047,18CIV14,23,21,44,P,4,72019,Backlog
4JN18CS047,18EGDL15,39,11,50,F,0,72019,Backlog
4JN18CS048,18MAT21,34,44,78,P,8,72019,Regular
4JN18CS048,18CHE22,35,35,70,P,8,72019,Regular
4JN18CS048,18CPS23,29,24,53,P,6,72019,Regular
4JN18CS048,18ELN24,33,21,54,P,6,72019,Regular
4JN18CS048,18ME25,30,30,60,P,7,72019,Regular
4JN18CS048,18CHEL26,37,50,87,P,9,72019,Regular
4JN18CS048,18CPL27,39,56,95,P,10,72019,Regular
4JN18CS048,18EGH28,24,40,64,P,7,72019,Regular
4JN18CS049,18MAT21,38,53,91,P,10,72019,Regular
4JN18CS049,18CHE22,32,35,67,P,7,72019,Regular
4JN18CS049,18CPS23,34,33,67,P,7,72019,Regular
4JN18CS049,18ELN24,32,29,61,P,7,72019,Regular
4JN18CS049,18ME25,25,38,63,P,7,72019,Regular
4JN18CS049,18CHEL26,38,53,91,P,10,72019,Regular
4JN18CS049,18CPL27,39,57,96,P,10,72019,Regular
4JN18CS049,18EGH28,25,34,59,P,6,72019,Regular
4JN18CS050,18MAT21,21,26,47,P,5,72019,Regular
4JN18CS050,18CHE22,25,14,39,F,0,72019,Regular
4JN18CS050,18CPS23,28,24,52,P,6,72019,Regular
4JN18CS050,18ELN24,24,15,39,F,0,72019,Regular
4JN18CS050,18ME25,25,21,46,P,5,72019,Regular
4JN18CS050,18CHEL26,36,53,89,P,9,72019,Regular
4JN18CS050,18CPL27,28,48,76,P,8,72019,Regular
4JN18CS050,18EGH28,22,25,47,P,5,72019,Regular
4JN18CS050,18ELE13,18,8,26,F,0,72019,Backlog
4JN18CS052,18MAT21,39,59,98,P,10,72019,Regular
4JN18CS052,18CHE22,40,45,85,P,9,72019,Regular
4JN18CS052,18CPS23,40,43,83,P,9,72019,Regular
4JN18CS052,18ELN24,39,42,81,P,9,72019,Regular
4JN18CS052,18ME25,35,45,80,P,9,72019,Regular
4JN18CS052,18CHEL26,36,53,89,P,9,72019,Regular
4JN18CS052,18CPL27,40,60,100,P,10,72019,Regular
4JN18CS052,18EGH28,25,41,66,P,7,72019,Regular
4JN18CS056,18MAT21,38,57,95,P,10,72019,Regular
4JN18CS056,18CHE22,38,50,88,P,9,72019,Regular
4JN18CS056,18CPS23,40,41,81,P,9,72019,Regular
4JN18CS056,18ELN24,38,44,82,P,9,72019,Regular
4JN18CS056,18ME25,36,39,75,P,8,72019,Regular
4JN18CS056,18CHEL26,39,49,88,P,9,72019,Regular
4JN18CS056,18CPL27,40,60,100,P,10,72019,Regular
4JN18CS056,18EGH28,32,44,76,P,8,72019,Regular
4JN18CS059,18MAT21,28,41,69,P,7,72019,Regular
4JN18CS059,18CHE22,35,34,69,P,7,72019,Regular
4JN18CS059,18CPS23,34,44,78,P,8,72019,Regular
4JN18CS059,18ELN24,32,30,62,P,7,72019,Regular
4JN18CS059,18ME25,30,32,62,P,7,72019,Regular
4JN18CS059,18CHEL26,36,51,87,P,9,72019,Regular
4JN18CS059,18CPL27,40,55,95,P,10,72019,Regular
4JN18CS059,18EGH28,24,29,53,P,6,72019,Regular
4JN18CS060,18MAT21,35,53,88,P,9,72019,Regular
4JN18CS060,18CHE22,37,50,87,P,9,72019,Regular
4JN18CS060,18CPS23,40,35,75,P,8,72019,Regular
4JN18CS060,18ELN24,35,35,70,P,8,72019,Regular
4JN18CS060,18ME25,32,36,68,P,7,72019,Regular
4JN18CS060,18CHEL26,35,54,89,P,9,72019,Regular
4JN18CS060,18CPL27,39,58,97,P,10,72019,Regular
4JN18CS060,18EGH28,25,39,64,P,7,72019,Regular
4JN18CS061,18MAT21,38,43,81,P,9,72019,Regular
4JN18CS061,18CHE22,36,48,84,P,9,72019,Regular
4JN18CS061,18CPS23,34,40,74,P,8,72019,Regular
4JN18CS061,18ELN24,36,35,71,P,8,72019,Regular
4JN18CS061,18ME25,32,39,71,P,8,72019,Regular
4JN18CS061,18CHEL26,36,55,91,P,10,72019,Regular
4JN18CS061,18CPL27,40,57,97,P,10,72019,Regular
4JN18CS061,18EGH28,27,39,66,P,7,72019,Regular
4JN18CS062,18MAT21,30,43,73,P,8,72019,Regular
4JN18CS062,18CHE22,28,24,52,P,6,72019,Regular
4JN18CS062,18CPS23,31,27,58,P,6,72019,Regular
4JN18CS062,18ELN24,29,21,50,P,6,72019,Regular
4JN18CS062,18ME25,29,29,58,P,6,72019,Regular
4JN18CS062,18CHEL26,36,53,89,P,9,72019,Regular
4JN18CS062,18CPL27,40,57,97,P,10,72019,Regular
4JN18CS062,18EGH28,24,32,56,P,6,72019,Regular
4JN18CS063,18MAT21,23,23,46,P,5,72019,Regular
4JN18CS063,18CHE22,30,39,69,P,7,72019,Regular
4JN18CS063,18CPS23,18,27,45,P,5,72019,Regular
4JN18CS063,18ELN24,29,21,50,P,6,72019,Regular
4JN18CS063,18ME25,23,43,66,P,7,72019,Regular
4JN18CS063,18CHEL26,34,55,89,P,9,72019,Regular
4JN18CS063,18CPL27,25,39,64,P,7,72019,Regular
4JN18CS063,18EGH28,22,24,46,P,5,72019,Regular
4JN18CS064,18MAT21,37,48,85,P,9,72019,Regular
4JN18CS064,18CHE22,36,45,81,P,9,72019,Regular
4JN18CS064,18CPS23,30,32,62,P,7,72019,Regular
4JN18CS064,18ELN24,32,35,67,P,7,72019,Regular
4JN18CS064,18ME25,30,47,77,P,8,72019,Regular
4JN18CS064,18CHEL26,38,50,88,P,9,72019,Regular
4JN18CS064,18CPL27,40,53,93,P,10,72019,Regular
4JN18CS064,18EGH28,23,31,54,P,6,72019,Regular
4JN18CS065,18MAT21,36,57,93,P,10,72019,Regular
4JN18CS065,18CHE22,30,39,69,P,7,72019,Regular
4JN18CS065,18CPS23,26,36,62,P,7,72019,Regular
4JN18CS065,18ELN24,28,23,51,P,6,72019,Regular
4JN18CS065,18ME25,24,44,68,P,7,72019,Regular
4JN18CS065,18CHEL26,38,50,88,P,9,72019,Regular
4JN18CS065,18CPL27,38,57,95,P,10,72019,Regular
4JN18CS065,18EGH28,26,36,62,P,7,72019,Regular
4JN18CS066,18MAT21,26,46,72,P,8,72019,Regular
4JN18CS066,18CHE22,33,45,78,P,8,72019,Regular
4JN18CS066,18CPS23,32,35,67,P,7,72019,Regular
4JN18CS066,18ELN24,29,33,62,P,7,72019,Regular
4JN18CS066,18ME25,32,38,70,P,8,72019,Regular
4JN18CS066,18CHEL26,40,50,90,P,10,72019,Regular
4JN18CS066,18CPL27,38,50,88,P,9,72019,Regular
4JN18CS066,18EGH28,29,45,74,P,8,72019,Regular
4JN18CS069,18MAT21,24,40,64,P,7,72019,Regular
4JN18CS069,18CHE22,23,32,55,P,6,72019,Regular
4JN18CS069,18CPS23,19,24,43,P,4,72019,Regular
4JN18CS069,18ELN24,25,22,47,P,5,72019,Regular
4JN18CS069,18ME25,20,25,45,P,5,72019,Regular
4JN18CS069,18CHEL26,38,55,93,P,10,72019,Regular
4JN18CS069,18CPL27,28,42,70,P,8,72019,Regular
4JN18CS069,18EGH28,22,37,59,P,6,72019,Regular
4JN18CS069,18PHY12,25,8,33,F,0,72019,Backlog
4JN18CS069,18ELE13,26,15,41,F,0,72019,Backlog
4JN18CS070,18MAT21,40,59,99,P,10,72019,Regular
4JN18CS070,18CHE22,35,42,77,P,8,72019,Regular
4JN18CS070,18CPS23,38,33,71,P,8,72019,Regular
4JN18CS070,18ELN24,36,21,57,P,6,72019,Regular
4JN18CS070,18ME25,32,38,70,P,8,72019,Regular
4JN18CS070,18CHEL26,38,54,92,P,10,72019,Regular
4JN18CS070,18CPL27,40,58,98,P,10,72019,Regular
4JN18CS070,18EGH28,27,36,63,P,7,72019,Regular
4JN18CS076,18MAT21,40,54,94,P,10,72019,Regular
4JN18CS076,18CHE22,38,44,82,P,9,72019,Regular
4JN18CS076,18CPS23,40,32,72,P,8,72019,Regular
4JN18CS076,18ELN24,40,37,77,P,8,72019,Regular
4JN18CS076,18ME25,37,45,82,P,9,72019,Regular
4JN18CS076,18CHEL26,38,57,95,P,10,72019,Regular
4JN18CS076,18CPL27,40,57,97,P,10,72019,Regular
4JN18CS076,18EGH28,23,32,55,P,6,72019,Regular
4JN18CS084,18MAT21,40,60,100,P,10,72019,Regular
4JN18CS084,18CHE22,40,54,94,P,10,72019,Regular
4JN18CS084,18CPS23,40,45,85,P,9,72019,Regular
4JN18CS084,18ELN24,40,50,90,P,10,72019,Regular
4JN18CS084,18ME25,35,53,88,P,9,72019,Regular
4JN18CS084,18CHEL26,39,44,83,P,9,72019,Regular
4JN18CS084,18CPL27,40,59,99,P,10,72019,Regular
4JN18CS084,18EGH28,26,42,68,P,7,72019,Regular
4JN18CS088,18MAT21,33,56,89,P,9,72019,Regular
4JN18CS088,18CHE22,31,39,70,P,8,72019,Regular
4JN18CS088,18CPS23,25,33,58,P,6,72019,Regular
4JN18CS088,18ELN24,26,29,55,P,6,72019,Regular
4JN18CS088,18ME25,23,35,58,P,6,72019,Regular
4JN18CS088,18CHEL26,37,39,76,P,8,72019,Regular
4JN18CS088,18CPL27,28,57,85,P,9,72019,Regular
4JN18CS088,18EGH28,26,41,67,P,7,72019,Regular
4JN18CS094,18MAT21,32,42,74,P,8,72019,Regular
4JN18CS094,18CHE22,32,44,76,P,8,72019,Regular
4JN18CS094,18CPS23,39,40,79,P,8,72019,Regular
4JN18CS094,18ELN24,29,27,56,P,6,72019,Regular
4JN18CS094,18ME25,28,41,69,P,7,72019,Regular
4JN18CS094,18CHEL26,38,48,86,P,9,72019,Regular
4JN18CS094,18CPL27,40,59,99,P,10,72019,Regular
4JN18CS094,18EGH28,26,36,62,P,7,72019,Regular
4JN18CS098,18MAT21,39,59,98,P,10,72019,Regular
4JN18CS098,18CHE22,38,50,88,P,9,72019,Regular
4JN18CS098,18CPS23,38,33,71,P,8,72019,Regular
4JN18CS098,18ELN24,34,38,72,P,8,72019,Regular
4JN18CS098,18ME25,29,31,60,P,7,72019,Regular
4JN18CS098,18CHEL26,40,52,92,P,10,72019,Regular
4JN18CS098,18CPL27,37,60,97,P,10,72019,Regular
4JN18CS098,18EGH28,27,32,59,P,6,72019,Regular
4JN18CS128,18MAT21,40,57,97,P,10,72019,Regular
4JN18CS128,18CHE22,37,47,84,P,9,72019,Regular
4JN18CS128,18CPS23,40,41,81,P,9,72019,Regular
4JN18CS128,18ELN24,39,39,78,P,8,72019,Regular
4JN18CS128,18ME25,36,23,59,P,6,72019,Regular
4JN18CS128,18CHEL26,40,50,90,P,10,72019,Regular
4JN18CS128,18CPL27,40,59,99,P,10,72019,Regular
4JN18CS128,18EGH28,29,44,73,P,8,72019,Regular
4JN18CS051,18MAT21,27,23,50,P,6,72019,Regular
4JN18CS051,18CHE22,32,38,70,P,8,72019,Regular
4JN18CS051,18CPS23,24,21,45,P,5,72019,Regular
4JN18CS051,18ELN24,23,24,47,P,5,72019,Regular
4JN18CS051,18ME25,35,35,70,P,8,72019,Regular
4JN18CS051,18CHEL26,35,53,88,P,9,72019,Regular
4JN18CS051,18CPL27,38,35,73,P,8,72019,Regular
4JN18CS051,18EGH28,28,30,58,P,6,72019,Regular
4JN18CS053,18MAT21,37,47,84,P,9,72019,Regular
4JN18CS053,18CHE22,32,45,77,P,8,72019,Regular
4JN18CS053,18CPS23,34,27,61,P,7,72019,Regular
4JN18CS053,18ELN24,24,26,50,P,6,72019,Regular
4JN18CS053,18ME25,40,41,81,P,9,72019,Regular
4JN18CS053,18CHEL26,37,46,83,P,9,72019,Regular
4JN18CS053,18CPL27,39,56,95,P,10,72019,Regular
4JN18CS053,18EGH28,32,37,69,P,7,72019,Regular
4JN18CS054,18MAT21,38,55,93,P,10,72019,Regular
4JN18CS054,18CHE22,38,53,91,P,10,72019,Regular
4JN18CS054,18CPS23,37,35,72,P,8,72019,Regular
4JN18CS054,18ELN24,26,21,47,P,5,72019,Regular
4JN18CS054,18ME25,35,38,73,P,8,72019,Regular
4JN18CS054,18CHEL26,39,55,94,P,10,72019,Regular
4JN18CS054,18CPL27,40,57,97,P,10,72019,Regular
4JN18CS054,18EGH28,32,30,62,P,7,72019,Regular
4JN18CS055,18MAT21,36,42,78,P,8,72019,Regular
4JN18CS055,18CHE22,30,24,54,P,6,72019,Regular
4JN18CS055,18CPS23,21,21,42,P,4,72019,Regular
4JN18CS055,18ELN24,19,22,41,P,4,72019,Regular
4JN18CS055,18ME25,28,32,60,P,7,72019,Regular
4JN18CS055,18CHEL26,35,51,86,P,9,72019,Regular
4JN18CS055,18CPL27,37,30,67,P,7,72019,Regular
4JN18CS055,18EGH28,28,22,50,P,6,72019,Regular
4JN18CS057,18MAT21,38,51,89,P,9,72019,Regular
4JN18CS057,18CHE22,32,30,62,P,7,72019,Regular
4JN18CS057,18CPS23,31,23,54,P,6,72019,Regular
4JN18CS057,18ELN24,24,15,39,F,0,72019,Regular
4JN18CS057,18ME25,34,45,79,P,8,72019,Regular
4JN18CS057,18CHEL26,40,55,95,P,10,72019,Regular
4JN18CS057,18CPL27,40,48,88,P,9,72019,Regular
4JN18CS057,18EGH28,28,38,66,P,7,72019,Regular
4JN18CS058,18MAT21,38,52,90,P,10,72019,Regular
4JN18CS058,18CHE22,38,45,83,P,9,72019,Regular
4JN18CS058,18CPS23,36,32,68,P,7,72019,Regular
4JN18CS058,18ELN24,29,21,50,P,6,72019,Regular
4JN18CS058,18ME25,38,38,76,P,8,72019,Regular
4JN18CS058,18CHEL26,40,38,78,P,8,72019,Regular
4JN18CS058,18CPL27,40,51,91,P,10,72019,Regular
4JN18CS058,18EGH28,28,33,61,P,7,72019,Regular
4JN18CS071,18MAT21,36,41,77,P,8,72019,Regular
4JN18CS071,18CHE22,36,39,75,P,8,72019,Regular
4JN18CS071,18CPS23,32,26,58,P,6,72019,Regular
4JN18CS071,18ELN24,31,26,57,P,6,72019,Regular
4JN18CS071,18ME25,39,40,79,P,8,72019,Regular
4JN18CS071,18CHEL26,37,43,80,P,9,72019,Regular
4JN18CS071,18CPL27,40,59,99,P,10,72019,Regular
4JN18CS071,18EGH28,28,33,61,P,7,72019,Regular
4JN18CS073,18MAT21,40,56,96,P,10,72019,Regular
4JN18CS073,18CHE22,40,42,82,P,9,72019,Regular
4JN18CS073,18CPS23,39,35,74,P,8,72019,Regular
4JN18CS073,18ELN24,33,33,66,P,7,72019,Regular
4JN18CS073,18ME25,39,33,72,P,8,72019,Regular
4JN18CS073,18CHEL26,40,55,95,P,10,72019,Regular
4JN18CS073,18CPL27,39,59,98,P,10,72019,Regular
4JN18CS073,18EGH28,28,35,63,P,7,72019,Regular
4JN18CS074,18MAT21,38,45,83,P,9,72019,Regular
4JN18CS074,18CHE22,38,37,75,P,8,72019,Regular
4JN18CS074,18CPS23,36,26,62,P,7,72019,Regular
4JN18CS074,18ELN24,34,29,63,P,7,72019,Regular
4JN18CS074,18ME25,37,39,76,P,8,72019,Regular
4JN18CS074,18CHEL26,37,55,92,P,10,72019,Regular
4JN18CS074,18CPL27,40,59,99,P,10,72019,Regular
4JN18CS074,18EGH28,29,35,64,P,7,72019,Regular
4JN18CS075,18MAT21,36,51,87,P,9,72019,Regular
4JN18CS075,18CHE22,32,35,67,P,7,72019,Regular
4JN18CS075,18CPS23,27,29,56,P,6,72019,Regular
4JN18CS075,18ELN24,22,22,44,P,4,72019,Regular
4JN18CS075,18ME25,28,24,52,P,6,72019,Regular
4JN18CS075,18CHEL26,38,52,90,P,10,72019,Regular
4JN18CS075,18CPL27,38,50,88,P,9,72019,Regular
4JN18CS075,18EGH28,25,21,46,P,5,72019,Regular
4JN18CS077,18MAT21,33,45,78,P,8,72019,Regular
4JN18CS077,18CHE22,30,31,61,P,7,72019,Regular
4JN18CS077,18CPS23,29,26,55,P,6,72019,Regular
4JN18CS077,18ELN24,22,15,37,F,0,72019,Regular
4JN18CS077,18ME25,29,31,60,P,7,72019,Regular
4JN18CS077,18CHEL26,38,52,90,P,10,72019,Regular
4JN18CS077,18CPL27,38,54,92,P,10,72019,Regular
4JN18CS077,18EGH28,25,33,58,P,6,72019,Regular
4JN18CS080,18MAT21,35,44,79,P,8,72019,Regular
4JN18CS080,18CHE22,31,42,73,P,8,72019,Regular
4JN18CS080,18CPS23,31,39,70,P,8,72019,Regular
4JN18CS080,18ELN24,23,24,47,P,5,72019,Regular
4JN18CS080,18ME25,34,40,74,P,8,72019,Regular
4JN18CS080,18CHEL26,38,47,85,P,9,72019,Regular
4JN18CS080,18CPL27,40,58,98,P,10,72019,Regular
4JN18CS080,18EGH28,30,35,65,P,7,72019,Regular
4JN18CS081,18MAT21,34,45,79,P,8,72019,Regular
4JN18CS081,18CHE22,34,40,74,P,8,72019,Regular
4JN18CS081,18CPS23,32,34,66,P,7,72019,Regular
4JN18CS081,18ELN24,26,21,47,P,5,72019,Regular
4JN18CS081,18ME25,36,38,74,P,8,72019,Regular
4JN18CS081,18CHEL26,39,48,87,P,9,72019,Regular
4JN18CS081,18CPL27,40,59,99,P,10,72019,Regular
4JN18CS081,18EGH28,32,38,70,P,8,72019,Regular
4JN18CS082,18MAT21,22,29,51,P,6,72019,Regular
4JN18CS082,18CHE22,22,17,39,F,0,72019,Regular
4JN18CS082,18CPS23,21,21,42,P,4,72019,Regular
4JN18CS082,18ELN24,19,14,33,F,0,72019,Regular
4JN18CS082,18ME25,20,26,46,P,5,72019,Regular
4JN18CS082,18CHEL26,37,39,76,P,8,72019,Regular
4JN18CS082,18CPL27,38,52,90,P,10,72019,Regular
4JN18CS082,18EGH28,25,27,52,P,6,72019,Regular
4JN18CS082,18PHY12,16,24,40,P,4,72019,Backlog
4JN18CS082,18ELE13,23,22,45,P,5,72019,Backlog
4JN18CS082,18CIV14,24,21,45,P,5,72019,Backlog
4JN18CS083,18MAT21,40,50,90,P,10,72019,Regular
4JN18CS083,18CHE22,39,47,86,P,9,72019,Regular
4JN18CS083,18CPS23,40,47,87,P,9,72019,Regular
4JN18CS083,18ELN24,37,43,80,P,9,72019,Regular
4JN18CS083,18ME25,40,50,90,P,10,72019,Regular
4JN18CS083,18CHEL26,39,57,96,P,10,72019,Regular
4JN18CS083,18CPL27,40,59,99,P,10,72019,Regular
4JN18CS083,18EGH28,30,35,65,P,7,72019,Regular
4JN18CS085,18MAT21,31,44,75,P,8,72019,Regular
4JN18CS085,18CHE22,32,41,73,P,8,72019,Regular
4JN18CS085,18CPS23,25,28,53,P,6,72019,Regular
4JN18CS085,18ELN24,21,29,50,P,6,72019,Regular
4JN18CS085,18ME25,32,30,62,P,7,72019,Regular
4JN18CS085,18CHEL26,38,39,77,P,8,72019,Regular
4JN18CS085,18CPL27,38,58,96,P,10,72019,Regular
4JN18CS085,18EGH28,28,31,59,P,6,72019,Regular
4JN18CS086,18MAT21,38,58,96,P,10,72019,Regular
4JN18CS086,18CHE22,32,46,78,P,8,72019,Regular
4JN18CS086,18CPS23,33,41,74,P,8,72019,Regular
4JN18CS086,18ELN24,28,30,58,P,6,72019,Regular
4JN18CS086,18ME25,32,36,68,P,7,72019,Regular
4JN18CS086,18CHEL26,40,35,75,P,8,72019,Regular
4JN18CS086,18CPL27,40,58,98,P,10,72019,Regular
4JN18CS086,18EGH28,32,37,69,P,7,72019,Regular
4JN18CS087,18MAT21,26,21,47,P,5,72019,Regular
4JN18CS087,18CHE22,30,29,59,P,6,72019,Regular
4JN18CS087,18CPS23,26,23,49,P,5,72019,Regular
4JN18CS087,18ELN24,19,17,36,F,0,72019,Regular
4JN18CS087,18ME25,31,31,62,P,7,72019,Regular
4JN18CS087,18CHEL26,38,52,90,P,10,72019,Regular
4JN18CS087,18CPL27,40,57,97,P,10,72019,Regular
4JN18CS087,18EGH28,32,18,50,F,0,72019,Regular
4JN18CS087,18PHY12,16,13,29,F,0,72019,Backlog
4JN18CS090,18MAT21,24,18,42,F,0,72019,Regular
4JN18CS090,18CHE22,25,32,57,P,6,72019,Regular
4JN18CS090,18CPS23,24,17,41,F,0,72019,Regular
4JN18CS090,18ELN24,19,3,22,F,0,72019,Regular
4JN18CS090,18ME25,22,22,44,P,4,72019,Regular
4JN18CS090,18CHEL26,37,41,78,P,8,72019,Regular
4JN18CS090,18CPL27,39,57,96,P,10,72019,Regular
4JN18CS090,18EGH28,32,30,62,P,7,72019,Regular
4JN18CS090,18PHY12,16,17,33,F,0,72019,Backlog
4JN18CS090,18ELE13,19,14,33,F,0,72019,Backlog
4JN18CS090,18CIV14,25,15,40,F,0,72019,Backlog
4JN18CS092,18MAT21,40,58,98,P,10,72019,Regular
4JN18CS092,18CHE22,40,53,93,P,10,72019,Regular
4JN18CS092,18CPS23,40,48,88,P,9,72019,Regular
4JN18CS092,18ELN24,39,50,89,P,9,72019,Regular
4JN18CS092,18ME25,40,52,92,P,10,72019,Regular
4JN18CS092,18CHEL26,40,56,96,P,10,72019,Regular
4JN18CS092,18CPL27,40,60,100,P,10,72019,Regular
4JN18CS092,18EGH28,38,46,84,P,9,72019,Regular
4JN18CS093,18MAT21,28,33,61,P,7,72019,Regular
4JN18CS093,18CHE22,29,29,58,P,6,72019,Regular
4JN18CS093,18CPS23,30,26,56,P,6,72019,Regular
4JN18CS093,18ELN24,22,21,43,P,4,72019,Regular
4JN18CS093,18ME25,30,36,66,P,7,72019,Regular
4JN18CS093,18CHEL26,37,51,88,P,9,72019,Regular
4JN18CS093,18CPL27,39,55,94,P,10,72019,Regular
4JN18CS093,18EGH28,29,35,64,P,7,72019,Regular
4JN18CS095,18MAT21,36,53,89,P,9,72019,Regular
4JN18CS095,18CHE22,37,49,86,P,9,72019,Regular
4JN18CS095,18CPS23,36,30,66,P,7,72019,Regular
4JN18CS095,18ELN24,29,42,71,P,8,72019,Regular
4JN18CS095,18ME25,33,38,71,P,8,72019,Regular
4JN18CS095,18CHEL26,36,50,86,P,9,72019,Regular
4JN18CS095,18CPL27,40,58,98,P,10,72019,Regular
4JN18CS095,18EGH28,29,30,59,P,6,72019,Regular
4JN18CS099,18MAT21,31,38,69,P,7,72019,Regular
4JN18CS099,18CHE22,34,45,79,P,8,72019,Regular
4JN18CS099,18CPS23,33,42,75,P,8,72019,Regular
4JN18CS099,18ELN24,24,33,57,P,6,72019,Regular
4JN18CS099,18ME25,34,35,69,P,7,72019,Regular
4JN18CS099,18CHEL26,37,43,80,P,9,72019,Regular
4JN18CS099,18CPL27,40,59,99,P,10,72019,Regular
4JN18CS099,18EGH28,29,32,61,P,7,72019,Regular
4JN18CS100,18MAT21,38,53,91,P,10,72019,Regular
4JN18CS100,18CHE22,36,43,79,P,8,72019,Regular
4JN18CS100,18CPS23,34,39,73,P,8,72019,Regular
4JN18CS100,18ELN24,27,26,53,P,6,72019,Regular
4JN18CS100,18ME25,34,30,64,P,7,72019,Regular
4JN18CS100,18CHEL26,37,43,80,P,9,72019,Regular
4JN18CS100,18CPL27,40,58,98,P,10,72019,Regular
4JN18CS100,18EGH28,24,29,53,P,6,72019,Regular
4JN18CS103,18MAT21,35,35,70,P,8,72019,Regular
4JN18CS103,18CHE22,40,47,87,P,9,72019,Regular
4JN18CS103,18CPS23,39,29,68,P,7,72019,Regular
4JN18CS103,18ELN24,29,30,59,P,6,72019,Regular
4JN18CS103,18ME25,39,47,86,P,9,72019,Regular
4JN18CS103,18CHEL26,38,45,83,P,9,72019,Regular
4JN18CS103,18CPL27,40,59,99,P,10,72019,Regular
4JN18CS103,18EGH28,25,33,58,P,6,72019,Regular
4JN18CS104,18MAT21,40,56,96,P,10,72019,Regular
4JN18CS104,18CHE22,35,40,75,P,8,72019,Regular
4JN18CS104,18CPS23,38,41,79,P,8,72019,Regular
4JN18CS104,18ELN24,30,27,57,P,6,72019,Regular
4JN18CS104,18ME25,37,42,79,P,8,72019,Regular
4JN18CS104,18CHEL26,37,54,91,P,10,72019,Regular
4JN18CS104,18CPL27,40,57,97,P,10,72019,Regular
4JN18CS104,18EGH28,30,36,66,P,7,72019,Regular
4JN18CS001,18MAT21,29,38,67,P,7,72019,Regular
4JN18CS001,18CHE22,27,39,66,P,7,72019,Regular
4JN18CS001,18CPS23,25,38,63,P,7,72019,Regular
4JN18CS001,18ELN24,28,24,52,P,6,72019,Regular
4JN18CS001,18ME25,24,21,45,P,5,72019,Regular
4JN18CS001,18CHEL26,36,39,75,P,8,72019,Regular
4JN18CS001,18CPL27,36,54,90,P,10,72019,Regular
4JN18CS001,18EGH28,22,21,43,P,4,72019,Regular
4JN18CS013,18MAT21,32,40,72,P,8,72019,Regular
4JN18CS013,18CHE22,31,27,58,P,6,72019,Regular
4JN18CS013,18CPS23,28,29,57,P,6,72019,Regular
4JN18CS013,18ELN24,28,27,55,P,6,72019,Regular
4JN18CS013,18ME25,30,39,69,P,7,72019,Regular
4JN18CS013,18CHEL26,36,41,77,P,8,72019,Regular
4JN18CS013,18CPL27,36,56,92,P,10,72019,Regular
4JN18CS013,18EGH28,27,36,63,P,7,72019,Regular
4JN18CS079,18MAT21,37,46,83,P,9,72019,Regular
4JN18CS079,18CHE22,35,36,71,P,8,72019,Regular
4JN18CS079,18CPS23,35,24,59,P,6,72019,Regular
4JN18CS079,18ELN24,29,21,50,P,6,72019,Regular
4JN18CS079,18ME25,33,44,77,P,8,72019,Regular
4JN18CS079,18CHEL26,39,43,82,P,9,72019,Regular
4JN18CS079,18CPL27,40,58,98,P,10,72019,Regular
4JN18CS079,18EGH28,25,30,55,P,6,72019,Regular
4JN18CS091,18MAT21,34,53,87,P,9,72019,Regular
4JN18CS091,18CHE22,32,40,72,P,8,72019,Regular
4JN18CS091,18CPS23,35,27,62,P,7,72019,Regular
4JN18CS091,18ELN24,30,29,59,P,6,72019,Regular
4JN18CS091,18ME25,34,33,67,P,7,72019,Regular
4JN18CS091,18CHEL26,39,50,89,P,9,72019,Regular
4JN18CS091,18CPL27,40,59,99,P,10,72019,Regular
4JN18CS091,18EGH28,25,34,59,P,6,72019,Regular
4JN18CS096,18MAT21,36,48,84,P,9,72019,Regular
4JN18CS096,18CHE22,36,36,72,P,8,72019,Regular
4JN18CS096,18CPS23,38,33,71,P,8,72019,Regular
4JN18CS096,18ELN24,34,24,58,P,6,72019,Regular
4JN18CS096,18ME25,32,40,72,P,8,72019,Regular
4JN18CS096,18CHEL26,40,53,93,P,10,72019,Regular
4JN18CS096,18CPL27,40,60,100,P,10,72019,Regular
4JN18CS096,18EGH28,28,39,67,P,7,72019,Regular
4JN18CS097,18MAT21,26,38,64,P,7,72019,Regular
4JN18CS097,18CHE22,33,30,63,P,7,72019,Regular
4JN18CS097,18CPS23,36,35,71,P,8,72019,Regular
4JN18CS097,18ELN24,27,34,61,P,7,72019,Regular
4JN18CS097,18ME25,31,41,72,P,8,72019,Regular
4JN18CS097,18CHEL26,40,52,92,P,10,72019,Regular
4JN18CS097,18CPL27,40,57,97,P,10,72019,Regular
4JN18CS097,18EGH28,25,35,60,P,7,72019,Regular
4JN18CS101,18MAT21,38,58,96,P,10,72019,Regular
4JN18CS101,18CHE22,30,34,64,P,7,72019,Regular
4JN18CS101,18CPS23,40,24,64,P,7,72019,Regular
4JN18CS101,18ELN24,27,33,60,P,7,72019,Regular
4JN18CS101,18ME25,27,30,57,P,6,72019,Regular
4JN18CS101,18CHEL26,37,35,72,P,8,72019,Regular
4JN18CS101,18CPL27,40,60,100,P,10,72019,Regular
4JN18CS101,18EGH28,22,29,51,P,6,72019,Regular
4JN18CS102,18MAT21,35,50,85,P,9,72019,Regular
4JN18CS102,18CHE22,36,45,81,P,9,72019,Regular
4JN18CS102,18CPS23,32,32,64,P,7,72019,Regular
4JN18CS102,18ELN24,28,28,56,P,6,72019,Regular
4JN18CS102,18ME25,32,42,74,P,8,72019,Regular
4JN18CS102,18CHEL26,36,51,87,P,9,72019,Regular
4JN18CS102,18CPL27,40,57,97,P,10,72019,Regular
4JN18CS102,18EGH28,26,38,64,P,7,72019,Regular
4JN18CS105,18MAT21,25,36,61,P,7,72019,Regular
4JN18CS105,18CHE22,28,31,59,P,6,72019,Regular
4JN18CS105,18CPS23,26,23,49,P,5,72019,Regular
4JN18CS105,18ELN24,24,21,45,P,5,72019,Regular
4JN18CS105,18ME25,28,27,55,P,6,72019,Regular
4JN18CS105,18CHEL26,38,51,89,P,9,72019,Regular
4JN18CS105,18CPL27,40,56,96,P,10,72019,Regular
4JN18CS105,18EGH28,23,27,50,P,6,72019,Regular
4JN18CS106,18MAT21,36,56,92,P,10,72019,Regular
4JN18CS106,18CHE22,36,38,74,P,8,72019,Regular
4JN18CS106,18CPS23,34,24,58,P,6,72019,Regular
4JN18CS106,18ELN24,34,38,72,P,8,72019,Regular
4JN18CS106,18ME25,29,33,62,P,7,72019,Regular
4JN18CS106,18CHEL26,37,50,87,P,9,72019,Regular
4JN18CS106,18CPL27,40,58,98,P,10,72019,Regular
4JN18CS106,18EGH28,25,27,52,P,6,72019,Regular
4JN18CS107,18MAT21,31,47,78,P,8,72019,Regular
4JN18CS107,18CHE22,35,33,68,P,7,72019,Regular
4JN18CS107,18CPS23,36,22,58,P,6,72019,Regular
4JN18CS107,18ELN24,29,27,56,P,6,72019,Regular
4JN18CS107,18ME25,34,32,66,P,7,72019,Regular
4JN18CS107,18CHEL26,38,47,85,P,9,72019,Regular
4JN18CS107,18CPL27,40,59,99,P,10,72019,Regular
4JN18CS107,18EGH28,22,28,50,P,6,72019,Regular
4JN18CS109,18MAT21,40,60,100,P,10,72019,Regular
4JN18CS109,18CHE22,36,45,81,P,9,72019,Regular
4JN18CS109,18CPS23,39,30,69,P,7,72019,Regular
4JN18CS109,18ELN24,38,47,85,P,9,72019,Regular
4JN18CS109,18ME25,31,35,66,P,7,72019,Regular
4JN18CS109,18CHEL26,38,54,92,P,10,72019,Regular
4JN18CS109,18CPL27,40,59,99,P,10,72019,Regular
4JN18CS109,18EGH28,22,35,57,P,6,72019,Regular
4JN18CS110,18MAT21,32,37,69,P,7,72019,Regular
4JN18CS110,18CHE22,30,38,68,P,7,72019,Regular
4JN18CS110,18CPS23,31,25,56,P,6,72019,Regular
4JN18CS110,18ELN24,24,23,47,P,5,72019,Regular
4JN18CS110,18ME25,30,23,53,P,6,72019,Regular
4JN18CS110,18CHEL26,37,47,84,P,9,72019,Regular
4JN18CS110,18CPL27,40,58,98,P,10,72019,Regular
4JN18CS110,18EGH28,25,35,60,P,7,72019,Regular
4JN18CS111,18MAT21,38,54,92,P,10,72019,Regular
4JN18CS111,18CHE22,37,47,84,P,9,72019,Regular
4JN18CS111,18CPS23,35,36,71,P,8,72019,Regular
4JN18CS111,18ELN24,30,36,66,P,7,72019,Regular
4JN18CS111,18ME25,32,36,68,P,7,72019,Regular
4JN18CS111,18CHEL26,37,42,79,P,8,72019,Regular
4JN18CS111,18CPL27,40,59,99,P,10,72019,Regular
4JN18CS111,18EGH28,28,35,63,P,7,72019,Regular
4JN18CS112,18MAT21,32,52,84,P,9,72019,Regular
4JN18CS112,18CHE22,36,48,84,P,9,72019,Regular
4JN18CS112,18CPS23,34,22,56,P,6,72019,Regular
4JN18CS112,18ELN24,34,30,64,P,7,72019,Regular
4JN18CS112,18ME25,34,32,66,P,7,72019,Regular
4JN18CS112,18CHEL26,37,53,90,P,10,72019,Regular
4JN18CS112,18CPL27,40,60,100,P,10,72019,Regular
4JN18CS112,18EGH28,24,30,54,P,6,72019,Regular
4JN18CS113,18MAT21,22,6,28,F,0,72019,Regular
4JN18CS113,18CHE22,26,12,38,F,0,72019,Regular
4JN18CS113,18CPS23,25,31,56,P,6,72019,Regular
4JN18CS113,18ELN24,30,5,35,F,0,72019,Regular
4JN18CS113,18ME25,28,11,39,F,0,72019,Regular
4JN18CS113,18CHEL26,38,0,38,A,0,72019,Regular
4JN18CS113,18CPL27,38,0,38,A,0,72019,Regular
4JN18CS113,18EGH28,22,26,48,P,5,72019,Regular
4JN18CS114,18MAT21,19,16,35,F,0,72019,Regular
4JN18CS114,18CHE22,22,24,46,P,5,72019,Regular
4JN18CS114,18CPS23,20,17,37,F,0,72019,Regular
4JN18CS114,18ELN24,16,11,27,F,0,72019,Regular
4JN18CS114,18ME25,23,23,46,P,5,72019,Regular
4JN18CS114,18CHEL26,37,51,88,P,9,72019,Regular
4JN18CS114,18CPL27,39,42,81,P,9,72019,Regular
4JN18CS114,18EGH28,23,30,53,P,6,72019,Regular
4JN18CS115,18MAT21,40,58,98,P,10,72019,Regular
4JN18CS115,18CHE22,40,48,88,P,9,72019,Regular
4JN18CS115,18CPS23,40,42,82,P,9,72019,Regular
4JN18CS115,18ELN24,38,34,72,P,8,72019,Regular
4JN18CS115,18ME25,39,44,83,P,9,72019,Regular
4JN18CS115,18CHEL26,39,46,85,P,9,72019,Regular
4JN18CS115,18CPL27,40,60,100,P,10,72019,Regular
4JN18CS115,18EGH28,30,38,68,P,7,72019,Regular
4JN18CS116,18MAT21,40,59,99,P,10,72019,Regular
4JN18CS116,18CHE22,39,52,91,P,10,72019,Regular
4JN18CS116,18CPS23,38,44,82,P,9,72019,Regular
4JN18CS116,18ELN24,38,40,78,P,8,72019,Regular
4JN18CS116,18ME25,33,52,85,P,9,72019,Regular
4JN18CS116,18CHEL26,40,57,97,P,10,72019,Regular
4JN18CS116,18CPL27,40,58,98,P,10,72019,Regular
4JN18CS116,18EGH28,27,38,65,P,7,72019,Regular
4JN18CS117,18MAT21,35,40,75,P,8,72019,Regular
4JN18CS117,18CHE22,33,43,76,P,8,72019,Regular
4JN18CS117,18CPS23,28,21,49,P,5,72019,Regular
4JN18CS117,18ELN24,25,24,49,P,5,72019,Regular
4JN18CS117,18ME25,27,28,55,P,6,72019,Regular
4JN18CS117,18CHEL26,38,35,73,P,8,72019,Regular
4JN18CS117,18CPL27,38,54,92,P,10,72019,Regular
4JN18CS117,18EGH28,27,34,61,P,7,72019,Regular
4JN18CS118,18MAT21,40,60,100,P,10,72019,Regular
4JN18CS118,18CHE22,40,39,79,P,8,72019,Regular
4JN18CS118,18CPS23,39,45,84,P,9,72019,Regular
4JN18CS118,18ELN24,38,38,76,P,8,72019,Regular
4JN18CS118,18ME25,32,38,70,P,8,72019,Regular
4JN18CS118,18CHEL26,40,52,92,P,10,72019,Regular
4JN18CS118,18CPL27,40,60,100,P,10,72019,Regular
4JN18CS118,18EGH28,23,32,55,P,6,72019,Regular
4JN18CS119,18MAT21,26,31,57,P,6,72019,Regular
4JN18CS119,18CHE22,31,30,61,P,7,72019,Regular
4JN18CS119,18CPS23,32,27,59,P,6,72019,Regular
4JN18CS119,18ELN24,27,21,48,P,5,72019,Regular
4JN18CS119,18ME25,32,33,65,P,7,72019,Regular
4JN18CS119,18CHEL26,37,33,70,P,8,72019,Regular
4JN18CS119,18CPL27,40,59,99,P,10,72019,Regular
4JN18CS119,18EGH28,26,33,59,P,6,72019,Regular
4JN18CS119,18MAT11,27,23,50,P,6,72019,Backlog
4JN18CS119,18ELE13,25,21,46,P,5,72019,Backlog
4JN18CS120,18MAT21,35,56,91,P,10,72019,Regular
4JN18CS120,18CHE22,35,39,74,P,8,72019,Regular
4JN18CS120,18CPS23,38,24,62,P,7,72019,Regular
4JN18CS120,18ELN24,36,34,70,P,8,72019,Regular
4JN18CS120,18ME25,33,50,83,P,9,72019,Regular
4JN18CS120,18CHEL26,37,54,91,P,10,72019,Regular
4JN18CS120,18CPL27,40,58,98,P,10,72019,Regular
4JN18CS120,18EGH28,25,32,57,P,6,72019,Regular
4JN18CS121,18MAT21,40,60,100,P,10,72019,Regular
4JN18CS121,18CHE22,40,48,88,P,9,72019,Regular
4JN18CS121,18CPS23,40,41,81,P,9,72019,Regular
4JN18CS121,18ELN24,40,49,89,P,9,72019,Regular
4JN18CS121,18ME25,39,51,90,P,10,72019,Regular
4JN18CS121,18CHEL26,38,52,90,P,10,72019,Regular
4JN18CS121,18CPL27,40,60,100,P,10,72019,Regular
4JN18CS121,18EGH28,30,42,72,P,8,72019,Regular
4JN18CS122,18MAT21,40,59,99,P,10,72019,Regular
4JN18CS122,18CHE22,40,50,90,P,10,72019,Regular
4JN18CS122,18CPS23,28,34,62,P,7,72019,Regular
4JN18CS122,18ELN24,36,47,83,P,9,72019,Regular
4JN18CS122,18ME25,34,48,82,P,9,72019,Regular
4JN18CS122,18CHEL26,37,48,85,P,9,72019,Regular
4JN18CS122,18CPL27,40,57,97,P,10,72019,Regular
4JN18CS122,18EGH28,25,32,57,P,6,72019,Regular
4JN18CS123,18MAT21,36,52,88,P,9,72019,Regular
4JN18CS123,18CHE22,40,48,88,P,9,72019,Regular
4JN18CS123,18CPS23,40,40,80,P,9,72019,Regular
4JN18CS123,18ELN24,32,42,74,P,8,72019,Regular
4JN18CS123,18ME25,32,32,64,P,7,72019,Regular
4JN18CS123,18CHEL26,36,40,76,P,8,72019,Regular
4JN18CS123,18CPL27,40,49,89,P,9,72019,Regular
4JN18CS123,18EGH28,22,23,45,P,5,72019,Regular
4JN18CS124,18MAT21,23,24,47,P,5,72019,Regular
4JN18CS124,18CHE22,22,18,40,F,0,72019,Regular
4JN18CS124,18CPS23,23,11,34,F,0,72019,Regular
4JN18CS124,18ELN24,16,15,31,F,0,72019,Regular
4JN18CS124,18ME25,24,23,47,P,5,72019,Regular
4JN18CS124,18CHEL26,35,26,61,P,7,72019,Regular
4JN18CS124,18CPL27,38,3,41,F,0,72019,Regular
4JN18CS124,18EGH28,31,42,73,P,8,72019,Regular
4JN18CS125,18MAT21,29,29,58,P,6,72019,Regular
4JN18CS125,18CHE22,31,38,69,P,7,72019,Regular
4JN18CS125,18CPS23,39,36,75,P,8,72019,Regular
4JN18CS125,18ELN24,20,31,51,P,6,72019,Regular
4JN18CS125,18ME25,26,23,49,P,5,72019,Regular
4JN18CS125,18CHEL26,34,41,75,P,8,72019,Regular
4JN18CS125,18CPL27,40,54,94,P,10,72019,Regular
4JN18CS125,18EGH28,28,41,69,P,7,72019,Regular
4JN18CS125,18MAT11,24,27,51,P,6,72019,Backlog
4JN18CS125,18ELE13,19,21,40,P,4,72019,Backlog
4JN18CS126,18MAT21,22,35,57,P,6,72019,Regular
4JN18CS126,18CHE22,25,40,65,P,7,72019,Regular
4JN18CS126,18CPS23,22,21,43,P,4,72019,Regular
4JN18CS126,18ELN24,16,24,40,P,4,72019,Regular
4JN18CS126,18ME25,25,21,46,P,5,72019,Regular
4JN18CS126,18CHEL26,30,39,69,P,7,72019,Regular
4JN18CS126,18CPL27,37,39,76,P,8,72019,Regular
4JN18CS126,18EGH28,26,30,56,P,6,72019,Regular
4JN18CS127,18MAT21,28,32,60,P,7,72019,Regular
4JN18CS127,18CHE22,34,44,78,P,8,72019,Regular
4JN18CS127,18CPS23,30,34,64,P,7,72019,Regular
4JN18CS127,18ELN24,31,21,52,P,6,72019,Regular
4JN18CS127,18ME25,29,41,70,P,8,72019,Regular
4JN18CS127,18CHEL26,33,47,80,P,9,72019,Regular
4JN18CS127,18CPL27,38,34,72,P,8,72019,Regular
4JN18CS127,18EGH28,25,31,56,P,6,72019,Regular
4JN15CS010,15CS81,19,45,64,P,7,72019,Regular
4JN15CS010,15CS832,16,40,56,P,6,72019,Regular
4JN15CS010,15CS82,20,54,74,P,8,72019,Regular
4JN15CS010,15CS84,47,47,94,P,10,72019,Regular
4JN15CS010,15CSP85,97,97,194,P,10,72019,Regular
4JN15CS010,15CSS86,88,0,88,P,9,72019,Regular
4JN15CS013,15CS81,20,48,68,P,7,72019,Regular
4JN15CS013,15CS832,18,47,65,P,7,72019,Regular
4JN15CS013,15CS82,16,46,62,P,7,72019,Regular
4JN15CS013,15CS84,48,47,95,P,10,72019,Regular
4JN15CS013,15CSP85,92,91,183,P,10,72019,Regular
4JN15CS013,15CSS86,96,0,96,P,10,72019,Regular
4JN15CS018,15CS81,20,46,66,P,7,72019,Regular
4JN15CS018,15CS832,17,51,68,P,7,72019,Regular
4JN15CS018,15CS82,17,47,64,P,7,72019,Regular
4JN15CS018,15CS84,47,46,93,P,10,72019,Regular
4JN15CS018,15CSP85,95,92,187,P,10,72019,Regular
4JN15CS018,15CSS86,92,0,92,P,10,72019,Regular
4JN15CS019,15CS81,19,42,61,P,7,72019,Regular
4JN15CS019,15CS82,19,40,59,P,6,72019,Regular
4JN15CS019,15CS84,48,48,96,P,10,72019,Regular
4JN15CS019,15CS834,15,33,48,P,5,72019,Regular
4JN15CS019,15CSP85,98,98,196,P,10,72019,Regular
4JN15CS019,15CSS86,97,0,97,P,10,72019,Regular
4JN15CS039,15CS81,20,36,56,P,6,72019,Regular
4JN15CS039,15CS82,18,46,64,P,7,72019,Regular
4JN15CS039,15CS84,49,47,96,P,10,72019,Regular
4JN15CS039,15CS834,17,54,71,P,8,72019,Regular
4JN15CS039,15CSP85,100,88,188,P,10,72019,Regular
4JN15CS039,15CSS86,95,0,95,P,10,72019,Regular
4JN15CS046,15CS81,16,34,50,P,6,72019,Regular
4JN15CS046,15CS832,12,36,48,P,5,72019,Regular
4JN15CS046,15CS82,12,53,65,P,7,72019,Regular
4JN15CS046,15CS84,45,46,91,P,10,72019,Regular
4JN15CS046,15CSP85,92,94,186,P,10,72019,Regular
4JN15CS046,15CSS86,94,0,94,P,10,72019,Regular
4JN15CS052,15CS81,20,49,69,P,7,72019,Regular
4JN15CS052,15CS832,20,53,73,P,8,72019,Regular
4JN15CS052,15CS82,20,55,75,P,8,72019,Regular
4JN15CS052,15CS84,49,49,98,P,10,72019,Regular
4JN15CS052,15CSP85,98,98,196,P,10,72019,Regular
4JN15CS052,15CSS86,97,0,97,P,10,72019,Regular
4JN15CS055,15CS81,16,53,69,P,7,72019,Regular
4JN15CS055,15CS832,20,38,58,P,6,72019,Regular
4JN15CS055,15CS82,20,55,75,P,8,72019,Regular
4JN15CS055,15CS84,47,48,95,P,10,72019,Regular
4JN15CS055,15CSP85,96,98,194,P,10,72019,Regular
4JN15CS055,15CSS86,91,0,91,P,10,72019,Regular
4JN15CS060,15CS81,18,34,52,P,6,72019,Regular
4JN15CS060,15CS832,14,43,57,P,6,72019,Regular
4JN15CS060,15CS82,18,46,64,P,7,72019,Regular
4JN15CS060,15CS84,48,47,95,P,10,72019,Regular
4JN15CS060,15CSP85,98,91,189,P,10,72019,Regular
4JN15CS060,15CSS86,94,0,94,P,10,72019,Regular
4JN15CS063,15CS81,20,53,73,P,8,72019,Regular
4JN15CS063,15CS832,17,60,77,P,8,72019,Regular
4JN15CS063,15CS82,19,43,62,P,7,72019,Regular
4JN15CS063,15CS84,48,47,95,P,10,72019,Regular
4JN15CS063,15CSP85,98,96,194,P,10,72019,Regular
4JN15CS063,15CSS86,96,0,96,P,10,72019,Regular
4JN15CS064,15CS81,20,62,82,P,9,72019,Regular
4JN15CS064,15CS82,19,57,76,P,8,72019,Regular
4JN15CS064,15CS84,48,48,96,P,10,72019,Regular
4JN15CS064,15CS834,18,55,73,P,8,72019,Regular
4JN15CS064,15CSP85,98,97,195,P,10,72019,Regular
4JN15CS064,15CSS86,97,0,97,P,10,72019,Regular
4JN15CS065,15CS81,18,44,62,P,7,72019,Regular
4JN15CS065,15CS832,16,49,65,P,7,72019,Regular
4JN15CS065,15CS82,20,52,72,P,8,72019,Regular
4JN15CS065,15CS84,46,47,93,P,10,72019,Regular
4JN15CS065,15CSP85,92,85,177,P,10,72019,Regular
4JN15CS065,15CSS86,93,0,93,P,10,72019,Regular
4JN15CS066,15CS81,20,49,69,P,7,72019,Regular
4JN15CS066,15CS832,20,68,88,P,9,72019,Regular
4JN15CS066,15CS82,20,59,79,P,8,72019,Regular
4JN15CS066,15CS84,48,47,95,P,10,72019,Regular
4JN15CS066,15CSP85,99,97,196,P,10,72019,Regular
4JN15CS066,15CSS86,91,0,91,P,10,72019,Regular
4JN15CS068,15CS81,20,44,64,P,7,72019,Regular
4JN15CS068,15CS832,19,63,82,P,9,72019,Regular
4JN15CS068,15CS82,20,66,86,P,9,72019,Regular
4JN15CS068,15CS84,48,47,95,P,10,72019,Regular
4JN15CS068,15CSP85,99,99,198,P,10,72019,Regular
4JN15CS068,15CSS86,96,0,96,P,10,72019,Regular
4JN15CS069,15CS81,19,39,58,P,6,72019,Regular
4JN15CS069,15CS82,17,45,62,P,7,72019,Regular
4JN15CS069,15CS84,48,47,95,P,10,72019,Regular
4JN15CS069,15CS834,17,43,60,P,7,72019,Regular
4JN15CS069,15CSP85,97,80,177,P,10,72019,Regular
4JN15CS069,15CSS86,93,0,93,P,10,72019,Regular
4JN15CS070,15CS81,20,45,65,P,7,72019,Regular
4JN15CS070,15CS832,18,58,76,P,8,72019,Regular
4JN15CS070,15CS82,19,62,81,P,9,72019,Regular
4JN15CS070,15CS84,49,48,97,P,10,72019,Regular
4JN15CS070,15CSP85,96,98,194,P,10,72019,Regular
4JN15CS070,15CSS86,94,0,94,P,10,72019,Regular
4JN15CS071,15CS81,19,35,54,P,6,72019,Regular
4JN15CS071,15CS832,17,35,52,P,6,72019,Regular
4JN15CS071,15CS82,17,49,66,P,7,72019,Regular
4JN15CS071,15CS84,46,47,93,P,10,72019,Regular
4JN15CS071,15CSP85,98,90,188,P,10,72019,Regular
4JN15CS071,15CSS86,89,0,89,P,9,72019,Regular
4JN15CS073,15CS81,20,48,68,P,7,72019,Regular
4JN15CS073,15CS832,20,55,75,P,8,72019,Regular
4JN15CS073,15CS82,20,51,71,P,8,72019,Regular
4JN15CS073,15CS84,48,48,96,P,10,72019,Regular
4JN15CS073,15CSP85,99,90,189,P,10,72019,Regular
4JN15CS073,15CSS86,93,0,93,P,10,72019,Regular
4JN15CS074,15CS81,18,37,55,P,6,72019,Regular
4JN15CS074,15CS82,20,46,66,P,7,72019,Regular
4JN15CS074,15CS84,48,48,96,P,10,72019,Regular
4JN15CS074,15CS834,19,46,65,P,7,72019,Regular
4JN15CS074,15CSP85,96,90,186,P,10,72019,Regular
4JN15CS074,15CSS86,97,0,97,P,10,72019,Regular
4JN15CS074,15CS72,15,39,54,P,6,72019,Backlog
4JN15CS074,15CS744,19,37,56,P,6,72019,Backlog
4JN15CS075,15CS81,20,56,76,P,8,72019,Regular
4JN15CS075,15CS82,20,59,79,P,8,72019,Regular
4JN15CS075,15CS84,49,50,99,P,10,72019,Regular
4JN15CS075,15CS834,20,72,92,P,10,72019,Regular
4JN15CS075,15CSP85,100,92,192,P,10,72019,Regular
4JN15CS075,15CSS86,97,0,97,P,10,72019,Regular
4JN15CS076,15CS81,20,47,67,P,7,72019,Regular
4JN15CS076,15CS832,19,53,72,P,8,72019,Regular
4JN15CS076,15CS82,20,55,75,P,8,72019,Regular
4JN15CS076,15CS84,49,47,96,P,10,72019,Regular
4JN15CS076,15CSP85,99,95,194,P,10,72019,Regular
4JN15CS076,15CSS86,97,0,97,P,10,72019,Regular
4JN15CS078,15CS81,20,50,70,P,8,72019,Regular
4JN15CS078,15CS832,20,56,76,P,8,72019,Regular
4JN15CS078,15CS82,20,56,76,P,8,72019,Regular
4JN15CS078,15CS84,49,48,97,P,10,72019,Regular
4JN15CS078,15CSP85,99,96,195,P,10,72019,Regular
4JN15CS078,15CSS86,96,0,96,P,10,72019,Regular
4JN15CS079,15CS81,15,39,54,P,6,72019,Regular
4JN15CS079,15CS832,12,29,41,P,4,72019,Regular
4JN15CS079,15CS82,12,30,42,P,4,72019,Regular
4JN15CS079,15CS84,47,46,93,P,10,72019,Regular
4JN15CS079,15CSP85,98,93,191,P,10,72019,Regular
4JN15CS079,15CSS86,88,0,88,P,9,72019,Regular
4JN15CS079,15CS71,13,35,48,P,5,72019,Backlog
4JN15CS079,15CS72,17,37,54,P,6,72019,Backlog
4JN15CS079,15CS754,13,29,42,P,4,72019,Backlog
4JN15CS081,15CS81,18,45,63,P,7,72019,Regular
4JN15CS081,15CS82,20,60,80,P,9,72019,Regular
4JN15CS081,15CS84,49,49,98,P,10,72019,Regular
4JN15CS081,15CS834,19,64,83,P,9,72019,Regular
4JN15CS081,15CSP85,99,98,197,P,10,72019,Regular
4JN15CS081,15CSS86,97,0,97,P,10,72019,Regular
4JN15CS083,15CS81,19,40,59,P,6,72019,Regular
4JN15CS083,15CS82,20,67,87,P,9,72019,Regular
4JN15CS083,15CS84,48,49,97,P,10,72019,Regular
4JN15CS083,15CS834,17,46,63,P,7,72019,Regular
4JN15CS083,15CSP85,99,97,196,P,10,72019,Regular
4JN15CS083,15CSS86,95,0,95,P,10,72019,Regular
4JN15CS084,15CS81,20,37,57,P,6,72019,Regular
4JN15CS084,15CS832,17,41,58,P,6,72019,Regular
4JN15CS084,15CS82,19,53,72,P,8,72019,Regular
4JN15CS084,15CS84,47,47,94,P,10,72019,Regular
4JN15CS084,15CSP85,92,80,172,P,10,72019,Regular
4JN15CS084,15CSS86,94,0,94,P,10,72019,Regular
4JN15CS085,15CS81,20,54,74,P,8,72019,Regular
4JN15CS085,15CS832,20,61,81,P,9,72019,Regular
4JN15CS085,15CS82,20,50,70,P,8,72019,Regular
4JN15CS085,15CS84,49,48,97,P,10,72019,Regular
4JN15CS085,15CSP85,98,97,195,P,10,72019,Regular
4JN15CS085,15CSS86,95,0,95,P,10,72019,Regular
4JN15CS087,15CS81,20,51,71,P,8,72019,Regular
4JN15CS087,15CS832,19,53,72,P,8,72019,Regular
4JN15CS087,15CS82,19,49,68,P,7,72019,Regular
4JN15CS087,15CS84,46,48,94,P,10,72019,Regular
4JN15CS087,15CSP85,99,95,194,P,10,72019,Regular
4JN15CS087,15CSS86,95,0,95,P,10,72019,Regular
4JN15CS088,15CS81,18,47,65,P,7,72019,Regular
4JN15CS088,15CS832,18,47,65,P,7,72019,Regular
4JN15CS088,15CS82,20,43,63,P,7,72019,Regular
4JN15CS088,15CS84,47,48,95,P,10,72019,Regular
4JN15CS088,15CSP85,92,82,174,P,10,72019,Regular
4JN15CS088,15CSS86,94,0,94,P,10,72019,Regular
4JN15CS089,15CS81,20,45,65,P,7,72019,Regular
4JN15CS089,15CS832,18,60,78,P,8,72019,Regular
4JN15CS089,15CS82,20,52,72,P,8,72019,Regular
4JN15CS089,15CS84,49,47,96,P,10,72019,Regular
4JN15CS089,15CSP85,96,99,195,P,10,72019,Regular
4JN15CS089,15CSS86,96,0,96,P,10,72019,Regular
4JN15CS090,15CS81,19,46,65,P,7,72019,Regular
4JN15CS090,15CS832,18,60,78,P,8,72019,Regular
4JN15CS090,15CS82,20,48,68,P,7,72019,Regular
4JN15CS090,15CS84,49,49,98,P,10,72019,Regular
4JN15CS090,15CSP85,99,98,197,P,10,72019,Regular
4JN15CS090,15CSS86,95,0,95,P,10,72019,Regular
4JN15CS091,15CS81,20,46,66,P,7,72019,Regular
4JN15CS091,15CS832,18,34,52,P,6,72019,Regular
4JN15CS091,15CS82,20,48,68,P,7,72019,Regular
4JN15CS091,15CS84,49,49,98,P,10,72019,Regular
4JN15CS091,15CSP85,96,97,193,P,10,72019,Regular
4JN15CS091,15CSS86,96,0,96,P,10,72019,Regular
4JN15CS092,15CS81,20,56,76,P,8,72019,Regular
4JN15CS092,15CS832,20,58,78,P,8,72019,Regular
4JN15CS092,15CS82,20,56,76,P,8,72019,Regular
4JN15CS092,15CS84,48,47,95,P,10,72019,Regular
4JN15CS092,15CSP85,96,96,192,P,10,72019,Regular
4JN15CS092,15CSS86,97,0,97,P,10,72019,Regular
4JN15CS093,15CS81,20,62,82,P,9,72019,Regular
4JN15CS093,15CS82,20,58,78,P,8,72019,Regular
4JN15CS093,15CS84,49,49,98,P,10,72019,Regular
4JN15CS093,15CS834,17,71,88,P,9,72019,Regular
4JN15CS093,15CSP85,96,99,195,P,10,72019,Regular
4JN15CS093,15CSS86,97,0,97,P,10,72019,Regular
4JN15CS094,15CS81,20,33,53,P,6,72019,Regular
4JN15CS094,15CS832,12,31,43,P,4,72019,Regular
4JN15CS094,15CS82,19,42,61,P,7,72019,Regular
4JN15CS094,15CS84,47,46,93,P,10,72019,Regular
4JN15CS094,15CSP85,96,97,193,P,10,72019,Regular
4JN15CS094,15CSS86,85,0,85,P,9,72019,Regular
4JN15CS094,15CS72,16,31,47,P,5,72019,Backlog
4JN15CS094,15CS73,19,37,56,P,6,72019,Backlog
4JN15CS095,15CS81,20,45,65,P,7,72019,Regular
4JN15CS095,15CS82,18,39,57,P,6,72019,Regular
4JN15CS095,15CS84,48,49,97,P,10,72019,Regular
4JN15CS095,15CS834,16,44,60,P,7,72019,Regular
4JN15CS095,15CSP85,98,96,194,P,10,72019,Regular
4JN15CS095,15CSS86,97,0,97,P,10,72019,Regular
4JN15CS098,15CS81,20,54,74,P,8,72019,Regular
4JN15CS098,15CS832,19,47,66,P,7,72019,Regular
4JN15CS098,15CS82,20,55,75,P,8,72019,Regular
4JN15CS098,15CS84,46,47,93,P,10,72019,Regular
4JN15CS098,15CSP85,98,94,192,P,10,72019,Regular
4JN15CS098,15CSS86,93,0,93,P,10,72019,Regular
4JN15CS099,15CS81,20,45,65,P,7,72019,Regular
4JN15CS099,15CS82,19,38,57,P,6,72019,Regular
4JN15CS099,15CS84,48,48,96,P,10,72019,Regular
4JN15CS099,15CS834,19,53,72,P,8,72019,Regular
4JN15CS099,15CSP85,95,95,190,P,10,72019,Regular
4JN15CS099,15CSS86,94,0,94,P,10,72019,Regular
4JN15CS100,15CS81,19,48,67,P,7,72019,Regular
4JN15CS100,15CS82,19,46,65,P,7,72019,Regular
4JN15CS100,15CS84,48,47,95,P,10,72019,Regular
4JN15CS100,15CS834,18,50,68,P,7,72019,Regular
4JN15CS100,15CSP85,96,94,190,P,10,72019,Regular
4JN15CS100,15CSS86,95,0,95,P,10,72019,Regular
4JN15CS101,15CS81,18,52,70,P,8,72019,Regular
4JN15CS101,15CS832,20,61,81,P,9,72019,Regular
4JN15CS101,15CS82,19,59,78,P,8,72019,Regular
4JN15CS101,15CS84,46,49,95,P,10,72019,Regular
4JN15CS101,15CSP85,99,96,195,P,10,72019,Regular
4JN15CS101,15CSS86,93,0,93,P,10,72019,Regular
4JN15CS102,15CS81,20,63,83,P,9,72019,Regular
4JN15CS102,15CS832,20,49,69,P,7,72019,Regular
4JN15CS102,15CS82,20,55,75,P,8,72019,Regular
4JN15CS102,15CS84,50,50,100,P,10,72019,Regular
4JN15CS102,15CSP85,100,99,199,P,10,72019,Regular
4JN15CS102,15CSS86,100,0,100,P,10,72019,Regular
4JN15CS103,15CS81,20,64,84,P,9,72019,Regular
4JN15CS103,15CS832,20,60,80,P,9,72019,Regular
4JN15CS103,15CS82,20,56,76,P,8,72019,Regular
4JN15CS103,15CS84,50,50,100,P,10,72019,Regular
4JN15CS103,15CSP85,100,99,199,P,10,72019,Regular
4JN15CS103,15CSS86,100,0,100,P,10,72019,Regular
4JN15CS105,15CS81,20,35,55,P,6,72019,Regular
4JN15CS105,15CS82,19,51,70,P,8,72019,Regular
4JN15CS105,15CS84,49,50,99,P,10,72019,Regular
4JN15CS105,15CS834,19,49,68,P,7,72019,Regular
4JN15CS105,15CSP85,98,98,196,P,10,72019,Regular
4JN15CS105,15CSS86,97,0,97,P,10,72019,Regular
4JN15CS108,15CS81,20,47,67,P,7,72019,Regular
4JN15CS108,15CS832,17,40,57,P,6,72019,Regular
4JN15CS108,15CS82,20,54,74,P,8,72019,Regular
4JN15CS108,15CS84,48,47,95,P,10,72019,Regular
4JN15CS108,15CSP85,98,97,195,P,10,72019,Regular
4JN15CS108,15CSS86,93,0,93,P,10,72019,Regular
4JN15CS110,15CS81,18,47,65,P,7,72019,Regular
4JN15CS110,15CS832,19,64,83,P,9,72019,Regular
4JN15CS110,15CS82,19,58,77,P,8,72019,Regular
4JN15CS110,15CS84,48,47,95,P,10,72019,Regular
4JN15CS110,15CSP85,99,98,197,P,10,72019,Regular
4JN15CS110,15CSS86,94,0,94,P,10,72019,Regular
4JN15CS112,15CS81,20,57,77,P,8,72019,Regular
4JN15CS112,15CS82,19,48,67,P,7,72019,Regular
4JN15CS112,15CS84,47,48,95,P,10,72019,Regular
4JN15CS112,15CS834,17,64,81,P,9,72019,Regular
4JN15CS112,15CSP85,96,96,192,P,10,72019,Regular
4JN15CS112,15CSS86,92,0,92,P,10,72019,Regular
4JN15CS114,15CS81,19,46,65,P,7,72019,Regular
4JN15CS114,15CS832,16,49,65,P,7,72019,Regular
4JN15CS114,15CS82,19,46,65,P,7,72019,Regular
4JN15CS114,15CS84,47,48,95,P,10,72019,Regular
4JN15CS114,15CSP85,92,83,175,P,10,72019,Regular
4JN15CS114,15CSS86,92,0,92,P,10,72019,Regular
4JN15CS115,15CS81,20,36,56,P,6,72019,Regular
4JN15CS115,15CS832,16,61,77,P,8,72019,Regular
4JN15CS115,15CS82,16,66,82,P,9,72019,Regular
4JN15CS115,15CS84,48,48,96,P,10,72019,Regular
4JN15CS115,15CSP85,92,85,177,P,10,72019,Regular
4JN15CS115,15CSS86,93,0,93,P,10,72019,Regular
4JN15CS115,15CS72,19,34,53,P,6,72019,Backlog
4JN15CS116,15CS81,19,52,71,P,8,72019,Regular
4JN15CS116,15CS82,19,60,79,P,8,72019,Regular
4JN15CS116,15CS84,48,48,96,P,10,72019,Regular
4JN15CS116,15CS834,20,65,85,P,9,72019,Regular
4JN15CS116,15CSP85,95,91,186,P,10,72019,Regular
4JN15CS116,15CSS86,95,0,95,P,10,72019,Regular
4JN15CS120,15CS81,18,49,67,P,7,72019,Regular
4JN15CS120,15CS832,16,46,62,P,7,72019,Regular
4JN15CS120,15CS82,17,36,53,P,6,72019,Regular
4JN15CS120,15CS84,48,47,95,P,10,72019,Regular
4JN15CS120,15CSP85,92,90,182,P,10,72019,Regular
4JN15CS120,15CSS86,95,0,95,P,10,72019,Regular
4JN15CS122,15CS81,20,45,65,P,7,72019,Regular
4JN15CS122,15CS832,19,46,65,P,7,72019,Regular
4JN15CS122,15CS82,20,66,86,P,9,72019,Regular
4JN15CS122,15CS84,46,47,93,P,10,72019,Regular
4JN15CS122,15CSP85,99,97,196,P,10,72019,Regular
4JN15CS122,15CSS86,96,0,96,P,10,72019,Regular
4JN15CS123,15CS81,20,42,62,P,7,72019,Regular
4JN15CS123,15CS832,18,70,88,P,9,72019,Regular
4JN15CS123,15CS82,19,59,78,P,8,72019,Regular
4JN15CS123,15CS84,48,49,97,P,10,72019,Regular
4JN15CS123,15CSP85,99,98,197,P,10,72019,Regular
4JN15CS123,15CSS86,94,0,94,P,10,72019,Regular
4JN15CS124,15CS81,20,48,68,P,7,72019,Regular
4JN15CS124,15CS832,20,60,80,P,9,72019,Regular
4JN15CS124,15CS82,20,50,70,P,8,72019,Regular
4JN15CS124,15CS84,49,50,99,P,10,72019,Regular
4JN15CS124,15CSP85,99,97,196,P,10,72019,Regular
4JN15CS124,15CSS86,97,0,97,P,10,72019,Regular
4JN15CS125,15CS81,20,35,55,P,6,72019,Regular
4JN15CS125,15CS832,19,60,79,P,8,72019,Regular
4JN15CS125,15CS82,19,60,79,P,8,72019,Regular
4JN15CS125,15CS84,47,49,96,P,10,72019,Regular
4JN15CS125,15CSP85,99,98,197,P,10,72019,Regular
4JN15CS125,15CSS86,94,0,94,P,10,72019,Regular
4JN15CS126,15CS81,20,51,71,P,8,72019,Regular
4JN15CS126,15CS832,20,58,78,P,8,72019,Regular
4JN15CS126,15CS82,20,59,79,P,8,72019,Regular
4JN15CS126,15CS84,48,47,95,P,10,72019,Regular
4JN15CS126,15CSP85,99,98,197,P,10,72019,Regular
4JN15CS126,15CSS86,94,0,94,P,10,72019,Regular
4JN15CS127,15CS81,20,32,52,P,6,72019,Regular
4JN15CS127,15CS832,18,49,67,P,7,72019,Regular
4JN15CS127,15CS82,19,47,66,P,7,72019,Regular
4JN15CS127,15CS84,48,48,96,P,10,72019,Regular
4JN15CS127,15CSP85,99,95,194,P,10,72019,Regular
4JN15CS127,15CSS86,98,0,98,P,10,72019,Regular
4JN15CS128,15CS81,19,46,65,P,7,72019,Regular
4JN15CS128,15CS832,18,52,70,P,8,72019,Regular
4JN15CS128,15CS82,20,52,72,P,8,72019,Regular
4JN15CS128,15CS84,48,47,95,P,10,72019,Regular
4JN15CS128,15CSP85,99,95,194,P,10,72019,Regular
4JN15CS128,15CSS86,95,0,95,P,10,72019,Regular
4JN15CS129,15CS81,20,37,57,P,6,72019,Regular
4JN15CS129,15CS832,19,52,71,P,8,72019,Regular
4JN15CS129,15CS82,20,57,77,P,8,72019,Regular
4JN15CS129,15CS84,48,47,95,P,10,72019,Regular
4JN15CS129,15CSP85,92,90,182,P,10,72019,Regular
4JN15CS129,15CSS86,94,0,94,P,10,72019,Regular
4JN15CS130,15CS81,19,52,71,P,8,72019,Regular
4JN15CS130,15CS832,19,49,68,P,7,72019,Regular
4JN15CS130,15CS82,20,51,71,P,8,72019,Regular
4JN15CS130,15CS84,48,47,95,P,10,72019,Regular
4JN15CS130,15CSP85,99,98,197,P,10,72019,Regular
4JN15CS130,15CSS86,95,0,95,P,10,72019,Regular
4JN16CS400,15CS81,20,50,70,P,8,72019,Regular
4JN16CS400,15CS82,18,62,80,P,9,72019,Regular
4JN16CS400,15CS84,48,47,95,P,10,72019,Regular
4JN16CS400,15CS834,19,62,81,P,9,72019,Regular
4JN16CS400,15CSP85,98,97,195,P,10,72019,Regular
4JN16CS400,15CSS86,94,0,94,P,10,72019,Regular
4JN16CS401,15CS81,20,44,64,P,7,72019,Regular
4JN16CS401,15CS82,18,70,88,P,9,72019,Regular
4JN16CS401,15CS84,48,47,95,P,10,72019,Regular
4JN16CS401,15CS834,18,54,72,P,8,72019,Regular
4JN16CS401,15CSP85,97,81,178,P,10,72019,Regular
4JN16CS401,15CSS86,92,0,92,P,10,72019,Regular
4JN16CS402,15CS81,20,45,65,P,7,72019,Regular
4JN16CS402,15CS832,17,48,65,P,7,72019,Regular
4JN16CS402,15CS82,18,57,75,P,8,72019,Regular
4JN16CS402,15CS84,48,47,95,P,10,72019,Regular
4JN16CS402,15CSP85,92,90,182,P,10,72019,Regular
4JN16CS402,15CSS86,94,0,94,P,10,72019,Regular
4JN16CS403,15CS81,20,48,68,P,7,72019,Regular
4JN16CS403,15CS82,19,50,69,P,7,72019,Regular
4JN16CS403,15CS84,48,47,95,P,10,72019,Regular
4JN16CS403,15CS834,16,61,77,P,8,72019,Regular
4JN16CS403,15CSP85,97,80,177,P,10,72019,Regular
4JN16CS403,15CSS86,89,0,89,P,9,72019,Regular
4JN16CS408,15CS81,20,45,65,P,7,72019,Regular
4JN16CS408,15CS832,13,36,49,P,5,72019,Regular
4JN16CS408,15CS82,18,42,60,P,7,72019,Regular
4JN16CS408,15CS84,48,47,95,P,10,72019,Regular
4JN16CS408,15CSP85,98,90,188,P,10,72019,Regular
4JN16CS408,15CSS86,93,0,93,P,10,72019,Regular
4JN16CS412,15CS81,20,48,68,P,7,72019,Regular
4JN16CS412,15CS82,20,62,82,P,9,72019,Regular
4JN16CS412,15CS84,48,47,95,P,10,72019,Regular
4JN16CS412,15CS834,20,48,68,P,7,72019,Regular
4JN16CS412,15CSP85,98,96,194,P,10,72019,Regular
4JN16CS412,15CSS86,95,0,95,P,10,72019,Regular
4JN16CS413,15CS81,20,54,74,P,8,72019,Regular
4JN16CS413,15CS82,20,58,78,P,8,72019,Regular
4JN16CS413,15CS84,48,47,95,P,10,72019,Regular
4JN16CS413,15CS834,18,63,81,P,9,72019,Regular
4JN16CS413,15CSP85,97,81,178,P,10,72019,Regular
4JN16CS413,15CSS86,89,0,89,P,9,72019,Regular
4JN16CS415,15CS81,20,41,61,P,7,72019,Regular
4JN16CS415,15CS82,20,38,58,P,6,72019,Regular
4JN16CS415,15CS84,47,46,93,P,10,72019,Regular
4JN16CS415,15CS834,17,28,45,P,5,72019,Regular
4JN16CS415,15CSP85,94,90,184,P,10,72019,Regular
4JN16CS415,15CSS86,94,0,94,P,10,72019,Regular
4JN16CS416,15CS81,14,42,56,P,6,72019,Regular
4JN16CS416,15CS832,17,52,69,P,7,72019,Regular
4JN16CS416,15CS82,17,49,66,P,7,72019,Regular
4JN16CS416,15CS84,46,47,93,P,10,72019,Regular
4JN16CS416,15CSP85,98,92,190,P,10,72019,Regular
4JN16CS416,15CSS86,88,0,88,P,9,72019,Regular
4JN16CS418,15CS81,20,51,71,P,8,72019,Regular
4JN16CS418,15CS82,20,53,73,P,8,72019,Regular
4JN16CS418,15CS84,48,49,97,P,10,72019,Regular
4JN16CS418,15CS834,16,54,70,P,8,72019,Regular
4JN16CS418,15CSP85,95,95,190,P,10,72019,Regular
4JN16CS418,15CSS86,94,0,94,P,10,72019,Regular
4JN14CS121,15CS81,16,37,53,P,6,72019,Regular
4JN14CS121,15CS832,16,32,48,P,5,72019,Regular
4JN14CS121,15CS82,20,29,49,P,5,72019,Regular
4JN14CS121,15CS84,46,48,94,P,10,72019,Regular
4JN14CS121,15CSP85,94,96,190,P,10,72019,Regular
4JN14CS121,15CSS86,92,0,92,P,10,72019,Regular
4JN14CS121,15CS72,16,46,62,P,7,72019,Backlog
4JN15CS001,15CS81,17,30,47,P,5,72019,Regular
4JN15CS001,15CS832,17,48,65,P,7,72019,Regular
4JN15CS001,15CS82,20,50,70,P,8,72019,Regular
4JN15CS001,15CS84,49,47,96,P,10,72019,Regular
4JN15CS001,15CSP85,97,96,193,P,10,72019,Regular
4JN15CS001,15CSS86,96,0,96,P,10,72019,Regular
4JN15CS002,15CS81,18,46,64,P,7,72019,Regular
4JN15CS002,15CS82,20,38,58,P,6,72019,Regular
4JN15CS002,15CS84,46,48,94,P,10,72019,Regular
4JN15CS002,15CS834,18,53,71,P,8,72019,Regular
4JN15CS002,15CSP85,94,85,179,P,10,72019,Regular
4JN15CS002,15CSS86,96,0,96,P,10,72019,Regular
4JN15CS003,15CS81,18,59,77,P,8,72019,Regular
4JN15CS003,15CS82,20,64,84,P,9,72019,Regular
4JN15CS003,15CS84,48,46,94,P,10,72019,Regular
4JN15CS003,15CS834,20,46,66,P,7,72019,Regular
4JN15CS003,15CSP85,95,97,192,P,10,72019,Regular
4JN15CS003,15CSS86,96,0,96,P,10,72019,Regular
4JN15CS004,15CS81,16,37,53,P,6,72019,Regular
4JN15CS004,15CS82,20,48,68,P,7,72019,Regular
4JN15CS004,15CS84,48,47,95,P,10,72019,Regular
4JN15CS004,15CS834,19,55,74,P,8,72019,Regular
4JN15CS004,15CSP85,95,98,193,P,10,72019,Regular
4JN15CS004,15CSS86,96,0,96,P,10,72019,Regular
4JN15CS005,15CS81,20,52,72,P,8,72019,Regular
4JN15CS005,15CS82,20,52,72,P,8,72019,Regular
4JN15CS005,15CS84,49,48,97,P,10,72019,Regular
4JN15CS005,15CS834,20,61,81,P,9,72019,Regular
4JN15CS005,15CSP85,100,99,199,P,10,72019,Regular
4JN15CS005,15CSS86,99,0,99,P,10,72019,Regular
4JN15CS007,15CS81,19,54,73,P,8,72019,Regular
4JN15CS007,15CS82,20,41,61,P,7,72019,Regular
4JN15CS007,15CS84,48,49,97,P,10,72019,Regular
4JN15CS007,15CS834,20,54,74,P,8,72019,Regular
4JN15CS007,15CSP85,99,99,198,P,10,72019,Regular
4JN15CS007,15CSS86,96,0,96,P,10,72019,Regular
4JN15CS008,15CS81,20,38,58,P,6,72019,Regular
4JN15CS008,15CS82,20,39,59,P,6,72019,Regular
4JN15CS008,15CS84,48,49,97,P,10,72019,Regular
4JN15CS008,15CS834,18,50,68,P,7,72019,Regular
4JN15CS008,15CSP85,100,99,199,P,10,72019,Regular
4JN15CS008,15CSS86,97,0,97,P,10,72019,Regular
4JN15CS009,15CS81,20,51,71,P,8,72019,Regular
4JN15CS009,15CS832,18,64,82,P,9,72019,Regular
4JN15CS009,15CS82,20,55,75,P,8,72019,Regular
4JN15CS009,15CS84,48,49,97,P,10,72019,Regular
4JN15CS009,15CSP85,100,99,199,P,10,72019,Regular
4JN15CS009,15CSS86,99,0,99,P,10,72019,Regular
4JN15CS011,15CS81,19,47,66,P,7,72019,Regular
4JN15CS011,15CS82,20,54,74,P,8,72019,Regular
4JN15CS011,15CS84,48,47,95,P,10,72019,Regular
4JN15CS011,15CS834,17,49,66,P,7,72019,Regular
4JN15CS011,15CSP85,95,93,188,P,10,72019,Regular
4JN15CS011,15CSS86,96,0,96,P,10,72019,Regular
4JN15CS012,15CS81,18,42,60,P,7,72019,Regular
4JN15CS012,15CS832,17,52,69,P,7,72019,Regular
4JN15CS012,15CS82,19,53,72,P,8,72019,Regular
4JN15CS012,15CS84,47,49,96,P,10,72019,Regular
4JN15CS012,15CSP85,95,97,192,P,10,72019,Regular
4JN15CS012,15CSS86,93,0,93,P,10,72019,Regular
4JN15CS014,15CS81,20,46,66,P,7,72019,Regular
4JN15CS014,15CS832,17,67,84,P,9,72019,Regular
4JN15CS014,15CS82,20,62,82,P,9,72019,Regular
4JN15CS014,15CS84,49,47,96,P,10,72019,Regular
4JN15CS014,15CSP85,90,93,183,P,10,72019,Regular
4JN15CS014,15CSS86,96,0,96,P,10,72019,Regular
4JN15CS015,15CS81,20,39,59,P,6,72019,Regular
4JN15CS015,15CS832,18,37,55,P,6,72019,Regular
4JN15CS015,15CS82,20,47,67,P,7,72019,Regular
4JN15CS015,15CS84,49,49,98,P,10,72019,Regular
4JN15CS015,15CSP85,90,96,186,P,10,72019,Regular
4JN15CS015,15CSS86,98,0,98,P,10,72019,Regular
4JN15CS016,15CS81,20,50,70,P,8,72019,Regular
4JN15CS016,15CS832,18,44,62,P,7,72019,Regular
4JN15CS016,15CS82,20,42,62,P,7,72019,Regular
4JN15CS016,15CS84,47,46,93,P,10,72019,Regular
4JN15CS016,15CSP85,92,76,168,P,10,72019,Regular
4JN15CS016,15CSS86,94,0,94,P,10,72019,Regular
4JN15CS021,15CS81,20,37,57,P,6,72019,Regular
4JN15CS021,15CS832,20,48,68,P,7,72019,Regular
4JN15CS021,15CS82,20,61,81,P,9,72019,Regular
4JN15CS021,15CS84,49,48,97,P,10,72019,Regular
4JN15CS021,15CSP85,96,96,192,P,10,72019,Regular
4JN15CS021,15CSS86,96,0,96,P,10,72019,Regular
4JN15CS022,15CS81,18,38,56,P,6,72019,Regular
4JN15CS022,15CS832,17,44,61,P,7,72019,Regular
4JN15CS022,15CS82,20,55,75,P,8,72019,Regular
4JN15CS022,15CS84,47,48,95,P,10,72019,Regular
4JN15CS022,15CSP85,90,94,184,P,10,72019,Regular
4JN15CS022,15CSS86,95,0,95,P,10,72019,Regular
4JN15CS023,15CS81,17,46,63,P,7,72019,Regular
4JN15CS023,15CS832,12,39,51,P,6,72019,Regular
4JN15CS023,15CS82,19,51,70,P,8,72019,Regular
4JN15CS023,15CS84,47,46,93,P,10,72019,Regular
4JN15CS023,15CSP85,94,75,169,P,10,72019,Regular
4JN15CS023,15CSS86,94,0,94,P,10,72019,Regular
4JN15CS024,15CS81,17,48,65,P,7,72019,Regular
4JN15CS024,15CS82,20,36,56,P,6,72019,Regular
4JN15CS024,15CS84,46,48,94,P,10,72019,Regular
4JN15CS024,15CS834,16,43,59,P,6,72019,Regular
4JN15CS024,15CSP85,94,88,182,P,10,72019,Regular
4JN15CS024,15CSS86,96,0,96,P,10,72019,Regular
4JN15CS024,15CS71,15,35,50,P,6,72019,Backlog
4JN15CS024,15CS742,12,37,49,P,5,72019,Backlog
4JN15CS024,15CS72,16,46,62,P,7,72019,Backlog
4JN15CS026,15CS81,20,45,65,P,7,72019,Regular
4JN15CS026,15CS832,19,48,67,P,7,72019,Regular
4JN15CS026,15CS82,20,51,71,P,8,72019,Regular
4JN15CS026,15CS84,49,48,97,P,10,72019,Regular
4JN15CS026,15CSP85,90,94,184,P,10,72019,Regular
4JN15CS026,15CSS86,98,0,98,P,10,72019,Regular
4JN15CS027,15CS81,20,46,66,P,7,72019,Regular
4JN15CS027,15CS832,20,57,77,P,8,72019,Regular
4JN15CS027,15CS82,20,53,73,P,8,72019,Regular
4JN15CS027,15CS84,48,49,97,P,10,72019,Regular
4JN15CS027,15CSP85,100,99,199,P,10,72019,Regular
4JN15CS027,15CSS86,99,0,99,P,10,72019,Regular
4JN15CS028,15CS81,20,53,73,P,8,72019,Regular
4JN15CS028,15CS832,19,47,66,P,7,72019,Regular
4JN15CS028,15CS82,20,57,77,P,8,72019,Regular
4JN15CS028,15CS84,48,48,96,P,10,72019,Regular
4JN15CS028,15CSP85,99,98,197,P,10,72019,Regular
4JN15CS028,15CSS86,96,0,96,P,10,72019,Regular
4JN15CS029,15CS81,20,45,65,P,7,72019,Regular
4JN15CS029,15CS82,20,59,79,P,8,72019,Regular
4JN15CS029,15CS84,49,48,97,P,10,72019,Regular
4JN15CS029,15CS834,19,43,62,P,7,72019,Regular
4JN15CS029,15CSP85,100,99,199,P,10,72019,Regular
4JN15CS029,15CSS86,99,0,99,P,10,72019,Regular
4JN15CS030,15CS81,19,33,52,P,6,72019,Regular
4JN15CS030,15CS832,18,40,58,P,6,72019,Regular
4JN15CS030,15CS82,20,31,51,P,6,72019,Regular
4JN15CS030,15CS84,49,47,96,P,10,72019,Regular
4JN15CS030,15CSP85,93,97,190,P,10,72019,Regular
4JN15CS030,15CSS86,94,0,94,P,10,72019,Regular
4JN15CS031,15CS81,20,49,69,P,7,72019,Regular
4JN15CS031,15CS832,19,70,89,P,9,72019,Regular
4JN15CS031,15CS82,20,59,79,P,8,72019,Regular
4JN15CS031,15CS84,48,49,97,P,10,72019,Regular
4JN15CS031,15CSP85,97,97,194,P,10,72019,Regular
4JN15CS031,15CSS86,96,0,96,P,10,72019,Regular
4JN15CS032,15CS81,20,63,83,P,9,72019,Regular
4JN15CS032,15CS82,20,65,85,P,9,72019,Regular
4JN15CS032,15CS84,48,49,97,P,10,72019,Regular
4JN15CS032,15CS834,20,62,82,P,9,72019,Regular
4JN15CS032,15CSP85,96,95,191,P,10,72019,Regular
4JN15CS032,15CSS86,97,0,97,P,10,72019,Regular
4JN15CS033,15CS81,19,45,64,P,7,72019,Regular
4JN15CS033,15CS82,20,59,79,P,8,72019,Regular
4JN15CS033,15CS84,47,48,95,P,10,72019,Regular
4JN15CS033,15CS834,20,54,74,P,8,72019,Regular
4JN15CS033,15CSP85,99,99,198,P,10,72019,Regular
4JN15CS033,15CSS86,95,0,95,P,10,72019,Regular
4JN15CS034,15CS81,20,35,55,P,6,72019,Regular
4JN15CS034,15CS82,20,44,64,P,7,72019,Regular
4JN15CS034,15CS84,48,49,97,P,10,72019,Regular
4JN15CS034,15CS834,19,29,48,P,5,72019,Regular
4JN15CS034,15CSP85,99,99,198,P,10,72019,Regular
4JN15CS034,15CSS86,98,0,98,P,10,72019,Regular
4JN15CS035,15CS81,20,43,63,P,7,72019,Regular
4JN15CS035,15CS82,20,67,87,P,9,72019,Regular
4JN15CS035,15CS84,50,50,100,P,10,72019,Regular
4JN15CS035,15CS834,20,53,73,P,8,72019,Regular
4JN15CS035,15CSP85,100,100,200,P,10,72019,Regular
4JN15CS035,15CSS86,100,0,100,P,10,72019,Regular
4JN15CS036,15CS81,20,45,65,P,7,72019,Regular
4JN15CS036,15CS832,20,65,85,P,9,72019,Regular
4JN15CS036,15CS82,20,69,89,P,9,72019,Regular
4JN15CS036,15CS84,47,49,96,P,10,72019,Regular
4JN15CS036,15CSP85,95,98,193,P,10,72019,Regular
4JN15CS036,15CSS86,97,0,97,P,10,72019,Regular
4JN15CS037,15CS81,19,44,63,P,7,72019,Regular
4JN15CS037,15CS832,15,57,72,P,8,72019,Regular
4JN15CS037,15CS82,17,50,67,P,7,72019,Regular
4JN15CS037,15CS84,48,49,97,P,10,72019,Regular
4JN15CS037,15CSP85,97,97,194,P,10,72019,Regular
4JN15CS037,15CSS86,95,0,95,P,10,72019,Regular
4JN15CS038,15CS81,19,43,62,P,7,72019,Regular
4JN15CS038,15CS82,20,51,71,P,8,72019,Regular
4JN15CS038,15CS84,46,48,94,P,10,72019,Regular
4JN15CS038,15CS834,17,32,49,P,5,72019,Regular
4JN15CS038,15CSP85,95,93,188,P,10,72019,Regular
4JN15CS038,15CSS86,94,0,94,P,10,72019,Regular
4JN15CS043,15CS81,18,36,54,P,6,72019,Regular
4JN15CS043,15CS82,20,59,79,P,8,72019,Regular
4JN15CS043,15CS84,48,48,96,P,10,72019,Regular
4JN15CS043,15CS834,16,48,64,P,7,72019,Regular
4JN15CS043,15CSP85,99,99,198,P,10,72019,Regular
4JN15CS043,15CSS86,96,0,96,P,10,72019,Regular
4JN15CS044,15CS81,20,50,70,P,8,72019,Regular
4JN15CS044,15CS82,20,56,76,P,8,72019,Regular
4JN15CS044,15CS84,48,47,95,P,10,72019,Regular
4JN15CS044,15CS834,18,44,62,P,7,72019,Regular
4JN15CS044,15CSP85,93,97,190,P,10,72019,Regular
4JN15CS044,15CSS86,94,0,94,P,10,72019,Regular
4JN15CS045,15CS81,20,50,70,P,8,72019,Regular
4JN15CS045,15CS832,18,56,74,P,8,72019,Regular
4JN15CS045,15CS82,20,61,81,P,9,72019,Regular
4JN15CS045,15CS84,49,47,96,P,10,72019,Regular
4JN15CS045,15CSP85,92,92,184,P,10,72019,Regular
4JN15CS045,15CSS86,95,0,95,P,10,72019,Regular
4JN15CS047,15CS81,19,28,47,P,5,72019,Regular
4JN15CS047,15CS82,20,51,71,P,8,72019,Regular
4JN15CS047,15CS84,48,48,96,P,10,72019,Regular
4JN15CS047,15CS834,18,47,65,P,7,72019,Regular
4JN15CS047,15CSP85,97,96,193,P,10,72019,Regular
4JN15CS047,15CSS86,96,0,96,P,10,72019,Regular
4JN15CS048,15CS81,19,40,59,P,6,72019,Regular
4JN15CS048,15CS82,20,54,74,P,8,72019,Regular
4JN15CS048,15CS84,48,48,96,P,10,72019,Regular
4JN15CS048,15CS834,20,55,75,P,8,72019,Regular
4JN15CS048,15CSP85,95,94,189,P,10,72019,Regular
4JN15CS048,15CSS86,96,0,96,P,10,72019,Regular
4JN15CS050,15CS81,20,38,58,P,6,72019,Regular
4JN15CS050,15CS832,15,53,68,P,7,72019,Regular
4JN15CS050,15CS82,20,60,80,P,9,72019,Regular
4JN15CS050,15CS84,48,50,98,P,10,72019,Regular
4JN15CS050,15CSP85,99,95,194,P,10,72019,Regular
4JN15CS050,15CSS86,97,0,97,P,10,72019,Regular
4JN15CS051,15CS81,20,45,65,P,7,72019,Regular
4JN15CS051,15CS82,20,67,87,P,9,72019,Regular
4JN15CS051,15CS84,50,49,99,P,10,72019,Regular
4JN15CS051,15CS834,20,61,81,P,9,72019,Regular
4JN15CS051,15CSP85,100,100,200,P,10,72019,Regular
4JN15CS051,15CSS86,99,0,99,P,10,72019,Regular
4JN15CS053,15CS81,18,40,58,P,6,72019,Regular
4JN15CS053,15CS832,18,41,59,P,6,72019,Regular
4JN15CS053,15CS82,20,43,63,P,7,72019,Regular
4JN15CS053,15CS84,48,46,94,P,10,72019,Regular
4JN15CS053,15CSP85,96,94,190,P,10,72019,Regular
4JN15CS053,15CSS86,97,0,97,P,10,72019,Regular
4JN15CS054,15CS81,20,35,55,P,6,72019,Regular
4JN15CS054,15CS82,20,52,72,P,8,72019,Regular
4JN15CS054,15CS84,47,48,95,P,10,72019,Regular
4JN15CS054,15CS834,20,42,62,P,7,72019,Regular
4JN15CS054,15CSP85,99,95,194,P,10,72019,Regular
4JN15CS054,15CSS86,94,0,94,P,10,72019,Regular
4JN15CS056,15CS81,19,31,50,P,6,72019,Regular
4JN15CS056,15CS82,20,39,59,P,6,72019,Regular
4JN15CS056,15CS84,48,48,96,P,10,72019,Regular
4JN15CS056,15CS834,17,41,58,P,6,72019,Regular
4JN15CS056,15CSP85,96,96,192,P,10,72019,Regular
4JN15CS056,15CSS86,97,0,97,P,10,72019,Regular
4JN15CS057,15CS81,20,32,52,P,6,72019,Regular
4JN15CS057,15CS82,20,48,68,P,7,72019,Regular
4JN15CS057,15CS84,49,49,98,P,10,72019,Regular
4JN15CS057,15CS834,20,62,82,P,9,72019,Regular
4JN15CS057,15CSP85,93,98,191,P,10,72019,Regular
4JN15CS057,15CSS86,97,0,97,P,10,72019,Regular
4JN15CS058,15CS81,19,46,65,P,7,72019,Regular
4JN15CS058,15CS82,20,64,84,P,9,72019,Regular
4JN15CS058,15CS84,46,48,94,P,10,72019,Regular
4JN15CS058,15CS834,20,52,72,P,8,72019,Regular
4JN15CS058,15CSP85,95,92,187,P,10,72019,Regular
4JN15CS058,15CSS86,94,0,94,P,10,72019,Regular
4JN15CS059,15CS81,20,38,58,P,6,72019,Regular
4JN15CS059,15CS82,20,53,73,P,8,72019,Regular
4JN15CS059,15CS84,47,46,93,P,10,72019,Regular
4JN15CS059,15CS834,18,43,61,P,7,72019,Regular
4JN15CS059,15CSP85,92,93,185,P,10,72019,Regular
4JN15CS059,15CSS86,94,0,94,P,10,72019,Regular
4JN15CS061,15CS81,18,53,71,P,8,72019,Regular
4JN15CS061,15CS82,20,50,70,P,8,72019,Regular
4JN15CS061,15CS84,47,48,95,P,10,72019,Regular
4JN15CS061,15CS834,20,37,57,P,6,72019,Regular
4JN15CS061,15CSP85,95,96,191,P,10,72019,Regular
4JN15CS061,15CSS86,96,0,96,P,10,72019,Regular
4JN15CS062,15CS81,20,42,62,P,7,72019,Regular
4JN15CS062,15CS82,20,44,64,P,7,72019,Regular
4JN15CS062,15CS84,49,48,97,P,10,72019,Regular
4JN15CS062,15CS834,20,76,96,P,10,72019,Regular
4JN15CS062,15CSP85,99,99,198,P,10,72019,Regular
4JN15CS062,15CSS86,99,0,99,P,10,72019,Regular
4JN15CS077,15CS81,20,38,58,P,6,72019,Regular
4JN15CS077,15CS82,20,47,67,P,7,72019,Regular
4JN15CS077,15CS84,48,48,96,P,10,72019,Regular
4JN15CS077,15CS834,20,62,82,P,9,72019,Regular
4JN15CS077,15CSP85,99,95,194,P,10,72019,Regular
4JN15CS077,15CSS86,95,0,95,P,10,72019,Regular
4JN15CS080,15CS81,13,0,13,A,0,72019,Regular
4JN15CS080,15CS82,16,0,16,A,0,72019,Regular
4JN15CS080,15CS84,46,46,92,P,10,72019,Regular
4JN15CS080,15CS834,17,33,50,P,6,72019,Regular
4JN15CS080,15CSP85,95,95,190,P,10,72019,Regular
4JN15CS080,15CSS86,92,0,92,P,10,72019,Regular
4JN15CS080,15CS72,14,0,14,A,0,72019,Backlog
4JN15CS080,15CS73,13,28,41,P,4,72019,Backlog
4JN15CS080,15CS754,14,30,44,P,4,72019,Backlog
4JN15CS082,15CS81,18,48,66,P,7,72019,Regular
4JN15CS082,15CS82,20,47,67,P,7,72019,Regular
4JN15CS082,15CS84,49,48,97,P,10,72019,Regular
4JN15CS082,15CS834,20,39,59,P,6,72019,Regular
4JN15CS082,15CSP85,97,96,193,P,10,72019,Regular
4JN15CS082,15CSS86,96,0,96,P,10,72019,Regular
4JN15CS097,15CS81,19,42,61,P,7,72019,Regular
4JN15CS097,15CS82,20,53,73,P,8,72019,Regular
4JN15CS097,15CS84,48,46,94,P,10,72019,Regular
4JN15CS097,15CS834,19,45,64,P,7,72019,Regular
4JN15CS097,15CSP85,94,88,182,P,10,72019,Regular
4JN15CS097,15CSS86,94,0,94,P,10,72019,Regular
4JN15CS104,15CS81,20,51,71,P,8,72019,Regular
4JN15CS104,15CS82,20,67,87,P,9,72019,Regular
4JN15CS104,15CS84,50,50,100,P,10,72019,Regular
4JN15CS104,15CS834,20,66,86,P,9,72019,Regular
4JN15CS104,15CSP85,100,99,199,P,10,72019,Regular
4JN15CS104,15CSS86,99,0,99,P,10,72019,Regular
4JN15CS109,15CS81,20,36,56,P,6,72019,Regular
4JN15CS109,15CS832,19,66,85,P,9,72019,Regular
4JN15CS109,15CS82,20,59,79,P,8,72019,Regular
4JN15CS109,15CS84,48,46,94,P,10,72019,Regular
4JN15CS109,15CSP85,92,93,185,P,10,72019,Regular
4JN15CS109,15CSS86,93,0,93,P,10,72019,Regular
4JN15CS117,15CS81,20,51,71,P,8,72019,Regular
4JN15CS117,15CS82,20,59,79,P,8,72019,Regular
4JN15CS117,15CS84,46,50,96,P,10,72019,Regular
4JN15CS117,15CS834,18,62,80,P,9,72019,Regular
4JN15CS117,15CSP85,97,95,192,P,10,72019,Regular
4JN15CS117,15CSS86,95,0,95,P,10,72019,Regular
4JN15CS119,15CS81,20,44,64,P,7,72019,Regular
4JN15CS119,15CS832,12,53,65,P,7,72019,Regular
4JN15CS119,15CS82,20,48,68,P,7,72019,Regular
4JN15CS119,15CS84,47,49,96,P,10,72019,Regular
4JN15CS119,15CSP85,99,98,197,P,10,72019,Regular
4JN15CS119,15CSS86,98,0,98,P,10,72019,Regular
4JN15CS121,15CS81,20,48,68,P,7,72019,Regular
4JN15CS121,15CS832,18,45,63,P,7,72019,Regular
4JN15CS121,15CS82,20,57,77,P,8,72019,Regular
4JN15CS121,15CS84,48,47,95,P,10,72019,Regular
4JN15CS121,15CSP85,96,96,192,P,10,72019,Regular
4JN15CS121,15CSS86,96,0,96,P,10,72019,Regular
4JN16CS404,15CS81,20,50,70,P,8,72019,Regular
4JN16CS404,15CS832,17,57,74,P,8,72019,Regular
4JN16CS404,15CS82,20,53,73,P,8,72019,Regular
4JN16CS404,15CS84,47,48,95,P,10,72019,Regular
4JN16CS404,15CSP85,92,97,189,P,10,72019,Regular
4JN16CS404,15CSS86,93,0,93,P,10,72019,Regular
4JN16CS405,15CS81,20,47,67,P,7,72019,Regular
4JN16CS405,15CS832,17,48,65,P,7,72019,Regular
4JN16CS405,15CS82,20,48,68,P,7,72019,Regular
4JN16CS405,15CS84,47,46,93,P,10,72019,Regular
4JN16CS405,15CSP85,92,92,184,P,10,72019,Regular
4JN16CS405,15CSS86,94,0,94,P,10,72019,Regular
4JN16CS406,15CS81,20,52,72,P,8,72019,Regular
4JN16CS406,15CS832,17,51,68,P,7,72019,Regular
4JN16CS406,15CS82,20,51,71,P,8,72019,Regular
4JN16CS406,15CS84,48,47,95,P,10,72019,Regular
4JN16CS406,15CSP85,90,95,185,P,10,72019,Regular
4JN16CS406,15CSS86,95,0,95,P,10,72019,Regular
4JN16CS407,15CS81,20,53,73,P,8,72019,Regular
4JN16CS407,15CS832,20,46,66,P,7,72019,Regular
4JN16CS407,15CS82,20,53,73,P,8,72019,Regular
4JN16CS407,15CS84,47,48,95,P,10,72019,Regular
4JN16CS407,15CSP85,99,95,194,P,10,72019,Regular
4JN16CS407,15CSS86,96,0,96,P,10,72019,Regular
4JN16CS410,15CS81,20,57,77,P,8,72019,Regular
4JN16CS410,15CS832,19,47,66,P,7,72019,Regular
4JN16CS410,15CS82,20,64,84,P,9,72019,Regular
4JN16CS410,15CS84,48,48,96,P,10,72019,Regular
4JN16CS410,15CSP85,95,95,190,P,10,72019,Regular
4JN16CS410,15CSS86,95,0,95,P,10,72019,Regular
4JN16CS414,15CS81,20,44,64,P,7,72019,Regular
4JN16CS414,15CS832,17,51,68,P,7,72019,Regular
4JN16CS414,15CS82,19,50,69,P,7,72019,Regular
4JN16CS414,15CS84,46,47,93,P,10,72019,Regular
4JN16CS414,15CSP85,95,95,190,P,10,72019,Regular
4JN16CS414,15CSS86,93,0,93,P,10,72019,Regular
4JN16CS417,15CS81,20,40,60,P,7,72019,Regular
4JN16CS417,15CS832,18,42,60,P,7,72019,Regular
4JN16CS417,15CS82,19,52,71,P,8,72019,Regular
4JN16CS417,15CS84,47,49,96,P,10,72019,Regular
4JN16CS417,15CSP85,90,98,188,P,10,72019,Regular
4JN16CS417,15CSS86,95,0,95,P,10,72019,Regular
4JN16CS420,15CS81,19,34,53,P,6,72019,Regular
4JN16CS420,15CS832,17,37,54,P,6,72019,Regular
4JN16CS420,15CS82,20,41,61,P,7,72019,Regular
4JN16CS420,15CS84,47,48,95,P,10,72019,Regular
4JN16CS420,15CSP85,90,95,185,P,10,72019,Regular
4JN16CS420,15CSS86,95,0,95,P,10,72019,Regular
4JN16CS422,15CS81,20,43,63,P,7,72019,Regular
4JN16CS422,15CS832,18,50,68,P,7,72019,Regular
4JN16CS422,15CS82,20,63,83,P,9,72019,Regular
4JN16CS422,15CS84,48,49,97,P,10,72019,Regular
4JN16CS422,15CSP85,93,98,191,P,10,72019,Regular
4JN16CS422,15CSS86,94,0,94,P,10,72019,Regular
4JN16CS423,15CS81,18,37,55,P,6,72019,Regular
4JN16CS423,15CS832,16,38,54,P,6,72019,Regular
4JN16CS423,15CS82,20,57,77,P,8,72019,Regular
4JN16CS423,15CS84,47,48,95,P,10,72019,Regular
4JN16CS423,15CSP85,97,95,192,P,10,72019,Regular
4JN16CS423,15CSS86,93,0,93,P,10,72019,Regular
4JN14CS002,15CS61,14,28,42,P,4,72019,Regular
4JN14CS002,15CS62,16,38,54,P,6,72019,Regular
4JN14CS002,15CS63,14,28,42,P,4,72019,Regular
4JN14CS002,15CS664,12,28,40,P,4,72019,Regular
4JN14CS002,15CS654,17,48,65,P,7,72019,Regular
4JN14CS002,15CS64,13,43,56,P,6,72019,Regular
4JN14CS002,15CSL67,13,35,48,P,5,72019,Regular
4JN14CS002,15CSL68,20,60,80,P,9,72019,Regular
4JN14CS002,15CS53,12,34,46,P,5,72019,Backlog
4JN14CS092,15CS61,12,44,56,P,6,72019,Regular
4JN14CS092,15CS62,16,32,48,P,5,72019,Regular
4JN14CS092,15CS653,13,36,49,P,5,72019,Regular
4JN14CS092,15CS63,12,22,34,F,0,72019,Regular
4JN14CS092,15CS64,13,39,52,P,6,72019,Regular
4JN14CS092,15CS664,12,17,29,F,0,72019,Regular
4JN14CS092,15CSL67,13,66,79,P,8,72019,Regular
4JN14CS092,15CSL68,15,77,92,P,10,72019,Regular
4JN14CS092,15CS52,15,28,43,P,4,72019,Backlog
4JN14CS092,15CS553,13,33,46,P,5,72019,Backlog
4JN14CS092,15CS53,12,8,20,F,0,72019,Backlog
4JN14CS092,15CS45,12,31,43,P,4,72019,Backlog
4JN14CS133,15CS61,18,50,68,P,7,72019,Regular
4JN14CS133,15CS62,12,35,47,P,5,72019,Regular
4JN14CS133,15CS653,13,36,49,P,5,72019,Regular
4JN14CS133,15CS63,16,39,55,P,6,72019,Regular
4JN14CS133,15CS664,16,34,50,P,6,72019,Regular
4JN14CS133,15CS64,14,35,49,P,5,72019,Regular
4JN14CS133,15CSL67,17,35,52,P,6,72019,Regular
4JN14CS133,15CSL68,16,42,58,P,6,72019,Regular
4JN14CS133,15CS36,16,0,16,A,0,72019,Backlog
4JN15CS025,15CS61,14,39,53,P,6,72019,Regular
4JN15CS025,15CS62,12,32,44,P,4,72019,Regular
4JN15CS025,15CS653,16,34,50,P,6,72019,Regular
4JN15CS025,15CS63,14,21,35,F,0,72019,Regular
4JN15CS025,15CS664,12,31,43,P,4,72019,Regular
4JN15CS025,15CS64,12,37,49,P,5,72019,Regular
4JN15CS025,15CSL67,18,42,60,P,7,72019,Regular
4JN15CS025,15CSL68,14,50,64,P,7,72019,Regular
4JN15CS041,15CS61,16,42,58,P,6,72019,Regular
4JN15CS041,15CS62,15,28,43,P,4,72019,Regular
4JN15CS041,15CS653,14,37,51,P,6,72019,Regular
4JN15CS041,15CS63,13,28,41,P,4,72019,Regular
4JN15CS041,15CS664,12,28,40,P,4,72019,Regular
4JN15CS041,15CS64,15,37,52,P,6,72019,Regular
4JN15CS041,15CSL67,17,47,64,P,7,72019,Regular
4JN15CS041,15CSL68,16,48,64,P,7,72019,Regular
4JN15CS041,15CS53,15,17,32,F,0,72019,Backlog
4JN15CS041,15CS553,14,49,63,P,7,72019,Backlog
4JN15CS049,15CS61,14,28,42,P,4,72019,Regular
4JN15CS049,15CS62,16,35,51,P,6,72019,Regular
4JN15CS049,15CS653,14,35,49,P,5,72019,Regular
4JN15CS049,15CS63,12,35,47,P,5,72019,Regular
4JN15CS049,15CS664,12,14,26,F,0,72019,Regular
4JN15CS049,15CS64,14,40,54,P,6,72019,Regular
4JN15CS049,15CSL67,13,66,79,P,8,72019,Regular
4JN15CS049,15CSL68,15,74,89,P,9,72019,Regular
4JN15CS049,15CS553,13,35,48,P,5,72019,Backlog
4JN15CS049,15CSL57,19,40,59,P,6,72019,Backlog
4JN15CS049,15MAT41,14,21,35,F,0,72019,Backlog
4JN15CS049,15MAT21,12,28,40,P,4,72019,Backlog
4JN15CS067,15CS61,14,39,53,P,6,72019,Regular
4JN15CS067,15CS62,14,33,47,P,5,72019,Regular
4JN15CS067,15CS653,14,31,45,P,5,72019,Regular
4JN15CS067,15CS63,13,31,44,P,4,72019,Regular
4JN15CS067,15CS664,13,28,41,P,4,72019,Regular
4JN15CS067,15CS64,13,39,52,P,6,72019,Regular
4JN15CS067,15CSL67,16,35,51,P,6,72019,Regular
4JN15CS067,15CSL68,15,33,48,P,5,72019,Regular
4JN15CS067,15CS564,15,39,54,P,6,72019,Backlog
4JN16CS001,15CS61,20,35,55,P,6,72019,Regular
4JN16CS001,15CS62,18,43,61,P,7,72019,Regular
4JN16CS001,15CS653,16,52,68,P,7,72019,Regular
4JN16CS001,15CS63,16,28,44,P,4,72019,Regular
4JN16CS001,15CS664,19,40,59,P,6,72019,Regular
4JN16CS001,15CS64,19,42,61,P,7,72019,Regular
4JN16CS001,15CSL67,20,68,88,P,9,72019,Regular
4JN16CS001,15CSL68,20,55,75,P,8,72019,Regular
4JN16CS003,15CS61,14,51,65,P,7,72019,Regular
4JN16CS003,15CS62,14,32,46,P,5,72019,Regular
4JN16CS003,15CS63,14,32,46,P,5,72019,Regular
4JN16CS003,15CS664,12,45,57,P,6,72019,Regular
4JN16CS003,15CS654,15,54,69,P,7,72019,Regular
4JN16CS003,15CS64,13,62,75,P,8,72019,Regular
4JN16CS003,15CSL67,16,33,49,P,5,72019,Regular
4JN16CS003,15CSL68,15,32,47,P,5,72019,Regular
4JN16CS005,15CS61,18,48,66,P,7,72019,Regular
4JN16CS005,15CS62,17,28,45,P,5,72019,Regular
4JN16CS005,15CS63,15,35,50,P,6,72019,Regular
4JN16CS005,15CS654,19,41,60,P,7,72019,Regular
4JN16CS005,15CS64,16,36,52,P,6,72019,Regular
4JN16CS005,15CS664,15,48,63,P,7,72019,Regular
4JN16CS005,15CSL67,16,35,51,P,6,72019,Regular
4JN16CS005,15CSL68,18,50,68,P,7,72019,Regular
4JN16CS006,15CS61,18,61,79,P,8,72019,Regular
4JN16CS006,15CS62,18,43,61,P,7,72019,Regular
4JN16CS006,15CS653,17,64,81,P,9,72019,Regular
4JN16CS006,15CS63,18,58,76,P,8,72019,Regular
4JN16CS006,15CS664,19,36,55,P,6,72019,Regular
4JN16CS006,15CS64,19,44,63,P,7,72019,Regular
4JN16CS006,15CSL67,18,60,78,P,8,72019,Regular
4JN16CS006,15CSL68,19,70,89,P,9,72019,Regular
4JN16CS007,15CS61,20,50,70,P,8,72019,Regular
4JN16CS007,15CS62,19,43,62,P,7,72019,Regular
4JN16CS007,15CS653,19,51,70,P,8,72019,Regular
4JN16CS007,15CS63,20,37,57,P,6,72019,Regular
4JN16CS007,15CS664,19,42,61,P,7,72019,Regular
4JN16CS007,15CS64,18,49,67,P,7,72019,Regular
4JN16CS007,15CSL67,18,74,92,P,10,72019,Regular
4JN16CS007,15CSL68,20,75,95,P,10,72019,Regular
4JN16CS008,15CS61,20,67,87,P,9,72019,Regular
4JN16CS008,15CS62,18,62,80,P,9,72019,Regular
4JN16CS008,15CS653,19,67,86,P,9,72019,Regular
4JN16CS008,15CS63,15,50,65,P,7,72019,Regular
4JN16CS008,15CS664,18,33,51,P,6,72019,Regular
4JN16CS008,15CS64,18,64,82,P,9,72019,Regular
4JN16CS008,15CSL67,19,73,92,P,10,72019,Regular
4JN16CS008,15CSL68,20,78,98,P,10,72019,Regular
4JN16CS009,15CS61,12,46,58,P,6,72019,Regular
4JN16CS009,15CS62,14,45,59,P,6,72019,Regular
4JN16CS009,15CS653,12,53,65,P,7,72019,Regular
4JN16CS009,15CS63,15,33,48,P,5,72019,Regular
4JN16CS009,15CS664,15,33,48,P,5,72019,Regular
4JN16CS009,15CS64,13,48,61,P,7,72019,Regular
4JN16CS009,15CSL67,14,32,46,P,5,72019,Regular
4JN16CS009,15CSL68,19,62,81,P,9,72019,Regular
4JN16CS010,15CS61,19,66,85,P,9,72019,Regular
4JN16CS010,15CS62,19,44,63,P,7,72019,Regular
4JN16CS010,15CS653,19,41,60,P,7,72019,Regular
4JN16CS010,15CS63,19,38,57,P,6,72019,Regular
4JN16CS010,15CS664,20,59,79,P,8,72019,Regular
4JN16CS010,15CS64,20,67,87,P,9,72019,Regular
4JN16CS010,15CSL67,20,78,98,P,10,72019,Regular
4JN16CS010,15CSL68,20,79,99,P,10,72019,Regular
4JN16CS011,15CS61,20,67,87,P,9,72019,Regular
4JN16CS011,15CS62,20,58,78,P,8,72019,Regular
4JN16CS011,15CS653,20,70,90,P,10,72019,Regular
4JN16CS011,15CS63,19,53,72,P,8,72019,Regular
4JN16CS011,15CS664,20,41,61,P,7,72019,Regular
4JN16CS011,15CS64,20,71,91,P,10,72019,Regular
4JN16CS011,15CSL67,19,78,97,P,10,72019,Regular
4JN16CS011,15CSL68,20,78,98,P,10,72019,Regular
4JN16CS012,15CS61,19,54,73,P,8,72019,Regular
4JN16CS012,15CS62,19,43,62,P,7,72019,Regular
4JN16CS012,15CS653,18,58,76,P,8,72019,Regular
4JN16CS012,15CS63,17,36,53,P,6,72019,Regular
4JN16CS012,15CS64,19,52,71,P,8,72019,Regular
4JN16CS012,15CS664,16,54,70,P,8,72019,Regular
4JN16CS012,15CSL67,18,73,91,P,10,72019,Regular
4JN16CS012,15CSL68,20,68,88,P,9,72019,Regular
4JN16CS013,15CS61,18,54,72,P,8,72019,Regular
4JN16CS013,15CS62,20,58,78,P,8,72019,Regular
4JN16CS013,15CS653,18,42,60,P,7,72019,Regular
4JN16CS013,15CS63,17,30,47,P,5,72019,Regular
4JN16CS013,15CS64,19,57,76,P,8,72019,Regular
4JN16CS013,15CS664,17,43,60,P,7,72019,Regular
4JN16CS013,15CSL67,19,75,94,P,10,72019,Regular
4JN16CS013,15CSL68,18,77,95,P,10,72019,Regular
4JN16CS014,15CS61,20,59,79,P,8,72019,Regular
4JN16CS014,15CS62,20,45,65,P,7,72019,Regular
4JN16CS014,15CS63,20,56,76,P,8,72019,Regular
4JN16CS014,15CS653,20,62,82,P,9,72019,Regular
4JN16CS014,15CS664,20,64,84,P,9,72019,Regular
4JN16CS014,15CS64,20,68,88,P,9,72019,Regular
4JN16CS014,15CSL67,20,78,98,P,10,72019,Regular
4JN16CS014,15CSL68,20,78,98,P,10,72019,Regular
4JN16CS015,15CS61,13,37,50,P,6,72019,Regular
4JN16CS015,15CS62,13,29,42,P,4,72019,Regular
4JN16CS015,15CS63,14,32,46,P,5,72019,Regular
4JN16CS015,15CS653,16,46,62,P,7,72019,Regular
4JN16CS015,15CS664,16,28,44,P,4,72019,Regular
4JN16CS015,15CS64,14,36,50,P,6,72019,Regular
4JN16CS015,15CSL67,18,50,68,P,7,72019,Regular
4JN16CS015,15CSL68,17,62,79,P,8,72019,Regular
4JN16CS016,15CS61,19,49,68,P,7,72019,Regular
4JN16CS016,15CS62,20,45,65,P,7,72019,Regular
4JN16CS016,15CS653,20,50,70,P,8,72019,Regular
4JN16CS016,15CS63,19,58,77,P,8,72019,Regular
4JN16CS016,15CS664,19,29,48,P,5,72019,Regular
4JN16CS016,15CS64,20,64,84,P,9,72019,Regular
4JN16CS016,15CSL67,20,73,93,P,10,72019,Regular
4JN16CS016,15CSL68,20,79,99,P,10,72019,Regular
4JN16CS017,15CS61,17,41,58,P,6,72019,Regular
4JN16CS017,15CS62,17,48,65,P,7,72019,Regular
4JN16CS017,15CS63,12,29,41,P,4,72019,Regular
4JN16CS017,15CS64,14,51,65,P,7,72019,Regular
4JN16CS017,15CS664,18,37,55,P,6,72019,Regular
4JN16CS017,15CS654,15,45,60,P,7,72019,Regular
4JN16CS017,15CSL67,16,32,48,P,5,72019,Regular
4JN16CS017,15CSL68,16,66,82,P,9,72019,Regular
4JN16CS018,15CS61,18,52,70,P,8,72019,Regular
4JN16CS018,15CS62,19,42,61,P,7,72019,Regular
4JN16CS018,15CS653,14,50,64,P,7,72019,Regular
4JN16CS018,15CS63,16,35,51,P,6,72019,Regular
4JN16CS018,15CS664,16,29,45,P,5,72019,Regular
4JN16CS018,15CS64,19,44,63,P,7,72019,Regular
4JN16CS018,15CSL67,17,78,95,P,10,72019,Regular
4JN16CS018,15CSL68,16,74,90,P,10,72019,Regular
4JN16CS019,15CS61,20,58,78,P,8,72019,Regular
4JN16CS019,15CS62,20,58,78,P,8,72019,Regular
4JN16CS019,15CS653,18,67,85,P,9,72019,Regular
4JN16CS019,15CS63,18,44,62,P,7,72019,Regular
4JN16CS019,15CS664,20,65,85,P,9,72019,Regular
4JN16CS019,15CS64,20,47,67,P,7,72019,Regular
4JN16CS019,15CSL67,20,77,97,P,10,72019,Regular
4JN16CS019,15CSL68,20,73,93,P,10,72019,Regular
4JN16CS020,15CS61,18,40,58,P,6,72019,Regular
4JN16CS020,15CS62,19,34,53,P,6,72019,Regular
4JN16CS020,15CS653,20,62,82,P,9,72019,Regular
4JN16CS020,15CS63,17,32,49,P,5,72019,Regular
4JN16CS020,15CS64,16,32,48,P,5,72019,Regular
4JN16CS020,15CS664,15,28,43,P,4,72019,Regular
4JN16CS020,15CSL67,18,74,92,P,10,72019,Regular
4JN16CS020,15CSL68,20,79,99,P,10,72019,Regular
4JN16CS021,15CS61,18,53,71,P,8,72019,Regular
4JN16CS021,15CS62,18,35,53,P,6,72019,Regular
4JN16CS021,15CS63,16,37,53,P,6,72019,Regular
4JN16CS021,15CS653,17,66,83,P,9,72019,Regular
4JN16CS021,15CS664,16,52,68,P,7,72019,Regular
4JN16CS021,15CS64,19,66,85,P,9,72019,Regular
4JN16CS021,15CSL67,19,70,89,P,9,72019,Regular
4JN16CS021,15CSL68,18,76,94,P,10,72019,Regular
4JN16CS022,15CS61,20,35,55,P,6,72019,Regular
4JN16CS022,15CS62,20,39,59,P,6,72019,Regular
4JN16CS022,15CS653,19,57,76,P,8,72019,Regular
4JN16CS022,15CS63,19,40,59,P,6,72019,Regular
4JN16CS022,15CS664,20,37,57,P,6,72019,Regular
4JN16CS022,15CS64,18,49,67,P,7,72019,Regular
4JN16CS022,15CSL67,20,79,99,P,10,72019,Regular
4JN16CS022,15CSL68,20,76,96,P,10,72019,Regular
4JN16CS023,15CS61,20,57,77,P,8,72019,Regular
4JN16CS023,15CS62,20,49,69,P,7,72019,Regular
4JN16CS023,15CS653,20,66,86,P,9,72019,Regular
4JN16CS023,15CS63,20,53,73,P,8,72019,Regular
4JN16CS023,15CS64,20,48,68,P,7,72019,Regular
4JN16CS023,15CS664,20,49,69,P,7,72019,Regular
4JN16CS023,15CSL67,19,74,93,P,10,72019,Regular
4JN16CS023,15CSL68,20,79,99,P,10,72019,Regular
4JN16CS024,15CS61,19,48,67,P,7,72019,Regular
4JN16CS024,15CS62,20,28,48,P,5,72019,Regular
4JN16CS024,15CS653,19,51,70,P,8,72019,Regular
4JN16CS024,15CS63,19,36,55,P,6,72019,Regular
4JN16CS024,15CS664,19,32,51,P,6,72019,Regular
4JN16CS024,15CS64,19,45,64,P,7,72019,Regular
4JN16CS024,15CSL67,20,75,95,P,10,72019,Regular
4JN16CS024,15CSL68,20,72,92,P,10,72019,Regular
4JN16CS026,15CS61,16,43,59,P,6,72019,Regular
4JN16CS026,15CS62,14,23,37,F,0,72019,Regular
4JN16CS026,15CS63,13,30,43,P,4,72019,Regular
4JN16CS026,15CS654,15,0,15,A,0,72019,Regular
4JN16CS026,15CS64,14,0,14,A,0,72019,Regular
4JN16CS026,15CS664,13,0,13,A,0,72019,Regular
4JN16CS026,15CSL67,13,22,35,F,0,72019,Regular
4JN16CS026,15CSL68,15,32,47,P,5,72019,Regular
4JN16CS026,15CSL57,17,33,50,P,6,72019,Backlog
4JN16CS027,15CS61,20,53,73,P,8,72019,Regular
4JN16CS027,15CS62,19,49,68,P,7,72019,Regular
4JN16CS027,15CS653,19,50,69,P,7,72019,Regular
4JN16CS027,15CS63,18,64,82,P,9,72019,Regular
4JN16CS027,15CS64,17,55,72,P,8,72019,Regular
4JN16CS027,15CS664,20,50,70,P,8,72019,Regular
4JN16CS027,15CSL67,20,75,95,P,10,72019,Regular
4JN16CS027,15CSL68,20,65,85,P,9,72019,Regular
4JN16CS028,15CS61,20,60,80,P,9,72019,Regular
4JN16CS028,15CS62,20,31,51,P,6,72019,Regular
4JN16CS028,15CS653,20,64,84,P,9,72019,Regular
4JN16CS028,15CS63,20,57,77,P,8,72019,Regular
4JN16CS028,15CS664,19,47,66,P,7,72019,Regular
4JN16CS028,15CS64,20,65,85,P,9,72019,Regular
4JN16CS028,15CSL67,20,77,97,P,10,72019,Regular
4JN16CS028,15CSL68,20,79,99,P,10,72019,Regular
4JN16CS029,15CS61,19,47,66,P,7,72019,Regular
4JN16CS029,15CS62,20,44,64,P,7,72019,Regular
4JN16CS029,15CS653,20,52,72,P,8,72019,Regular
4JN16CS029,15CS63,18,43,61,P,7,72019,Regular
4JN16CS029,15CS664,20,34,54,P,6,72019,Regular
4JN16CS029,15CS64,20,48,68,P,7,72019,Regular
4JN16CS029,15CSL67,20,74,94,P,10,72019,Regular
4JN16CS029,15CSL68,20,75,95,P,10,72019,Regular
4JN16CS030,15CS61,20,57,77,P,8,72019,Regular
4JN16CS030,15CS62,20,47,67,P,7,72019,Regular
4JN16CS030,15CS653,19,55,74,P,8,72019,Regular
4JN16CS030,15CS63,19,37,56,P,6,72019,Regular
4JN16CS030,15CS664,19,67,86,P,9,72019,Regular
4JN16CS030,15CS64,20,66,86,P,9,72019,Regular
4JN16CS030,15CSL67,20,70,90,P,10,72019,Regular
4JN16CS030,15CSL68,20,79,99,P,10,72019,Regular
4JN16CS031,15CS61,19,52,71,P,8,72019,Regular
4JN16CS031,15CS62,17,43,60,P,7,72019,Regular
4JN16CS031,15CS653,14,35,49,P,5,72019,Regular
4JN16CS031,15CS63,16,31,47,P,5,72019,Regular
4JN16CS031,15CS664,15,39,54,P,6,72019,Regular
4JN16CS031,15CS64,16,43,59,P,6,72019,Regular
4JN16CS031,15CSL67,17,32,49,P,5,72019,Regular
4JN16CS031,15CSL68,18,58,76,P,8,72019,Regular
4JN16CS032,15CS61,19,46,65,P,7,72019,Regular
4JN16CS032,15CS62,20,46,66,P,7,72019,Regular
4JN16CS032,15CS63,17,36,53,P,6,72019,Regular
4JN16CS032,15CS653,18,58,76,P,8,72019,Regular
4JN16CS032,15CS664,15,51,66,P,7,72019,Regular
4JN16CS032,15CS64,18,41,59,P,6,72019,Regular
4JN16CS032,15CSL67,18,64,82,P,9,72019,Regular
4JN16CS032,15CSL68,18,62,80,P,9,72019,Regular
4JN16CS033,15CS61,20,66,86,P,9,72019,Regular
4JN16CS033,15CS62,20,50,70,P,8,72019,Regular
4JN16CS033,15CS653,19,73,92,P,10,72019,Regular
4JN16CS033,15CS63,20,49,69,P,7,72019,Regular
4JN16CS033,15CS664,20,44,64,P,7,72019,Regular
4JN16CS033,15CS64,19,60,79,P,8,72019,Regular
4JN16CS033,15CSL67,20,79,99,P,10,72019,Regular
4JN16CS033,15CSL68,20,79,99,P,10,72019,Regular
4JN16CS034,15CS61,18,54,72,P,8,72019,Regular
4JN16CS034,15CS62,19,43,62,P,7,72019,Regular
4JN16CS034,15CS653,18,57,75,P,8,72019,Regular
4JN16CS034,15CS63,16,46,62,P,7,72019,Regular
4JN16CS034,15CS664,17,55,72,P,8,72019,Regular
4JN16CS034,15CS64,17,47,64,P,7,72019,Regular
4JN16CS034,15CSL67,19,78,97,P,10,72019,Regular
4JN16CS034,15CSL68,16,65,81,P,9,72019,Regular
4JN16CS035,15CS61,19,51,70,P,8,72019,Regular
4JN16CS035,15CS62,18,31,49,P,5,72019,Regular
4JN16CS035,15CS653,17,53,70,P,8,72019,Regular
4JN16CS035,15CS63,17,39,56,P,6,72019,Regular
4JN16CS035,15CS64,16,42,58,P,6,72019,Regular
4JN16CS035,15CS664,19,43,62,P,7,72019,Regular
4JN16CS035,15CSL67,18,50,68,P,7,72019,Regular
4JN16CS035,15CSL68,18,60,78,P,8,72019,Regular
4JN16CS036,15CS61,15,47,62,P,7,72019,Regular
4JN16CS036,15CS62,15,42,57,P,6,72019,Regular
4JN16CS036,15CS653,13,52,65,P,7,72019,Regular
4JN16CS036,15CS63,13,38,51,P,6,72019,Regular
4JN16CS036,15CS64,13,44,57,P,6,72019,Regular
4JN16CS036,15CS664,12,36,48,P,5,72019,Regular
4JN16CS036,15CSL67,17,40,57,P,6,72019,Regular
4JN16CS036,15CSL68,14,60,74,P,8,72019,Regular
4JN16CS037,15CS61,18,53,71,P,8,72019,Regular
4JN16CS037,15CS62,19,42,61,P,7,72019,Regular
4JN16CS037,15CS653,18,45,63,P,7,72019,Regular
4JN16CS037,15CS63,15,37,52,P,6,72019,Regular
4JN16CS037,15CS664,16,42,58,P,6,72019,Regular
4JN16CS037,15CS64,18,44,62,P,7,72019,Regular
4JN16CS037,15CSL67,19,77,96,P,10,72019,Regular
4JN16CS037,15CSL68,20,78,98,P,10,72019,Regular
4JN16CS038,15CS61,17,47,64,P,7,72019,Regular
4JN16CS038,15CS62,19,55,74,P,8,72019,Regular
4JN16CS038,15CS653,17,74,91,P,10,72019,Regular
4JN16CS038,15CS63,18,45,63,P,7,72019,Regular
4JN16CS038,15CS664,18,52,70,P,8,72019,Regular
4JN16CS038,15CS64,17,50,67,P,7,72019,Regular
4JN16CS038,15CSL67,20,56,76,P,8,72019,Regular
4JN16CS038,15CSL68,20,76,96,P,10,72019,Regular
4JN16CS039,15CS61,17,46,63,P,7,72019,Regular
4JN16CS039,15CS62,19,28,47,P,5,72019,Regular
4JN16CS039,15CS653,13,49,62,P,7,72019,Regular
4JN16CS039,15CS63,15,28,43,P,4,72019,Regular
4JN16CS039,15CS664,15,28,43,P,4,72019,Regular
4JN16CS039,15CS64,14,43,57,P,6,72019,Regular
4JN16CS039,15CSL67,17,75,92,P,10,72019,Regular
4JN16CS039,15CSL68,17,60,77,P,8,72019,Regular
4JN16CS040,15CS61,16,32,48,P,5,72019,Regular
4JN16CS040,15CS62,14,22,36,F,0,72019,Regular
4JN16CS040,15CS63,14,19,33,F,0,72019,Regular
4JN16CS040,15CS653,15,0,15,A,0,72019,Regular
4JN16CS040,15CS64,13,0,13,A,0,72019,Regular
4JN16CS040,15CS664,13,0,13,A,0,72019,Regular
4JN16CS040,15CSL67,18,77,95,P,10,72019,Regular
4JN16CS040,15CSL68,20,71,91,P,10,72019,Regular
4JN16CS041,15CS61,17,41,58,P,6,72019,Regular
4JN16CS041,15CS62,15,42,57,P,6,72019,Regular
4JN16CS041,15CS63,16,28,44,P,4,72019,Regular
4JN16CS041,15CS654,18,52,70,P,8,72019,Regular
4JN16CS041,15CS664,12,39,51,P,6,72019,Regular
4JN16CS041,15CS64,16,47,63,P,7,72019,Regular
4JN16CS041,15CSL67,17,71,88,P,9,72019,Regular
4JN16CS041,15CSL68,20,56,76,P,8,72019,Regular
4JN16CS042,15CS61,20,56,76,P,8,72019,Regular
4JN16CS042,15CS62,18,47,65,P,7,72019,Regular
4JN16CS042,15CS653,18,64,82,P,9,72019,Regular
4JN16CS042,15CS63,16,60,76,P,8,72019,Regular
4JN16CS042,15CS64,17,47,64,P,7,72019,Regular
4JN16CS042,15CS664,18,44,62,P,7,72019,Regular
4JN16CS042,15CSL67,18,60,78,P,8,72019,Regular
4JN16CS042,15CSL68,18,70,88,P,9,72019,Regular
4JN16CS044,15CS61,20,35,55,P,6,72019,Regular
4JN16CS044,15CS62,20,60,80,P,9,72019,Regular
4JN16CS044,15CS63,18,41,59,P,6,72019,Regular
4JN16CS044,15CS664,17,46,63,P,7,72019,Regular
4JN16CS044,15CS654,19,67,86,P,9,72019,Regular
4JN16CS044,15CS64,19,39,58,P,6,72019,Regular
4JN16CS044,15CSL67,20,77,97,P,10,72019,Regular
4JN16CS044,15CSL68,20,76,96,P,10,72019,Regular
4JN16CS045,15CS61,15,49,64,P,7,72019,Regular
4JN16CS045,15CS62,13,36,49,P,5,72019,Regular
4JN16CS045,15CS63,12,28,40,P,4,72019,Regular
4JN16CS045,15CS664,14,28,42,P,4,72019,Regular
4JN16CS045,15CS654,14,44,58,P,6,72019,Regular
4JN16CS045,15CS64,12,18,30,F,0,72019,Regular
4JN16CS045,15CSL67,18,32,50,P,6,72019,Regular
4JN16CS045,15CSL68,17,40,57,P,6,72019,Regular
4JN16CS045,15CS51,16,18,34,F,0,72019,Backlog
4JN16CS045,15CSL57,17,32,49,P,5,72019,Backlog
4JN16CS046,15CS61,17,53,70,P,8,72019,Regular
4JN16CS046,15CS62,14,45,59,P,6,72019,Regular
4JN16CS046,15CS63,17,34,51,P,6,72019,Regular
4JN16CS046,15CS653,16,63,79,P,8,72019,Regular
4JN16CS046,15CS664,17,34,51,P,6,72019,Regular
4JN16CS046,15CS64,15,53,68,P,7,72019,Regular
4JN16CS046,15CSL67,19,75,94,P,10,72019,Regular
4JN16CS046,15CSL68,20,68,88,P,9,72019,Regular
4JN16CS047,15CS61,18,53,71,P,8,72019,Regular
4JN16CS047,15CS62,17,28,45,P,5,72019,Regular
4JN16CS047,15CS653,14,44,58,P,6,72019,Regular
4JN16CS047,15CS63,17,50,67,P,7,72019,Regular
4JN16CS047,15CS664,17,51,68,P,7,72019,Regular
4JN16CS047,15CS64,16,50,66,P,7,72019,Regular
4JN16CS047,15CSL67,14,42,56,P,6,72019,Regular
4JN16CS047,15CSL68,17,43,60,P,7,72019,Regular
4JN16CS048,15CS61,19,49,68,P,7,72019,Regular
4JN16CS048,15CS62,19,41,60,P,7,72019,Regular
4JN16CS048,15CS653,17,59,76,P,8,72019,Regular
4JN16CS048,15CS63,20,42,62,P,7,72019,Regular
4JN16CS048,15CS64,18,53,71,P,8,72019,Regular
4JN16CS048,15CS664,20,52,72,P,8,72019,Regular
4JN16CS048,15CSL67,16,77,93,P,10,72019,Regular
4JN16CS048,15CSL68,20,76,96,P,10,72019,Regular
4JN16CS049,15CS61,20,49,69,P,7,72019,Regular
4JN16CS049,15CS62,16,32,48,P,5,72019,Regular
4JN16CS049,15CS653,14,31,45,P,5,72019,Regular
4JN16CS049,15CS63,14,30,44,P,4,72019,Regular
4JN16CS049,15CS664,19,35,54,P,6,72019,Regular
4JN16CS049,15CS64,12,54,66,P,7,72019,Regular
4JN16CS049,15CSL67,17,32,49,P,5,72019,Regular
4JN16CS049,15CSL68,16,48,64,P,7,72019,Regular
4JN16CS049,15CSL57,17,34,51,P,6,72019,Backlog
4JN16CS049,15MAT31,12,22,34,F,0,72019,Backlog
4JN16CS051,15CS61,20,69,89,P,9,72019,Regular
4JN16CS051,15CS62,20,51,71,P,8,72019,Regular
4JN16CS051,15CS653,20,67,87,P,9,72019,Regular
4JN16CS051,15CS63,16,50,66,P,7,72019,Regular
4JN16CS051,15CS664,19,60,79,P,8,72019,Regular
4JN16CS051,15CS64,19,58,77,P,8,72019,Regular
4JN16CS051,15CSL67,20,76,96,P,10,72019,Regular
4JN16CS051,15CSL68,20,76,96,P,10,72019,Regular
4JN16CS052,15CS61,17,32,49,P,5,72019,Regular
4JN16CS052,15CS62,16,40,56,P,6,72019,Regular
4JN16CS052,15CS653,17,42,59,P,6,72019,Regular
4JN16CS052,15CS63,19,35,54,P,6,72019,Regular
4JN16CS052,15CS64,15,44,59,P,6,72019,Regular
4JN16CS052,15CS664,15,28,43,P,4,72019,Regular
4JN16CS052,15CSL67,17,70,87,P,9,72019,Regular
4JN16CS052,15CSL68,18,55,73,P,8,72019,Regular
4JN16CS052,15CS53,13,29,42,P,4,72019,Backlog
4JN16CS052,15CS44,13,0,13,A,0,72019,Backlog
4JN16CS052,15CS45,14,35,49,P,5,72019,Backlog
4JN16CS053,15CS61,20,49,69,P,7,72019,Regular
4JN16CS053,15CS62,20,50,70,P,8,72019,Regular
4JN16CS053,15CS653,20,63,83,P,9,72019,Regular
4JN16CS053,15CS63,20,37,57,P,6,72019,Regular
4JN16CS053,15CS64,20,45,65,P,7,72019,Regular
4JN16CS053,15CS664,20,51,71,P,8,72019,Regular
4JN16CS053,15CSL67,20,79,99,P,10,72019,Regular
4JN16CS053,15CSL68,20,79,99,P,10,72019,Regular
4JN16CS054,15CS61,20,60,80,P,9,72019,Regular
4JN16CS054,15CS62,20,56,76,P,8,72019,Regular
4JN16CS054,15CS63,19,37,56,P,6,72019,Regular
4JN16CS054,15CS653,18,65,83,P,9,72019,Regular
4JN16CS054,15CS664,16,53,69,P,7,72019,Regular
4JN16CS054,15CS64,20,49,69,P,7,72019,Regular
4JN16CS054,15CSL67,20,50,70,P,8,72019,Regular
4JN16CS054,15CSL68,20,75,95,P,10,72019,Regular
4JN16CS055,15CS61,20,49,69,P,7,72019,Regular
4JN16CS055,15CS62,17,42,59,P,6,72019,Regular
4JN16CS055,15CS653,18,38,56,P,6,72019,Regular
4JN16CS055,15CS63,15,46,61,P,7,72019,Regular
4JN16CS055,15CS664,17,42,59,P,6,72019,Regular
4JN16CS055,15CS64,18,35,53,P,6,72019,Regular
4JN16CS055,15CSL67,18,70,88,P,9,72019,Regular
4JN16CS055,15CSL68,18,40,58,P,6,72019,Regular
4JN16CS056,15CS61,16,42,58,P,6,72019,Regular
4JN16CS056,15CS62,18,49,67,P,7,72019,Regular
4JN16CS056,15CS653,14,53,67,P,7,72019,Regular
4JN16CS056,15CS63,17,28,45,P,5,72019,Regular
4JN16CS056,15CS664,17,37,54,P,6,72019,Regular
4JN16CS056,15CS64,16,39,55,P,6,72019,Regular
4JN16CS056,15CSL67,18,32,50,P,6,72019,Regular
4JN16CS056,15CSL68,16,62,78,P,8,72019,Regular
4JN16CS056,15CS553,12,56,68,P,7,72019,Backlog
4JN16CS057,15CS61,15,44,59,P,6,72019,Regular
4JN16CS057,15CS62,16,42,58,P,6,72019,Regular
4JN16CS057,15CS653,16,51,67,P,7,72019,Regular
4JN16CS057,15CS63,17,47,64,P,7,72019,Regular
4JN16CS057,15CS664,16,50,66,P,7,72019,Regular
4JN16CS057,15CS64,16,48,64,P,7,72019,Regular
4JN16CS057,15CSL67,18,73,91,P,10,72019,Regular
4JN16CS057,15CSL68,20,50,70,P,8,72019,Regular
4JN16CS058,15CS61,19,53,72,P,8,72019,Regular
4JN16CS058,15CS62,19,33,52,P,6,72019,Regular
4JN16CS058,15CS653,20,57,77,P,8,72019,Regular
4JN16CS058,15CS63,19,37,56,P,6,72019,Regular
4JN16CS058,15CS664,20,29,49,P,5,72019,Regular
4JN16CS058,15CS64,17,41,58,P,6,72019,Regular
4JN16CS058,15CSL67,18,77,95,P,10,72019,Regular
4JN16CS058,15CSL68,20,70,90,P,10,72019,Regular
4JN16CS059,15CS61,19,52,71,P,8,72019,Regular
4JN16CS059,15CS62,19,53,72,P,8,72019,Regular
4JN16CS059,15CS653,19,56,75,P,8,72019,Regular
4JN16CS059,15CS63,17,42,59,P,6,72019,Regular
4JN16CS059,15CS64,18,63,81,P,9,72019,Regular
4JN16CS059,15CS664,17,40,57,P,6,72019,Regular
4JN16CS059,15CSL67,19,71,90,P,10,72019,Regular
4JN16CS059,15CSL68,18,77,95,P,10,72019,Regular
4JN16CS060,15CS61,18,52,70,P,8,72019,Regular
4JN16CS060,15CS62,16,46,62,P,7,72019,Regular
4JN16CS060,15CS63,14,60,74,P,8,72019,Regular
4JN16CS060,15CS653,17,59,76,P,8,72019,Regular
4JN16CS060,15CS664,13,41,54,P,6,72019,Regular
4JN16CS060,15CS64,16,34,50,P,6,72019,Regular
4JN16CS060,15CSL67,17,35,52,P,6,72019,Regular
4JN16CS060,15CSL68,20,68,88,P,9,72019,Regular
4JN16CS061,15CS61,20,67,87,P,9,72019,Regular
4JN16CS061,15CS62,20,35,55,P,6,72019,Regular
4JN16CS061,15CS653,19,75,94,P,10,72019,Regular
4JN16CS061,15CS63,20,49,69,P,7,72019,Regular
4JN16CS061,15CS664,20,52,72,P,8,72019,Regular
4JN16CS061,15CS64,19,58,77,P,8,72019,Regular
4JN16CS061,15CSL67,20,79,99,P,10,72019,Regular
4JN16CS061,15CSL68,20,78,98,P,10,72019,Regular
4JN16CS062,15CS61,18,40,58,P,6,72019,Regular
4JN16CS062,15CS62,15,32,47,P,5,72019,Regular
4JN16CS062,15CS63,15,28,43,P,4,72019,Regular
4JN16CS062,15CS653,14,38,52,P,6,72019,Regular
4JN16CS062,15CS64,14,28,42,P,4,72019,Regular
4JN16CS062,15CS664,16,28,44,P,4,72019,Regular
4JN16CS062,15CSL67,20,77,97,P,10,72019,Regular
4JN16CS062,15CSL68,16,70,86,P,9,72019,Regular
4JN16CS062,15CS564,16,28,44,P,4,72019,Backlog
4JN16CS063,15CS61,18,51,69,P,7,72019,Regular
4JN16CS063,15CS62,19,57,76,P,8,72019,Regular
4JN16CS063,15CS63,16,32,48,P,5,72019,Regular
4JN16CS063,15CS653,18,63,81,P,9,72019,Regular
4JN16CS063,15CS64,16,42,58,P,6,72019,Regular
4JN16CS063,15CS664,19,53,72,P,8,72019,Regular
4JN16CS063,15CSL67,18,52,70,P,8,72019,Regular
4JN16CS063,15CSL68,18,60,78,P,8,72019,Regular
4JN16CS064,15CS61,20,53,73,P,8,72019,Regular
4JN16CS064,15CS62,20,42,62,P,7,72019,Regular
4JN16CS064,15CS653,19,44,63,P,7,72019,Regular
4JN16CS064,15CS63,19,45,64,P,7,72019,Regular
4JN16CS064,15CS664,18,39,57,P,6,72019,Regular
4JN16CS064,15CS64,19,42,61,P,7,72019,Regular
4JN16CS064,15CSL67,18,58,76,P,8,72019,Regular
4JN16CS064,15CSL68,20,78,98,P,10,72019,Regular
4JN16CS065,15CS61,17,51,68,P,7,72019,Regular
4JN16CS065,15CS62,19,53,72,P,8,72019,Regular
4JN16CS065,15CS653,15,65,80,P,9,72019,Regular
4JN16CS065,15CS63,17,42,59,P,6,72019,Regular
4JN16CS065,15CS664,19,39,58,P,6,72019,Regular
4JN16CS065,15CS64,17,54,71,P,8,72019,Regular
4JN16CS065,15CSL67,14,68,82,P,9,72019,Regular
4JN16CS065,15CSL68,19,75,94,P,10,72019,Regular
4JN16CS066,15CS61,15,44,59,P,6,72019,Regular
4JN16CS066,15CS62,14,46,60,P,7,72019,Regular
4JN16CS066,15CS63,17,33,50,P,6,72019,Regular
4JN16CS066,15CS653,17,53,70,P,8,72019,Regular
4JN16CS066,15CS664,18,42,60,P,7,72019,Regular
4JN16CS066,15CS64,19,48,67,P,7,72019,Regular
4JN16CS066,15CSL67,13,53,66,P,7,72019,Regular
4JN16CS066,15CSL68,17,70,87,P,9,72019,Regular
4JN16CS067,15CS61,14,33,47,P,5,72019,Regular
4JN16CS067,15CS62,14,36,50,P,6,72019,Regular
4JN16CS067,15CS63,13,28,41,P,4,72019,Regular
4JN16CS067,15CS653,15,41,56,P,6,72019,Regular
4JN16CS067,15CS664,16,20,36,F,0,72019,Regular
4JN16CS067,15CS64,14,35,49,P,5,72019,Regular
4JN16CS067,15CSL67,16,38,54,P,6,72019,Regular
4JN16CS067,15CSL68,17,59,76,P,8,72019,Regular
4JN16CS070,15CS61,19,37,56,P,6,72019,Regular
4JN16CS070,15CS62,18,28,46,P,5,72019,Regular
4JN16CS070,15CS653,18,60,78,P,8,72019,Regular
4JN16CS070,15CS63,15,30,45,P,5,72019,Regular
4JN16CS070,15CS664,18,32,50,P,6,72019,Regular
4JN16CS070,15CS64,16,28,44,P,4,72019,Regular
4JN16CS070,15CSL67,17,75,92,P,10,72019,Regular
4JN16CS070,15CSL68,19,65,84,P,9,72019,Regular
4JN16CS071,15CS61,15,36,51,P,6,72019,Regular
4JN16CS071,15CS62,14,37,51,P,6,72019,Regular
4JN16CS071,15CS63,14,32,46,P,5,72019,Regular
4JN16CS071,15CS653,15,57,72,P,8,72019,Regular
4JN16CS071,15CS664,16,28,44,P,4,72019,Regular
4JN16CS071,15CS64,15,32,47,P,5,72019,Regular
4JN16CS071,15CSL67,13,48,61,P,7,72019,Regular
4JN16CS071,15CSL68,17,68,85,P,9,72019,Regular
4JN16CS072,15CS61,20,52,72,P,8,72019,Regular
4JN16CS072,15CS62,19,52,71,P,8,72019,Regular
4JN16CS072,15CS653,19,68,87,P,9,72019,Regular
4JN16CS072,15CS63,19,52,71,P,8,72019,Regular
4JN16CS072,15CS664,19,48,67,P,7,72019,Regular
4JN16CS072,15CS64,20,51,71,P,8,72019,Regular
4JN16CS072,15CSL67,17,77,94,P,10,72019,Regular
4JN16CS072,15CSL68,20,75,95,P,10,72019,Regular
4JN16CS073,15CS61,20,64,84,P,9,72019,Regular
4JN16CS073,15CS62,16,43,59,P,6,72019,Regular
4JN16CS073,15CS653,19,65,84,P,9,72019,Regular
4JN16CS073,15CS63,20,52,72,P,8,72019,Regular
4JN16CS073,15CS664,19,37,56,P,6,72019,Regular
4JN16CS073,15CS64,16,40,56,P,6,72019,Regular
4JN16CS073,15CSL67,18,60,78,P,8,72019,Regular
4JN16CS073,15CSL68,17,79,96,P,10,72019,Regular
4JN16CS074,15CS61,20,60,80,P,9,72019,Regular
4JN16CS074,15CS62,20,57,77,P,8,72019,Regular
4JN16CS074,15CS653,20,55,75,P,8,72019,Regular
4JN16CS074,15CS63,19,46,65,P,7,72019,Regular
4JN16CS074,15CS664,20,56,76,P,8,72019,Regular
4JN16CS074,15CS64,20,57,77,P,8,72019,Regular
4JN16CS074,15CSL67,19,75,94,P,10,72019,Regular
4JN16CS074,15CSL68,20,74,94,P,10,72019,Regular
4JN16CS075,15CS61,20,55,75,P,8,72019,Regular
4JN16CS075,15CS62,20,51,71,P,8,72019,Regular
4JN16CS075,15CS653,20,57,77,P,8,72019,Regular
4JN16CS075,15CS63,19,59,78,P,8,72019,Regular
4JN16CS075,15CS664,20,43,63,P,7,72019,Regular
4JN16CS075,15CS64,20,69,89,P,9,72019,Regular
4JN16CS075,15CSL67,20,79,99,P,10,72019,Regular
4JN16CS075,15CSL68,20,79,99,P,10,72019,Regular
4JN16CS077,15CS61,19,61,80,P,9,72019,Regular
4JN16CS077,15CS62,20,38,58,P,6,72019,Regular
4JN16CS077,15CS653,19,65,84,P,9,72019,Regular
4JN16CS077,15CS63,20,50,70,P,8,72019,Regular
4JN16CS077,15CS664,20,49,69,P,7,72019,Regular
4JN16CS077,15CS64,19,47,66,P,7,72019,Regular
4JN16CS077,15CSL67,20,77,97,P,10,72019,Regular
4JN16CS077,15CSL68,20,77,97,P,10,72019,Regular
4JN16CS078,15CS61,18,64,82,P,9,72019,Regular
4JN16CS078,15CS62,20,48,68,P,7,72019,Regular
4JN16CS078,15CS653,17,54,71,P,8,72019,Regular
4JN16CS078,15CS63,15,35,50,P,6,72019,Regular
4JN16CS078,15CS664,19,41,60,P,7,72019,Regular
4JN16CS078,15CS64,18,48,66,P,7,72019,Regular
4JN16CS078,15CSL67,19,76,95,P,10,72019,Regular
4JN16CS078,15CSL68,20,65,85,P,9,72019,Regular
4JN16CS079,15CS61,17,60,77,P,8,72019,Regular
4JN16CS079,15CS62,16,30,46,P,5,72019,Regular
4JN16CS079,15CS653,17,49,66,P,7,72019,Regular
4JN16CS079,15CS63,16,38,54,P,6,72019,Regular
4JN16CS079,15CS664,15,30,45,P,5,72019,Regular
4JN16CS079,15CS64,18,53,71,P,8,72019,Regular
4JN16CS079,15CSL67,17,73,90,P,10,72019,Regular
4JN16CS079,15CSL68,20,60,80,P,9,72019,Regular
4JN16CS080,15CS61,18,43,61,P,7,72019,Regular
4JN16CS080,15CS62,18,45,63,P,7,72019,Regular
4JN16CS080,15CS63,18,34,52,P,6,72019,Regular
4JN16CS080,15CS653,18,60,78,P,8,72019,Regular
4JN16CS080,15CS64,19,34,53,P,6,72019,Regular
4JN16CS080,15CS664,17,52,69,P,7,72019,Regular
4JN16CS080,15CSL67,19,68,87,P,9,72019,Regular
4JN16CS080,15CSL68,18,58,76,P,8,72019,Regular
4JN16CS082,15CS61,16,47,63,P,7,72019,Regular
4JN16CS082,15CS62,16,36,52,P,6,72019,Regular
4JN16CS082,15CS63,19,40,59,P,6,72019,Regular
4JN16CS082,15CS664,15,33,48,P,5,72019,Regular
4JN16CS082,15CS654,19,67,86,P,9,72019,Regular
4JN16CS082,15CS64,17,54,71,P,8,72019,Regular
4JN16CS082,15CSL67,17,72,89,P,9,72019,Regular
4JN16CS082,15CSL68,20,63,83,P,9,72019,Regular
4JN16CS083,15CS61,16,56,72,P,8,72019,Regular
4JN16CS083,15CS62,17,43,60,P,7,72019,Regular
4JN16CS083,15CS653,14,59,73,P,8,72019,Regular
4JN16CS083,15CS63,14,28,42,P,4,72019,Regular
4JN16CS083,15CS664,18,29,47,P,5,72019,Regular
4JN16CS083,15CS64,17,45,62,P,7,72019,Regular
4JN16CS083,15CSL67,17,58,75,P,8,72019,Regular
4JN16CS083,15CSL68,16,72,88,P,9,72019,Regular
4JN16CS083,15MAT41,14,28,42,P,4,72019,Backlog
4JN16CS084,15CS61,20,57,77,P,8,72019,Regular
4JN16CS084,15CS62,20,52,72,P,8,72019,Regular
4JN16CS084,15CS653,20,56,76,P,8,72019,Regular
4JN16CS084,15CS63,19,58,77,P,8,72019,Regular
4JN16CS084,15CS664,19,32,51,P,6,72019,Regular
4JN16CS084,15CS64,20,71,91,P,10,72019,Regular
4JN16CS084,15CSL67,20,73,93,P,10,72019,Regular
4JN16CS084,15CSL68,20,79,99,P,10,72019,Regular
4JN16CS085,15CS61,20,49,69,P,7,72019,Regular
4JN16CS085,15CS62,20,44,64,P,7,72019,Regular
4JN16CS085,15CS653,19,50,69,P,7,72019,Regular
4JN16CS085,15CS63,19,34,53,P,6,72019,Regular
4JN16CS085,15CS664,19,34,53,P,6,72019,Regular
4JN16CS085,15CS64,18,60,78,P,8,72019,Regular
4JN16CS085,15CSL67,17,75,92,P,10,72019,Regular
4JN16CS085,15CSL68,18,76,94,P,10,72019,Regular
4JN16CS087,15CS61,20,48,68,P,7,72019,Regular
4JN16CS087,15CS62,19,35,54,P,6,72019,Regular
4JN16CS087,15CS63,18,33,51,P,6,72019,Regular
4JN16CS087,15CS653,19,48,67,P,7,72019,Regular
4JN16CS087,15CS664,19,38,57,P,6,72019,Regular
4JN16CS087,15CS64,18,39,57,P,6,72019,Regular
4JN16CS087,15CSL67,17,55,72,P,8,72019,Regular
4JN16CS087,15CSL68,19,74,93,P,10,72019,Regular
4JN16CS088,15CS61,15,40,55,P,6,72019,Regular
4JN16CS088,15CS62,17,29,46,P,5,72019,Regular
4JN16CS088,15CS653,17,61,78,P,8,72019,Regular
4JN16CS088,15CS63,15,40,55,P,6,72019,Regular
4JN16CS088,15CS64,14,34,48,P,5,72019,Regular
4JN16CS088,15CS664,16,36,52,P,6,72019,Regular
4JN16CS088,15CSL67,13,78,91,P,10,72019,Regular
4JN16CS088,15CSL68,16,60,76,P,8,72019,Regular
4JN16CS089,15CS61,20,60,80,P,9,72019,Regular
4JN16CS089,15CS62,20,62,82,P,9,72019,Regular
4JN16CS089,15CS653,20,72,92,P,10,72019,Regular
4JN16CS089,15CS63,19,50,69,P,7,72019,Regular
4JN16CS089,15CS664,20,59,79,P,8,72019,Regular
4JN16CS089,15CS64,20,53,73,P,8,72019,Regular
4JN16CS089,15CSL67,20,76,96,P,10,72019,Regular
4JN16CS089,15CSL68,20,79,99,P,10,72019,Regular
4JN16CS090,15CS61,19,68,87,P,9,72019,Regular
4JN16CS090,15CS62,16,45,61,P,7,72019,Regular
4JN16CS090,15CS653,15,51,66,P,7,72019,Regular
4JN16CS090,15CS63,17,31,48,P,5,72019,Regular
4JN16CS090,15CS664,16,28,44,P,4,72019,Regular
4JN16CS090,15CS64,18,56,74,P,8,72019,Regular
4JN16CS090,15CSL67,18,60,78,P,8,72019,Regular
4JN16CS090,15CSL68,20,76,96,P,10,72019,Regular
4JN16CS091,15CS61,20,49,69,P,7,72019,Regular
4JN16CS091,15CS62,20,42,62,P,7,72019,Regular
4JN16CS091,15CS653,16,69,85,P,9,72019,Regular
4JN16CS091,15CS63,19,34,53,P,6,72019,Regular
4JN16CS091,15CS664,20,55,75,P,8,72019,Regular
4JN16CS091,15CS64,19,35,54,P,6,72019,Regular
4JN16CS091,15CSL67,17,72,89,P,9,72019,Regular
4JN16CS091,15CSL68,20,78,98,P,10,72019,Regular
4JN16CS093,15CS61,15,35,50,P,6,72019,Regular
4JN16CS093,15CS62,16,38,54,P,6,72019,Regular
4JN16CS093,15CS63,14,33,47,P,5,72019,Regular
4JN16CS093,15CS653,13,49,62,P,7,72019,Regular
4JN16CS093,15CS664,15,33,48,P,5,72019,Regular
4JN16CS093,15CS64,15,35,50,P,6,72019,Regular
4JN16CS093,15CSL67,13,72,85,P,9,72019,Regular
4JN16CS093,15CSL68,16,62,78,P,8,72019,Regular
4JN16CS094,15CS61,18,59,77,P,8,72019,Regular
4JN16CS094,15CS62,17,41,58,P,6,72019,Regular
4JN16CS094,15CS653,17,63,80,P,9,72019,Regular
4JN16CS094,15CS63,19,42,61,P,7,72019,Regular
4JN16CS094,15CS664,17,44,61,P,7,72019,Regular
4JN16CS094,15CS64,17,64,81,P,9,72019,Regular
4JN16CS094,15CSL67,19,68,87,P,9,72019,Regular
4JN16CS094,15CSL68,20,76,96,P,10,72019,Regular
4JN16CS095,15CS61,17,52,69,P,7,72019,Regular
4JN16CS095,15CS62,15,47,62,P,7,72019,Regular
4JN16CS095,15CS653,17,56,73,P,8,72019,Regular
4JN16CS095,15CS63,18,64,82,P,9,72019,Regular
4JN16CS095,15CS664,14,36,50,P,6,72019,Regular
4JN16CS095,15CS64,18,52,70,P,8,72019,Regular
4JN16CS095,15CSL67,17,64,81,P,9,72019,Regular
4JN16CS095,15CSL68,18,50,68,P,7,72019,Regular
4JN16CS096,15CS61,18,62,80,P,9,72019,Regular
4JN16CS096,15CS62,20,52,72,P,8,72019,Regular
4JN16CS096,15CS653,18,73,91,P,10,72019,Regular
4JN16CS096,15CS63,17,50,67,P,7,72019,Regular
4JN16CS096,15CS664,20,45,65,P,7,72019,Regular
4JN16CS096,15CS64,19,57,76,P,8,72019,Regular
4JN16CS096,15CSL67,18,76,94,P,10,72019,Regular
4JN16CS096,15CSL68,20,65,85,P,9,72019,Regular
4JN16CS097,15CS61,20,41,61,P,7,72019,Regular
4JN16CS097,15CS62,19,33,52,P,6,72019,Regular
4JN16CS097,15CS653,18,59,77,P,8,72019,Regular
4JN16CS097,15CS63,19,38,57,P,6,72019,Regular
4JN16CS097,15CS664,17,48,65,P,7,72019,Regular
4JN16CS097,15CS64,19,61,80,P,9,72019,Regular
4JN16CS097,15CSL67,16,75,91,P,10,72019,Regular
4JN16CS097,15CSL68,20,60,80,P,9,72019,Regular
4JN16CS099,15CS61,19,71,90,P,10,72019,Regular
4JN16CS099,15CS62,17,56,73,P,8,72019,Regular
4JN16CS099,15CS653,18,57,75,P,8,72019,Regular
4JN16CS099,15CS63,17,42,59,P,6,72019,Regular
4JN16CS099,15CS64,19,66,85,P,9,72019,Regular
4JN16CS099,15CS664,18,53,71,P,8,72019,Regular
4JN16CS099,15CSL67,20,68,88,P,9,72019,Regular
4JN16CS099,15CSL68,20,55,75,P,8,72019,Regular
4JN16CS100,15CS61,17,71,88,P,9,72019,Regular
4JN16CS100,15CS62,17,42,59,P,6,72019,Regular
4JN16CS100,15CS63,18,45,63,P,7,72019,Regular
4JN16CS100,15CS653,19,65,84,P,9,72019,Regular
4JN16CS100,15CS664,19,43,62,P,7,72019,Regular
4JN16CS100,15CS64,20,54,74,P,8,72019,Regular
4JN16CS100,15CSL67,20,73,93,P,10,72019,Regular
4JN16CS100,15CSL68,20,78,98,P,10,72019,Regular
4JN16CS101,15CS61,15,55,70,P,8,72019,Regular
4JN16CS101,15CS62,20,39,59,P,6,72019,Regular
4JN16CS101,15CS653,15,36,51,P,6,72019,Regular
4JN16CS101,15CS63,18,34,52,P,6,72019,Regular
4JN16CS101,15CS664,18,31,49,P,5,72019,Regular
4JN16CS101,15CS64,15,28,43,P,4,72019,Regular
4JN16CS101,15CSL67,18,55,73,P,8,72019,Regular
4JN16CS101,15CSL68,16,52,68,P,7,72019,Regular
4JN16CS102,15CS61,20,64,84,P,9,72019,Regular
4JN16CS102,15CS62,18,47,65,P,7,72019,Regular
4JN16CS102,15CS653,19,64,83,P,9,72019,Regular
4JN16CS102,15CS63,20,50,70,P,8,72019,Regular
4JN16CS102,15CS664,20,37,57,P,6,72019,Regular
4JN16CS102,15CS64,18,56,74,P,8,72019,Regular
4JN16CS102,15CSL67,20,78,98,P,10,72019,Regular
4JN16CS102,15CSL68,20,77,97,P,10,72019,Regular
4JN16CS103,15CS61,20,48,68,P,7,72019,Regular
4JN16CS103,15CS62,20,48,68,P,7,72019,Regular
4JN16CS103,15CS653,19,34,53,P,6,72019,Regular
4JN16CS103,15CS63,20,56,76,P,8,72019,Regular
4JN16CS103,15CS664,20,51,71,P,8,72019,Regular
4JN16CS103,15CS64,19,59,78,P,8,72019,Regular
4JN16CS103,15CSL67,20,78,98,P,10,72019,Regular
4JN16CS103,15CSL68,20,77,97,P,10,72019,Regular
4JN16CS104,15CS61,20,61,81,P,9,72019,Regular
4JN16CS104,15CS62,20,60,80,P,9,72019,Regular
4JN16CS104,15CS653,19,56,75,P,8,72019,Regular
4JN16CS104,15CS63,18,46,64,P,7,72019,Regular
4JN16CS104,15CS664,20,55,75,P,8,72019,Regular
4JN16CS104,15CS64,20,53,73,P,8,72019,Regular
4JN16CS104,15CSL67,20,79,99,P,10,72019,Regular
4JN16CS104,15CSL68,20,79,99,P,10,72019,Regular
4JN16CS105,15CS61,18,41,59,P,6,72019,Regular
4JN16CS105,15CS62,16,35,51,P,6,72019,Regular
4JN16CS105,15CS63,15,34,49,P,5,72019,Regular
4JN16CS105,15CS664,14,34,48,P,5,72019,Regular
4JN16CS105,15CS654,19,57,76,P,8,72019,Regular
4JN16CS105,15CS64,14,37,51,P,6,72019,Regular
4JN16CS105,15CSL67,16,32,48,P,5,72019,Regular
4JN16CS105,15CSL68,16,35,51,P,6,72019,Regular
4JN16CS106,15CS61,18,44,62,P,7,72019,Regular
4JN16CS106,15CS62,20,36,56,P,6,72019,Regular
4JN16CS106,15CS653,18,59,77,P,8,72019,Regular
4JN16CS106,15CS63,17,35,52,P,6,72019,Regular
4JN16CS106,15CS664,18,38,56,P,6,72019,Regular
4JN16CS106,15CS64,18,41,59,P,6,72019,Regular
4JN16CS106,15CSL67,19,77,96,P,10,72019,Regular
4JN16CS106,15CSL68,20,76,96,P,10,72019,Regular
4JN16CS107,15CS61,19,50,69,P,7,72019,Regular
4JN16CS107,15CS62,19,45,64,P,7,72019,Regular
4JN16CS107,15CS653,17,53,70,P,8,72019,Regular
4JN16CS107,15CS63,18,41,59,P,6,72019,Regular
4JN16CS107,15CS664,17,51,68,P,7,72019,Regular
4JN16CS107,15CS64,20,41,61,P,7,72019,Regular
4JN16CS107,15CSL67,19,75,94,P,10,72019,Regular
4JN16CS107,15CSL68,20,74,94,P,10,72019,Regular
4JN16CS108,15CS61,18,53,71,P,8,72019,Regular
4JN16CS108,15CS62,19,42,61,P,7,72019,Regular
4JN16CS108,15CS653,18,57,75,P,8,72019,Regular
4JN16CS108,15CS63,20,31,51,P,6,72019,Regular
4JN16CS108,15CS664,20,43,63,P,7,72019,Regular
4JN16CS108,15CS64,16,40,56,P,6,72019,Regular
4JN16CS108,15CSL67,15,76,91,P,10,72019,Regular
4JN16CS108,15CSL68,20,75,95,P,10,72019,Regular
4JN16CS109,15CS61,18,43,61,P,7,72019,Regular
4JN16CS109,15CS62,14,46,60,P,7,72019,Regular
4JN16CS109,15CS63,13,28,41,P,4,72019,Regular
4JN16CS109,15CS664,15,28,43,P,4,72019,Regular
4JN16CS109,15CS654,15,50,65,P,7,72019,Regular
4JN16CS109,15CS64,12,46,58,P,6,72019,Regular
4JN16CS109,15CSL67,18,25,43,F,0,72019,Regular
4JN16CS109,15CSL68,18,32,50,P,6,72019,Regular
4JN16CS109,15CSL57,18,32,50,P,6,72019,Backlog
4JN16CS109,15MAT31,14,22,36,F,0,72019,Backlog
4JN16CS110,15CS61,15,45,60,P,7,72019,Regular
4JN16CS110,15CS62,17,45,62,P,7,72019,Regular
4JN16CS110,15CS63,13,34,47,P,5,72019,Regular
4JN16CS110,15CS653,17,42,59,P,6,72019,Regular
4JN16CS110,15CS664,12,37,49,P,5,72019,Regular
4JN16CS110,15CS64,18,37,55,P,6,72019,Regular
4JN16CS110,15CSL67,20,74,94,P,10,72019,Regular
4JN16CS110,15CSL68,20,71,91,P,10,72019,Regular
4JN16CS110,15CS52,16,28,44,P,4,72019,Backlog
4JN16CS112,15CS61,18,31,49,P,5,72019,Regular
4JN16CS112,15CS62,17,43,60,P,7,72019,Regular
4JN16CS112,15CS653,19,60,79,P,8,72019,Regular
4JN16CS112,15CS63,17,51,68,P,7,72019,Regular
4JN16CS112,15CS664,20,46,66,P,7,72019,Regular
4JN16CS112,15CS64,18,50,68,P,7,72019,Regular
4JN16CS112,15CSL67,20,77,97,P,10,72019,Regular
4JN16CS112,15CSL68,20,78,98,P,10,72019,Regular
4JN16CS113,15CS61,15,63,78,P,8,72019,Regular
4JN16CS113,15CS62,16,36,52,P,6,72019,Regular
4JN16CS113,15CS653,15,47,62,P,7,72019,Regular
4JN16CS113,15CS63,13,38,51,P,6,72019,Regular
4JN16CS113,15CS664,14,44,58,P,6,72019,Regular
4JN16CS113,15CS64,17,47,64,P,7,72019,Regular
4JN16CS113,15CSL67,14,40,54,P,6,72019,Regular
4JN16CS113,15CSL68,17,58,75,P,8,72019,Regular
4JN16CS114,15CS61,20,62,82,P,9,72019,Regular
4JN16CS114,15CS62,20,53,73,P,8,72019,Regular
4JN16CS114,15CS653,20,63,83,P,9,72019,Regular
4JN16CS114,15CS63,19,42,61,P,7,72019,Regular
4JN16CS114,15CS64,19,50,69,P,7,72019,Regular
4JN16CS114,15CS664,20,52,72,P,8,72019,Regular
4JN16CS114,15CSL67,20,72,92,P,10,72019,Regular
4JN16CS114,15CSL68,20,79,99,P,10,72019,Regular
4JN16CS115,15CS61,18,35,53,P,6,72019,Regular
4JN16CS115,15CS62,14,28,42,P,4,72019,Regular
4JN16CS115,15CS653,17,46,63,P,7,72019,Regular
4JN16CS115,15CS63,14,32,46,P,5,72019,Regular
4JN16CS115,15CS664,15,28,43,P,4,72019,Regular
4JN16CS115,15CS64,17,30,47,P,5,72019,Regular
4JN16CS115,15CSL67,13,73,86,P,9,72019,Regular
4JN16CS115,15CSL68,20,76,96,P,10,72019,Regular
4JN16CS116,15CS61,17,28,45,P,5,72019,Regular
4JN16CS116,15CS62,14,29,43,P,4,72019,Regular
4JN16CS116,15CS63,12,18,30,F,0,72019,Regular
4JN16CS116,15CS653,12,50,62,P,7,72019,Regular
4JN16CS116,15CS664,15,28,43,P,4,72019,Regular
4JN16CS116,15CS64,14,34,48,P,5,72019,Regular
4JN16CS116,15CSL67,18,50,68,P,7,72019,Regular
4JN16CS116,15CSL68,17,76,93,P,10,72019,Regular
4JN16CS116,15CS54,16,22,38,F,0,72019,Backlog
4JN16CS116,15CSL57,18,41,59,P,6,72019,Backlog
4JN16CS117,15CS61,15,47,62,P,7,72019,Regular
4JN16CS117,15CS62,12,28,40,P,4,72019,Regular
4JN16CS117,15CS653,17,30,47,P,5,72019,Regular
4JN16CS117,15CS63,12,33,45,P,5,72019,Regular
4JN16CS117,15CS664,16,28,44,P,4,72019,Regular
4JN16CS117,15CS64,12,30,42,P,4,72019,Regular
4JN16CS117,15CSL67,16,32,48,P,5,72019,Regular
4JN16CS117,15CSL68,15,43,58,P,6,72019,Regular
4JN16CS117,15CSL57,17,32,49,P,5,72019,Backlog
4JN16CS118,15CS61,16,60,76,P,8,72019,Regular
4JN16CS118,15CS62,17,40,57,P,6,72019,Regular
4JN16CS118,15CS653,17,43,60,P,7,72019,Regular
4JN16CS118,15CS63,14,39,53,P,6,72019,Regular
4JN16CS118,15CS664,12,44,56,P,6,72019,Regular
4JN16CS118,15CS64,16,51,67,P,7,72019,Regular
4JN16CS118,15CSL67,16,77,93,P,10,72019,Regular
4JN16CS118,15CSL68,14,62,76,P,8,72019,Regular
4JN16CS119,15CS61,17,51,68,P,7,72019,Regular
4JN16CS119,15CS62,17,41,58,P,6,72019,Regular
4JN16CS119,15CS653,16,64,80,P,9,72019,Regular
4JN16CS119,15CS63,15,38,53,P,6,72019,Regular
4JN16CS119,15CS664,15,38,53,P,6,72019,Regular
4JN16CS119,15CS64,17,56,73,P,8,72019,Regular
4JN16CS119,15CSL67,13,62,75,P,8,72019,Regular
4JN16CS119,15CSL68,17,65,82,P,9,72019,Regular
4JN16CS120,15CS61,17,53,70,P,8,72019,Regular
4JN16CS120,15CS62,18,41,59,P,6,72019,Regular
4JN16CS120,15CS653,18,57,75,P,8,72019,Regular
4JN16CS120,15CS63,18,38,56,P,6,72019,Regular
4JN16CS120,15CS664,20,29,49,P,5,72019,Regular
4JN16CS120,15CS64,18,56,74,P,8,72019,Regular
4JN16CS120,15CSL67,20,75,95,P,10,72019,Regular
4JN16CS120,15CSL68,20,78,98,P,10,72019,Regular
4JN16CS121,15CS61,15,41,56,P,6,72019,Regular
4JN16CS121,15CS62,15,40,55,P,6,72019,Regular
4JN16CS121,15CS653,14,38,52,P,6,72019,Regular
4JN16CS121,15CS63,13,29,42,P,4,72019,Regular
4JN16CS121,15CS664,17,35,52,P,6,72019,Regular
4JN16CS121,15CS64,19,28,47,P,5,72019,Regular
4JN16CS121,15CSL67,13,45,58,P,6,72019,Regular
4JN16CS121,15CSL68,16,50,66,P,7,72019,Regular
4JN16CS122,15CS61,15,35,50,P,6,72019,Regular
4JN16CS122,15CS62,17,23,40,F,0,72019,Regular
4JN16CS122,15CS653,17,21,38,F,0,72019,Regular
4JN16CS122,15CS63,13,16,29,F,0,72019,Regular
4JN16CS122,15CS664,17,28,45,P,5,72019,Regular
4JN16CS122,15CS64,17,31,48,P,5,72019,Regular
4JN16CS122,15CSL67,20,77,97,P,10,72019,Regular
4JN16CS122,15CSL68,20,79,99,P,10,72019,Regular
4JN16CS123,15CS61,18,57,75,P,8,72019,Regular
4JN16CS123,15CS62,18,37,55,P,6,72019,Regular
4JN16CS123,15CS653,16,40,56,P,6,72019,Regular
4JN16CS123,15CS63,15,37,52,P,6,72019,Regular
4JN16CS123,15CS664,18,50,68,P,7,72019,Regular
4JN16CS123,15CS64,16,44,60,P,7,72019,Regular
4JN16CS123,15CSL67,17,49,66,P,7,72019,Regular
4JN16CS123,15CSL68,17,75,92,P,10,72019,Regular
4JN16CS124,15CS61,20,62,82,P,9,72019,Regular
4JN16CS124,15CS62,20,52,72,P,8,72019,Regular
4JN16CS124,15CS653,19,54,73,P,8,72019,Regular
4JN16CS124,15CS63,20,40,60,P,7,72019,Regular
4JN16CS124,15CS664,20,54,74,P,8,72019,Regular
4JN16CS124,15CS64,19,61,80,P,9,72019,Regular
4JN16CS124,15CSL67,18,77,95,P,10,72019,Regular
4JN16CS124,15CSL68,20,78,98,P,10,72019,Regular
4JN16CS125,15CS61,19,69,88,P,9,72019,Regular
4JN16CS125,15CS62,19,61,80,P,9,72019,Regular
4JN16CS125,15CS63,18,45,63,P,7,72019,Regular
4JN16CS125,15CS653,18,52,70,P,8,72019,Regular
4JN16CS125,15CS664,20,53,73,P,8,72019,Regular
4JN16CS125,15CS64,20,61,81,P,9,72019,Regular
4JN16CS125,15CSL67,20,77,97,P,10,72019,Regular
4JN16CS125,15CSL68,20,78,98,P,10,72019,Regular
4JN16CS126,15CS61,20,63,83,P,9,72019,Regular
4JN16CS126,15CS62,20,56,76,P,8,72019,Regular
4JN16CS126,15CS653,19,69,88,P,9,72019,Regular
4JN16CS126,15CS63,20,53,73,P,8,72019,Regular
4JN16CS126,15CS664,20,44,64,P,7,72019,Regular
4JN16CS126,15CS64,20,55,75,P,8,72019,Regular
4JN16CS126,15CSL67,20,78,98,P,10,72019,Regular
4JN16CS126,15CSL68,20,79,99,P,10,72019,Regular
4JN16CS127,15CS61,18,65,83,P,9,72019,Regular
4JN16CS127,15CS62,20,53,73,P,8,72019,Regular
4JN16CS127,15CS653,19,47,66,P,7,72019,Regular
4JN16CS127,15CS63,16,41,57,P,6,72019,Regular
4JN16CS127,15CS664,16,40,56,P,6,72019,Regular
4JN16CS127,15CS64,19,58,77,P,8,72019,Regular
4JN16CS127,15CSL67,20,75,95,P,10,72019,Regular
4JN16CS127,15CSL68,20,70,90,P,10,72019,Regular
4JN16CS128,15CS61,17,54,71,P,8,72019,Regular
4JN16CS128,15CS62,19,44,63,P,7,72019,Regular
4JN16CS128,15CS653,19,68,87,P,9,72019,Regular
4JN16CS128,15CS63,17,40,57,P,6,72019,Regular
4JN16CS128,15CS664,17,56,73,P,8,72019,Regular
4JN16CS128,15CS64,18,53,71,P,8,72019,Regular
4JN16CS128,15CSL67,20,78,98,P,10,72019,Regular
4JN16CS128,15CSL68,20,63,83,P,9,72019,Regular
4JN16CS129,15CS61,20,60,80,P,9,72019,Regular
4JN16CS129,15CS62,20,53,73,P,8,72019,Regular
4JN16CS129,15CS653,19,67,86,P,9,72019,Regular
4JN16CS129,15CS63,20,49,69,P,7,72019,Regular
4JN16CS129,15CS664,20,48,68,P,7,72019,Regular
4JN16CS129,15CS64,19,45,64,P,7,72019,Regular
4JN16CS129,15CSL67,20,78,98,P,10,72019,Regular
4JN16CS129,15CSL68,20,78,98,P,10,72019,Regular
4JN16CS130,15CS61,17,54,71,P,8,72019,Regular
4JN16CS130,15CS62,18,36,54,P,6,72019,Regular
4JN16CS130,15CS63,18,58,76,P,8,72019,Regular
4JN16CS130,15CS653,18,68,86,P,9,72019,Regular
4JN16CS130,15CS664,14,58,72,P,8,72019,Regular
4JN16CS130,15CS64,18,58,76,P,8,72019,Regular
4JN16CS130,15CSL67,18,77,95,P,10,72019,Regular
4JN16CS130,15CSL68,20,61,81,P,9,72019,Regular
4JN16CS131,15CS61,17,61,78,P,8,72019,Regular
4JN16CS131,15CS62,20,49,69,P,7,72019,Regular
4JN16CS131,15CS653,19,68,87,P,9,72019,Regular
4JN16CS131,15CS63,18,35,53,P,6,72019,Regular
4JN16CS131,15CS664,19,49,68,P,7,72019,Regular
4JN16CS131,15CS64,19,50,69,P,7,72019,Regular
4JN16CS131,15CSL67,18,71,89,P,9,72019,Regular
4JN16CS131,15CSL68,18,55,73,P,8,72019,Regular
4JN16CS132,15CS61,17,56,73,P,8,72019,Regular
4JN16CS132,15CS62,17,54,71,P,8,72019,Regular
4JN16CS132,15CS653,15,60,75,P,8,72019,Regular
4JN16CS132,15CS63,18,42,60,P,7,72019,Regular
4JN16CS132,15CS664,17,40,57,P,6,72019,Regular
4JN16CS132,15CS64,15,45,60,P,7,72019,Regular
4JN16CS132,15CSL67,16,65,81,P,9,72019,Regular
4JN16CS132,15CSL68,18,75,93,P,10,72019,Regular
4JN17CS400,15CS61,16,32,48,P,5,72019,Regular
4JN17CS400,15CS62,19,28,47,P,5,72019,Regular
4JN17CS400,15CS63,16,38,54,P,6,72019,Regular
4JN17CS400,15CS653,16,46,62,P,7,72019,Regular
4JN17CS400,15CS64,15,43,58,P,6,72019,Regular
4JN17CS400,15CS664,15,31,46,P,5,72019,Regular
4JN17CS400,15CSL67,18,48,66,P,7,72019,Regular
4JN17CS400,15CSL68,20,45,65,P,7,72019,Regular
4JN17CS400,15MATDIP41,0,29,29,P,0,72019,Backlog
4JN17CS400,15MATDIP31,0,4,4,F,0,72019,Backlog
4JN17CS401,15CS61,18,50,68,P,7,72019,Regular
4JN17CS401,15CS62,17,40,57,P,6,72019,Regular
4JN17CS401,15CS63,13,50,63,P,7,72019,Regular
4JN17CS401,15CS664,12,38,50,P,6,72019,Regular
4JN17CS401,15CS654,19,46,65,P,7,72019,Regular
4JN17CS401,15CS64,15,47,62,P,7,72019,Regular
4JN17CS401,15CSL67,19,71,90,P,10,72019,Regular
4JN17CS401,15CSL68,20,60,80,P,9,72019,Regular
4JN17CS401,15MATDIP41,0,0,0,A,0,72019,Backlog
4JN17CS401,15MAT41,9,0,9,A,0,72019,Backlog
4JN17CS402,15CS61,18,50,68,P,7,72019,Regular
4JN17CS402,15CS62,18,38,56,P,6,72019,Regular
4JN17CS402,15CS63,12,28,40,P,4,72019,Regular
4JN17CS402,15CS654,18,56,74,P,8,72019,Regular
4JN17CS402,15CS64,14,34,48,P,5,72019,Regular
4JN17CS402,15CS664,16,40,56,P,6,72019,Regular
4JN17CS402,15CSL67,13,32,45,P,5,72019,Regular
4JN17CS402,15CSL68,20,60,80,P,9,72019,Regular
4JN17CS402,15MAT31,12,19,31,F,0,72019,Backlog
4JN17CS403,15CS61,18,51,69,P,7,72019,Regular
4JN17CS403,15CS62,18,51,69,P,7,72019,Regular
4JN17CS403,15CS63,12,34,46,P,5,72019,Regular
4JN17CS403,15CS64,13,63,76,P,8,72019,Regular
4JN17CS403,15CS664,17,43,60,P,7,72019,Regular
4JN17CS403,15CS654,19,60,79,P,8,72019,Regular
4JN17CS403,15CSL67,17,32,49,P,5,72019,Regular
4JN17CS403,15CSL68,18,60,78,P,8,72019,Regular
4JN17CS403,15MATDIP41,0,28,28,P,0,72019,Backlog
4JN17CS403,15MATDIP31,0,1,1,F,0,72019,Backlog
4JN17CS404,15CS61,16,54,70,P,8,72019,Regular
4JN17CS404,15CS62,17,51,68,P,7,72019,Regular
4JN17CS404,15CS653,14,49,63,P,7,72019,Regular
4JN17CS404,15CS63,16,28,44,P,4,72019,Regular
4JN17CS404,15CS64,16,52,68,P,7,72019,Regular
4JN17CS404,15CS664,13,31,44,P,4,72019,Regular
4JN17CS404,15CSL67,20,66,86,P,9,72019,Regular
4JN17CS404,15CSL68,20,53,73,P,8,72019,Regular
4JN17CS404,15MATDIP41,0,28,28,P,0,72019,Backlog
4JN17CS404,15MAT31,12,28,40,P,4,72019,Backlog
4JN17CS405,15CS61,20,57,77,P,8,72019,Regular
4JN17CS405,15CS62,18,43,61,P,7,72019,Regular
4JN17CS405,15CS63,16,32,48,P,5,72019,Regular
4JN17CS405,15CS664,13,29,42,P,4,72019,Regular
4JN17CS405,15CS654,19,61,80,P,9,72019,Regular
4JN17CS405,15CS64,20,40,60,P,7,72019,Regular
4JN17CS405,15CSL67,19,66,85,P,9,72019,Regular
4JN17CS405,15CSL68,20,49,69,P,7,72019,Regular
4JN17CS405,15MATDIP31,0,22,22,F,0,72019,Backlog
4JN17CS406,15CS61,13,32,45,P,5,72019,Regular
4JN17CS406,15CS62,15,30,45,P,5,72019,Regular
4JN17CS406,15CS63,13,31,44,P,4,72019,Regular
4JN17CS406,15CS654,15,42,57,P,6,72019,Regular
4JN17CS406,15CS64,14,41,55,P,6,72019,Regular
4JN17CS406,15CS664,13,36,49,P,5,72019,Regular
4JN17CS406,15CSL67,17,33,50,P,6,72019,Regular
4JN17CS406,15CSL68,15,36,51,P,6,72019,Regular
4JN17CS406,15MATDIP31,0,0,0,A,0,72019,Backlog
4JN17CS407,15CS61,17,28,45,P,5,72019,Regular
4JN17CS407,15CS62,14,54,68,P,7,72019,Regular
4JN17CS407,15CS63,14,45,59,P,6,72019,Regular
4JN17CS407,15CS654,19,44,63,P,7,72019,Regular
4JN17CS407,15CS64,14,28,42,P,4,72019,Regular
4JN17CS407,15CS664,14,45,59,P,6,72019,Regular
4JN17CS407,15CSL67,17,32,49,P,5,72019,Regular
4JN17CS407,15CSL68,16,48,64,P,7,72019,Regular
4JN17CS407,15CS51,15,14,29,F,0,72019,Backlog
4JN17CS407,15CS564,19,40,59,P,6,72019,Backlog
4JN17CS407,15CS54,16,0,16,A,0,72019,Backlog
4JN17CS407,15CSL57,18,18,36,F,0,72019,Backlog
4JN17CS407,15MAT41,12,0,12,A,0,72019,Backlog
4JN17CS408,15CS61,15,46,61,P,7,72019,Regular
4JN17CS408,15CS62,14,47,61,P,7,72019,Regular
4JN17CS408,15CS63,12,28,40,P,4,72019,Regular
4JN17CS408,15CS653,14,41,55,P,6,72019,Regular
4JN17CS408,15CS664,15,30,45,P,5,72019,Regular
4JN17CS408,15CS64,13,32,45,P,5,72019,Regular
4JN17CS408,15CSL67,19,33,52,P,6,72019,Regular
4JN17CS408,15CSL68,20,45,65,P,7,72019,Regular
4JN17CS408,15CSL57,20,39,59,P,6,72019,Backlog
4JN17CS408,15MATDIP41,0,31,31,P,0,72019,Backlog
4JN17CS408,15MATDIP31,0,0,0,A,0,72019,Backlog
4JN17CS410,15CS61,14,38,52,P,6,72019,Regular
4JN17CS410,15CS62,14,30,44,P,4,72019,Regular
4JN17CS410,15CS63,12,28,40,P,4,72019,Regular
4JN17CS410,15CS653,15,47,62,P,7,72019,Regular
4JN17CS410,15CS664,13,31,44,P,4,72019,Regular
4JN17CS410,15CS64,17,37,54,P,6,72019,Regular
4JN17CS410,15CSL67,18,66,84,P,9,72019,Regular
4JN17CS410,15CSL68,16,44,60,P,7,72019,Regular
4JN17CS410,15CS553,12,30,42,P,4,72019,Backlog
4JN17CS410,15MATDIP41,0,19,19,F,0,72019,Backlog
4JN17CS410,15MATDIP31,0,3,3,F,0,72019,Backlog
4JN17CS411,15CS61,16,60,76,P,8,72019,Regular
4JN17CS411,15CS62,15,48,63,P,7,72019,Regular
4JN17CS411,15CS63,15,22,37,F,0,72019,Regular
4JN17CS411,15CS653,15,28,43,P,4,72019,Regular
4JN17CS411,15CS64,18,46,64,P,7,72019,Regular
4JN17CS411,15CS664,14,30,44,P,4,72019,Regular
4JN17CS411,15CSL67,19,73,92,P,10,72019,Regular
4JN17CS411,15CSL68,15,45,60,P,7,72019,Regular
4JN17CS412,15CS61,17,37,54,P,6,72019,Regular
4JN17CS412,15CS62,17,62,79,P,8,72019,Regular
4JN17CS412,15CS63,15,30,45,P,5,72019,Regular
4JN17CS412,15CS654,17,54,71,P,8,72019,Regular
4JN17CS412,15CS64,14,49,63,P,7,72019,Regular
4JN17CS412,15CS664,18,42,60,P,7,72019,Regular
4JN17CS412,15CSL67,13,36,49,P,5,72019,Regular
4JN17CS412,15CSL68,19,66,85,P,9,72019,Regular
4JN17CS412,15MATDIP31,0,1,1,F,0,72019,Backlog
4JN17CS412,15MAT31,12,12,24,F,0,72019,Backlog
4JN17CS413,15CS61,20,55,75,P,8,72019,Regular
4JN17CS413,15CS62,18,44,62,P,7,72019,Regular
4JN17CS413,15CS63,18,41,59,P,6,72019,Regular
4JN17CS413,15CS654,19,60,79,P,8,72019,Regular
4JN17CS413,15CS64,19,41,60,P,7,72019,Regular
4JN17CS413,15CS664,16,28,44,P,4,72019,Regular
4JN17CS413,15CSL67,20,66,86,P,9,72019,Regular
4JN17CS413,15CSL68,20,60,80,P,9,72019,Regular
4JN17CS414,15CS61,18,43,61,P,7,72019,Regular
4JN17CS414,15CS62,13,30,43,P,4,72019,Regular
4JN17CS414,15CS653,14,31,45,P,5,72019,Regular
4JN17CS414,15CS63,13,28,41,P,4,72019,Regular
4JN17CS414,15CS664,12,28,40,P,4,72019,Regular
4JN17CS414,15CS64,15,30,45,P,5,72019,Regular
4JN17CS414,15CSL67,19,55,74,P,8,72019,Regular
4JN17CS414,15CSL68,18,50,68,P,7,72019,Regular
4JN17CS414,15CS53,16,30,46,P,5,72019,Backlog
4JN17CS416,15CS61,15,28,43,P,4,72019,Regular
4JN17CS416,15CS62,18,32,50,P,6,72019,Regular
4JN17CS416,15CS63,12,32,44,P,4,72019,Regular
4JN17CS416,15CS664,18,29,47,P,5,72019,Regular
4JN17CS416,15CS654,15,48,63,P,7,72019,Regular
4JN17CS416,15CS64,13,43,56,P,6,72019,Regular
4JN17CS416,15CSL67,14,32,46,P,5,72019,Regular
4JN17CS416,15CSL68,17,61,78,P,8,72019,Regular
4JN17CS416,15CS51,17,10,27,F,0,72019,Backlog
4JN17CS416,15MAT41,9,9,18,F,0,72019,Backlog
4JN17CS416,15MAT31,12,28,40,P,4,72019,Backlog
4JN17CS417,15CS61,15,52,67,P,7,72019,Regular
4JN17CS417,15CS62,17,47,64,P,7,72019,Regular
4JN17CS417,15CS63,16,35,51,P,6,72019,Regular
4JN17CS417,15CS64,17,41,58,P,6,72019,Regular
4JN17CS417,15CS664,13,28,41,P,4,72019,Regular
4JN17CS417,15CS654,19,59,78,P,8,72019,Regular
4JN17CS417,15CSL67,18,52,70,P,8,72019,Regular
4JN17CS417,15CSL68,20,50,70,P,8,72019,Regular
4JN17CS417,15MATDIP41,0,28,28,P,0,72019,Backlog
4JN17CS417,15MATDIP31,0,0,0,A,0,72019,Backlog
4JN17CS418,15CS61,18,36,54,P,6,72019,Regular
4JN17CS418,15CS62,15,53,68,P,7,72019,Regular
4JN17CS418,15CS63,14,31,45,P,5,72019,Regular
4JN17CS418,15CS64,15,61,76,P,8,72019,Regular
4JN17CS418,15CS664,18,47,65,P,7,72019,Regular
4JN17CS418,15CS654,18,61,79,P,8,72019,Regular
4JN17CS418,15CSL67,20,35,55,P,6,72019,Regular
4JN17CS418,15CSL68,18,45,63,P,7,72019,Regular
4JN17CS418,15MATDIP31,0,22,22,F,0,72019,Backlog
4JN17CS419,15CS61,19,52,71,P,8,72019,Regular
4JN17CS419,15CS62,18,49,67,P,7,72019,Regular
4JN17CS419,15CS63,15,39,54,P,6,72019,Regular
4JN17CS419,15CS664,20,41,61,P,7,72019,Regular
4JN17CS419,15CS654,20,52,72,P,8,72019,Regular
4JN17CS419,15CS64,17,56,73,P,8,72019,Regular
4JN17CS419,15CSL67,17,50,67,P,7,72019,Regular
4JN17CS419,15CSL68,17,78,95,P,10,72019,Regular
4JN17CS419,15MATDIP41,0,34,34,P,0,72019,Backlog
4JN17CS420,15CS61,17,55,72,P,8,72019,Regular
4JN17CS420,15CS62,16,47,63,P,7,72019,Regular
4JN17CS420,15CS63,16,30,46,P,5,72019,Regular
4JN17CS420,15CS654,19,48,67,P,7,72019,Regular
4JN17CS420,15CS64,14,38,52,P,6,72019,Regular
4JN17CS420,15CS664,12,28,40,P,4,72019,Regular
4JN17CS420,15CSL67,17,32,49,P,5,72019,Regular
4JN17CS420,15CSL68,19,50,69,P,7,72019,Regular
4JN17CS420,15CSL57,19,22,41,F,0,72019,Backlog
4JN17CS420,15MATDIP41,0,23,23,F,0,72019,Backlog
4JN17CS420,15MATDIP31,0,0,0,A,0,72019,Backlog
4JN17CS422,15CS61,17,52,69,P,7,72019,Regular
4JN17CS422,15CS62,17,42,59,P,6,72019,Regular
4JN17CS422,15CS63,14,38,52,P,6,72019,Regular
4JN17CS422,15CS664,12,40,52,P,6,72019,Regular
4JN17CS422,15CS654,20,51,71,P,8,72019,Regular
4JN17CS422,15CS64,16,38,54,P,6,72019,Regular
4JN17CS422,15CSL67,18,66,84,P,9,72019,Regular
4JN17CS422,15CSL68,16,52,68,P,7,72019,Regular
4JN17CS422,15MAT41,12,0,12,A,0,72019,Backlog
4JN17CS422,15MATDIP41,0,0,0,A,0,72019,Backlog
4JN17CS423,15CS61,14,50,64,P,7,72019,Regular
4JN17CS423,15CS62,15,35,50,P,6,72019,Regular
4JN17CS423,15CS63,15,30,45,P,5,72019,Regular
4JN17CS423,15CS64,13,45,58,P,6,72019,Regular
4JN17CS423,15CS664,16,36,52,P,6,72019,Regular
4JN17CS423,15CS654,16,32,48,P,5,72019,Regular
4JN17CS423,15CSL67,18,33,51,P,6,72019,Regular
4JN17CS423,15CSL68,18,45,63,P,7,72019,Regular
4JN17CS423,15MATDIP31,0,4,4,F,0,72019,Backlog
4JN17CS423,15CS36,15,0,15,A,0,72019,Backlog
4JN17CS424,15CS61,13,37,50,P,6,72019,Regular
4JN17CS424,15CS62,15,45,60,P,7,72019,Regular
4JN17CS424,15CS63,12,13,25,F,0,72019,Regular
4JN17CS424,15CS664,12,47,59,P,6,72019,Regular
4JN17CS424,15CS654,14,38,52,P,6,72019,Regular
4JN17CS424,15CS64,13,22,35,F,0,72019,Regular
4JN17CS424,15CSL67,17,32,49,P,5,72019,Regular
4JN17CS424,15CSL68,15,32,47,P,5,72019,Regular
4JN17CS424,15CS52,14,21,35,F,0,72019,Backlog
4JN17CS424,15CS53,16,28,44,P,4,72019,Backlog
4JN17CS424,15CSL57,19,27,46,F,0,72019,Backlog
4JN17CS424,15MAT41,7,0,7,A,0,72019,Backlog
4JN17CS424,15MAT31,12,16,28,F,0,72019,Backlog
4JN17CS424,15CS36,12,0,12,A,0,72019,Backlog
4JN17CS425,15CS61,16,61,77,P,8,72019,Regular
4JN17CS425,15CS62,16,54,70,P,8,72019,Regular
4JN17CS425,15CS63,15,49,64,P,7,72019,Regular
4JN17CS425,15CS664,12,28,40,P,4,72019,Regular
4JN17CS425,15CS654,19,53,72,P,8,72019,Regular
4JN17CS425,15CS64,16,34,50,P,6,72019,Regular
4JN17CS425,15CSL67,19,70,89,P,9,72019,Regular
4JN17CS425,15CSL68,20,65,85,P,9,72019,Regular
4JN17CS425,15MATDIP31,0,0,0,A,0,72019,Backlog
4JN17CS427,15CS61,20,59,79,P,8,72019,Regular
4JN17CS427,15CS62,17,49,66,P,7,72019,Regular
4JN17CS427,15CS63,16,59,75,P,8,72019,Regular
4JN17CS427,15CS664,14,54,68,P,7,72019,Regular
4JN17CS427,15CS654,20,64,84,P,9,72019,Regular
4JN17CS427,15CS64,20,34,54,P,6,72019,Regular
4JN17CS427,15CSL67,18,74,92,P,10,72019,Regular
4JN17CS427,15CSL68,20,61,81,P,9,72019,Regular
4JN16CS002,17MAT41,27,31,58,P,6,72019,Regular
4JN16CS002,17CS42,36,35,71,P,8,72019,Regular
4JN16CS002,17CS43,29,21,50,P,6,72019,Regular
4JN16CS002,17CS44,27,21,48,P,5,72019,Regular
4JN16CS002,17CS45,23,21,44,P,4,72019,Regular
4JN16CS002,17CS46,25,21,46,P,5,72019,Regular
4JN16CS002,17CSL47,34,27,61,P,7,72019,Regular
4JN16CS002,17CSL48,30,42,72,P,8,72019,Regular
4JN16CS043,17MAT41,21,22,43,P,4,72019,Regular
4JN16CS043,17CS42,28,17,45,F,0,72019,Regular
4JN16CS043,17CS43,29,27,56,P,6,72019,Regular
4JN16CS043,17CS44,18,33,51,P,6,72019,Regular
4JN16CS043,17CS45,24,18,42,F,0,72019,Regular
4JN16CS043,17CS46,20,25,45,P,5,72019,Regular
4JN16CS043,17CSL47,30,13,43,F,0,72019,Regular
4JN16CS043,17CSL48,30,5,35,F,0,72019,Regular
4JN16CS043,17CS32,27,21,48,P,5,72019,Backlog
4JN16CS043,17CS33,19,30,49,P,5,72019,Backlog
4JN16CS043,17CS34,20,15,35,F,0,72019,Backlog
4JN16CS043,17CSL37,30,6,36,F,0,72019,Backlog
4JN16CS043,17CSL38,31,6,37,F,0,72019,Backlog
4JN16CS043,17KKM39,12,13,25,P,0,72019,Backlog
4JN16CS043,15MAT21,12,39,51,P,6,72019,Backlog
4JN16CS043,15MAT11,13,29,42,P,4,72019,Backlog
4JN16CS043,15CIV13,13,36,49,P,5,72019,Backlog
4JN16CS043,15ELE15,12,18,30,F,0,72019,Backlog
4JN16CS069,17MAT41,24,23,47,P,5,72019,Regular
4JN16CS069,17CS42,20,0,20,A,0,72019,Regular
4JN16CS069,17CS43,16,7,23,F,0,72019,Regular
4JN16CS069,17CS44,15,6,21,F,0,72019,Regular
4JN16CS069,17CS45,19,0,19,A,0,72019,Regular
4JN16CS069,17CS46,17,0,17,A,0,72019,Regular
4JN16CS069,17CSL47,34,24,58,P,6,72019,Regular
4JN16CS069,17CSL48,35,30,65,P,7,72019,Regular
4JN16CS069,17CS32,21,16,37,F,0,72019,Backlog
4JN16CS069,17CS34,20,9,29,F,0,72019,Backlog
4JN16CS069,17CS35,19,11,30,F,0,72019,Backlog
4JN16CS069,17CS36,20,0,20,A,0,72019,Backlog
4JN16CS076,17MAT41,21,29,50,P,6,72019,Regular
4JN16CS076,17CS42,25,26,51,P,6,72019,Regular
4JN16CS076,17CS43,27,32,59,P,6,72019,Regular
4JN16CS076,17CS44,22,29,51,P,6,72019,Regular
4JN16CS076,17CS45,26,3,29,F,0,72019,Regular
4JN16CS076,17CS46,20,15,35,F,0,72019,Regular
4JN16CS076,17CSL47,35,42,77,P,8,72019,Regular
4JN16CS076,17CSL48,30,42,72,P,8,72019,Regular
4JN16CS076,17CS33,27,33,60,P,7,72019,Backlog
4JN16CS076,17CS35,19,24,43,P,4,72019,Backlog
4JN16CS076,17CS36,25,21,46,P,5,72019,Backlog
4JN16CS081,17MAT41,21,24,45,P,5,72019,Regular
4JN16CS081,17CS42,21,11,32,F,0,72019,Regular
4JN16CS081,17CS43,26,15,41,F,0,72019,Regular
4JN16CS081,17CS44,20,23,43,P,4,72019,Regular
4JN16CS081,17CS45,26,27,53,P,6,72019,Regular
4JN16CS081,17CS46,19,22,41,P,4,72019,Regular
4JN16CS081,17CSL47,34,38,72,P,8,72019,Regular
4JN16CS081,17CSL48,30,26,56,P,6,72019,Regular
4JN16CS081,17CS32,30,6,36,F,0,72019,Backlog
4JN16CS081,17CS33,26,18,44,F,0,72019,Backlog
4JN16CS081,17CS36,25,21,46,P,5,72019,Backlog
4JN16CS081,15MAT21,17,22,39,F,0,72019,Backlog
4JN16CS081,15MAT11,7,23,30,F,0,72019,Backlog
4JN16CS081,15PCD13,9,13,22,F,0,72019,Backlog
4JN17CS007,17MAT41,28,38,66,P,7,72019,Regular
4JN17CS007,17CS42,33,36,69,P,7,72019,Regular
4JN17CS007,17CS43,35,21,56,P,6,72019,Regular
4JN17CS007,17CS44,29,21,50,P,6,72019,Regular
4JN17CS007,17CS45,29,26,55,P,6,72019,Regular
4JN17CS007,17CS46,25,27,52,P,6,72019,Regular
4JN17CS007,17CSL47,38,33,71,P,8,72019,Regular
4JN17CS007,17CSL48,36,26,62,P,7,72019,Regular
4JN17CS007,17CPH49,15,13,28,P,0,72019,Regular
4JN17CS008,17MAT41,40,55,95,P,10,72019,Regular
4JN17CS008,17CS42,39,34,73,P,8,72019,Regular
4JN17CS008,17CS43,40,41,81,P,9,72019,Regular
4JN17CS008,17CS44,37,27,64,P,7,72019,Regular
4JN17CS008,17CS45,40,36,76,P,8,72019,Regular
4JN17CS008,17CS46,33,42,75,P,8,72019,Regular
4JN17CS008,17CSL47,40,59,99,P,10,72019,Regular
4JN17CS008,17CSL48,40,60,100,P,10,72019,Regular
4JN17CS008,17CPH49,13,10,23,P,0,72019,Regular
4JN17CS009,17MAT41,40,39,79,P,8,72019,Regular
4JN17CS009,17CS42,37,39,76,P,8,72019,Regular
4JN17CS009,17CS43,40,36,76,P,8,72019,Regular
4JN17CS009,17CS44,36,31,67,P,7,72019,Regular
4JN17CS009,17CS45,37,23,60,P,7,72019,Regular
4JN17CS009,17CS46,28,35,63,P,7,72019,Regular
4JN17CS009,17CSL47,40,59,99,P,10,72019,Regular
4JN17CS009,17CSL48,40,59,99,P,10,72019,Regular
4JN17CS009,17CPH49,15,13,28,P,0,72019,Regular
4JN17CS011,17MAT41,32,36,68,P,7,72019,Regular
4JN17CS011,17CS42,28,21,49,P,5,72019,Regular
4JN17CS011,17CS43,38,30,68,P,7,72019,Regular
4JN17CS011,17CS44,20,37,57,P,6,72019,Regular
4JN17CS011,17CS45,32,25,57,P,6,72019,Regular
4JN17CS011,17CS46,20,30,50,P,6,72019,Regular
4JN17CS011,17CSL47,36,34,70,P,8,72019,Regular
4JN17CS011,17CSL48,32,33,65,P,7,72019,Regular
4JN17CS011,17CPH49,15,10,25,P,0,72019,Regular
4JN17CS015,17MAT41,40,37,77,P,8,72019,Regular
4JN17CS015,17CS42,35,33,68,P,7,72019,Regular
4JN17CS015,17CS43,36,33,69,P,7,72019,Regular
4JN17CS015,17CS44,27,34,61,P,7,72019,Regular
4JN17CS015,17CS45,31,33,64,P,7,72019,Regular
4JN17CS015,17CS46,21,26,47,P,5,72019,Regular
4JN17CS015,17CSL47,38,48,86,P,9,72019,Regular
4JN17CS015,17CSL48,25,54,79,P,8,72019,Regular
4JN17CS015,17CPH49,14,10,24,P,0,72019,Regular
4JN17CS015,17CS33,22,32,54,P,6,72019,Backlog
4JN17CS015,17CS36,26,28,54,P,6,72019,Backlog
4JN17CS017,17MAT41,19,0,19,F,0,72019,Regular
4JN17CS017,17CS42,21,21,42,P,4,72019,Regular
4JN17CS017,17CS43,16,5,21,F,0,72019,Regular
4JN17CS017,17CS44,19,12,31,F,0,72019,Regular
4JN17CS017,17CS45,19,8,27,F,0,72019,Regular
4JN17CS017,17CS46,14,23,37,F,0,72019,Regular
4JN17CS017,17CSL47,30,38,68,P,7,72019,Regular
4JN17CS017,17CSL48,28,26,54,P,6,72019,Regular
4JN17CS017,17CPH49,13,10,23,P,0,72019,Regular
4JN17CS017,17CS32,24,13,37,F,0,72019,Backlog
4JN17CS017,17CS33,20,21,41,P,4,72019,Backlog
4JN17CS017,17CS34,20,18,38,F,0,72019,Backlog
4JN17CS017,17CS35,19,4,23,F,0,72019,Backlog
4JN17CS017,17MAT21,20,15,35,F,0,72019,Backlog
4JN17CS017,17MAT11,20,21,41,P,4,72019,Backlog
4JN17CS017,17PHY12,19,25,44,P,4,72019,Backlog
4JN17CS020,17MAT41,34,30,64,P,7,72019,Regular
4JN17CS020,17CS42,33,21,54,P,6,72019,Regular
4JN17CS020,17CS43,34,29,63,P,7,72019,Regular
4JN17CS020,17CS44,27,35,62,P,7,72019,Regular
4JN17CS020,17CS45,34,34,68,P,7,72019,Regular
4JN17CS020,17CS46,22,33,55,P,6,72019,Regular
4JN17CS020,17CSL47,36,56,92,P,10,72019,Regular
4JN17CS020,17CSL48,27,51,78,P,8,72019,Regular
4JN17CS020,17CPH49,14,10,24,P,0,72019,Regular
4JN17CS021,17MAT41,26,29,55,P,6,72019,Regular
4JN17CS021,17CS42,29,35,64,P,7,72019,Regular
4JN17CS021,17CS43,31,21,52,P,6,72019,Regular
4JN17CS021,17CS44,23,23,46,P,5,72019,Regular
4JN17CS021,17CS45,30,35,65,P,7,72019,Regular
4JN17CS021,17CS46,23,23,46,P,5,72019,Regular
4JN17CS021,17CSL47,36,47,83,P,9,72019,Regular
4JN17CS021,17CSL48,25,30,55,P,6,72019,Regular
4JN17CS021,17CPH49,16,10,26,P,0,72019,Regular
4JN17CS021,17CS36,30,21,51,P,6,72019,Backlog
4JN17CS021,17MAT11,19,11,30,F,0,72019,Backlog
4JN17CS022,17MAT41,31,25,56,P,6,72019,Regular
4JN17CS022,17CS42,33,21,54,P,6,72019,Regular
4JN17CS022,17CS43,34,21,55,P,6,72019,Regular
4JN17CS022,17CS44,32,21,53,P,6,72019,Regular
4JN17CS022,17CS45,29,29,58,P,6,72019,Regular
4JN17CS022,17CS46,24,24,48,P,5,72019,Regular
4JN17CS022,17CSL47,38,53,91,P,10,72019,Regular
4JN17CS022,17CSL48,38,42,80,P,9,72019,Regular
4JN17CS022,17CPH49,16,14,30,P,0,72019,Regular
4JN17CS024,17MAT41,24,26,50,P,6,72019,Regular
4JN17CS024,17CS42,30,26,56,P,6,72019,Regular
4JN17CS024,17CS43,26,14,40,F,0,72019,Regular
4JN17CS024,17CS44,23,14,37,F,0,72019,Regular
4JN17CS024,17CS45,25,21,46,P,5,72019,Regular
4JN17CS024,17CS46,15,25,40,P,4,72019,Regular
4JN17CS024,17CSL47,32,14,46,F,0,72019,Regular
4JN17CS024,17CSL48,28,1,29,F,0,72019,Regular
4JN17CS024,17CPH49,16,13,29,P,0,72019,Regular
4JN17CS024,17CS33,24,13,37,F,0,72019,Backlog
4JN17CS024,17CS34,24,21,45,P,5,72019,Backlog
4JN17CS024,17CS36,20,21,41,P,4,72019,Backlog
4JN17CS024,17MAT21,19,24,43,P,4,72019,Backlog
4JN17CS024,17PCD23,34,21,55,P,6,72019,Backlog
4JN17CS024,17PHY12,20,9,29,F,0,72019,Backlog
4JN17CS027,17MAT41,36,51,87,P,9,72019,Regular
4JN17CS027,17CS42,39,37,76,P,8,72019,Regular
4JN17CS027,17CS43,39,47,86,P,9,72019,Regular
4JN17CS027,17CS44,39,35,74,P,8,72019,Regular
4JN17CS027,17CS45,36,32,68,P,7,72019,Regular
4JN17CS027,17CS46,36,33,69,P,7,72019,Regular
4JN17CS027,17CSL47,40,56,96,P,10,72019,Regular
4JN17CS027,17CSL48,40,60,100,P,10,72019,Regular
4JN17CS027,17CPH49,13,15,28,P,0,72019,Regular
4JN17CS028,17MAT41,40,59,99,P,10,72019,Regular
4JN17CS028,17CS42,39,42,81,P,9,72019,Regular
4JN17CS028,17CS43,40,53,93,P,10,72019,Regular
4JN17CS028,17CS44,39,48,87,P,9,72019,Regular
4JN17CS028,17CS45,35,21,56,P,6,72019,Regular
4JN17CS028,17CS46,33,28,61,P,7,72019,Regular
4JN17CS028,17CSL47,40,60,100,P,10,72019,Regular
4JN17CS028,17CSL48,38,60,98,P,10,72019,Regular
4JN17CS028,17CPH49,15,13,28,P,0,72019,Regular
4JN17CS029,17MAT41,22,38,60,P,7,72019,Regular
4JN17CS029,17CS42,22,24,46,P,5,72019,Regular
4JN17CS029,17CS43,22,28,50,P,6,72019,Regular
4JN17CS029,17CS44,19,27,46,P,5,72019,Regular
4JN17CS029,17CS45,22,21,43,P,4,72019,Regular
4JN17CS029,17CS46,15,21,36,F,0,72019,Regular
4JN17CS029,17CSL47,30,35,65,P,7,72019,Regular
4JN17CS029,17CSL48,25,28,53,P,6,72019,Regular
4JN17CS029,17CPH49,12,10,22,P,0,72019,Regular
4JN17CS029,17CS33,21,17,38,F,0,72019,Backlog
4JN17CS029,17CS36,20,11,31,F,0,72019,Backlog
4JN17CS033,17MAT41,32,45,77,P,8,72019,Regular
4JN17CS033,17CS42,33,29,62,P,7,72019,Regular
4JN17CS033,17CS43,35,33,68,P,7,72019,Regular
4JN17CS033,17CS44,28,30,58,P,6,72019,Regular
4JN17CS033,17CS45,36,27,63,P,7,72019,Regular
4JN17CS033,17CS46,25,34,59,P,6,72019,Regular
4JN17CS033,17CSL47,38,34,72,P,8,72019,Regular
4JN17CS033,17CSL48,32,52,84,P,9,72019,Regular
4JN17CS033,17CPH49,13,10,23,P,0,72019,Regular
4JN17CS034,17MAT41,24,28,52,P,6,72019,Regular
4JN17CS034,17CS42,28,23,51,P,6,72019,Regular
4JN17CS034,17CS43,32,31,63,P,7,72019,Regular
4JN17CS034,17CS44,23,21,44,P,4,72019,Regular
4JN17CS034,17CS45,29,21,50,P,6,72019,Regular
4JN17CS034,17CS46,22,23,45,P,5,72019,Regular
4JN17CS034,17CSL47,34,27,61,P,7,72019,Regular
4JN17CS034,17CSL48,30,14,44,F,0,72019,Regular
4JN17CS034,17CPH49,13,6,19,F,0,72019,Regular
4JN17CS034,17CS34,20,24,44,P,4,72019,Backlog
4JN17CS034,17CS36,20,23,43,P,4,72019,Backlog
4JN17CS036,17MAT41,32,33,65,P,7,72019,Regular
4JN17CS036,17CS42,31,26,57,P,6,72019,Regular
4JN17CS036,17CS43,38,33,71,P,8,72019,Regular
4JN17CS036,17CS44,26,22,48,P,5,72019,Regular
4JN17CS036,17CS45,24,21,45,P,5,72019,Regular
4JN17CS036,17CS46,22,25,47,P,5,72019,Regular
4JN17CS036,17CSL47,38,27,65,P,7,72019,Regular
4JN17CS036,17CSL48,32,27,59,P,6,72019,Regular
4JN17CS036,17CPH49,13,10,23,P,0,72019,Regular
4JN17CS040,17MAT41,24,21,45,P,5,72019,Regular
4JN17CS040,17CS42,26,21,47,P,5,72019,Regular
4JN17CS040,17CS43,34,35,69,P,7,72019,Regular
4JN17CS040,17CS44,20,21,41,P,4,72019,Regular
4JN17CS040,17CS45,27,35,62,P,7,72019,Regular
4JN17CS040,17CS46,23,25,48,P,5,72019,Regular
4JN17CS040,17CSL47,38,29,67,P,7,72019,Regular
4JN17CS040,17CSL48,30,26,56,P,6,72019,Regular
4JN17CS040,17CPH49,14,13,27,P,0,72019,Regular
4JN17CS040,17CS32,27,21,48,P,5,72019,Backlog
4JN17CS040,17CS34,25,21,46,P,5,72019,Backlog
4JN17CS040,17CS36,27,26,53,P,6,72019,Backlog
4JN17CS040,17MAT21,19,12,31,F,0,72019,Backlog
4JN17CS042,17MAT41,32,46,78,P,8,72019,Regular
4JN17CS042,17CS42,36,26,62,P,7,72019,Regular
4JN17CS042,17CS43,37,45,82,P,9,72019,Regular
4JN17CS042,17CS44,27,32,59,P,6,72019,Regular
4JN17CS042,17CS45,32,30,62,P,7,72019,Regular
4JN17CS042,17CS46,25,31,56,P,6,72019,Regular
4JN17CS042,17CSL47,36,51,87,P,9,72019,Regular
4JN17CS042,17CSL48,40,39,79,P,8,72019,Regular
4JN17CS042,17CPH49,15,10,25,P,0,72019,Regular
4JN17CS043,17MAT41,40,51,91,P,10,72019,Regular
4JN17CS043,17CS42,38,42,80,P,9,72019,Regular
4JN17CS043,17CS43,39,48,87,P,9,72019,Regular
4JN17CS043,17CS44,37,33,70,P,8,72019,Regular
4JN17CS043,17CS45,38,29,67,P,7,72019,Regular
4JN17CS043,17CS46,32,40,72,P,8,72019,Regular
4JN17CS043,17CSL47,36,45,81,P,9,72019,Regular
4JN17CS043,17CSL48,40,57,97,P,10,72019,Regular
4JN17CS043,17CPH49,14,12,26,P,0,72019,Regular
4JN17CS046,17MAT41,38,29,67,P,7,72019,Regular
4JN17CS046,17CS42,39,35,74,P,8,72019,Regular
4JN17CS046,17CS43,30,27,57,P,6,72019,Regular
4JN17CS046,17CS44,21,11,32,F,0,72019,Regular
4JN17CS046,17CS45,30,21,51,P,6,72019,Regular
4JN17CS046,17CS46,21,12,33,F,0,72019,Regular
4JN17CS046,17CSL47,35,56,91,P,10,72019,Regular
4JN17CS046,17CSL48,40,10,50,F,0,72019,Regular
4JN17CS046,17CPH49,15,13,28,P,0,72019,Regular
4JN17CS046,17ELE15,35,24,59,P,6,72019,Backlog
4JN17CS049,17MAT41,26,21,47,P,5,72019,Regular
4JN17CS049,17CS42,26,23,49,P,5,72019,Regular
4JN17CS049,17CS43,25,29,54,P,6,72019,Regular
4JN17CS049,17CS44,19,22,41,P,4,72019,Regular
4JN17CS049,17CS45,23,21,44,P,4,72019,Regular
4JN17CS049,17CS46,17,24,41,P,4,72019,Regular
4JN17CS049,17CSL47,34,53,87,P,9,72019,Regular
4JN17CS049,17CSL48,30,15,45,F,0,72019,Regular
4JN17CS049,17CPH49,14,15,29,P,0,72019,Regular
4JN17CS049,17CS33,23,26,49,P,5,72019,Backlog
4JN17CS049,17CS34,23,21,44,P,4,72019,Backlog
4JN17CS050,17MAT41,22,24,46,P,5,72019,Regular
4JN17CS050,17CS42,22,1,23,F,0,72019,Regular
4JN17CS050,17CS43,24,8,32,F,0,72019,Regular
4JN17CS050,17CS44,17,0,17,F,0,72019,Regular
4JN17CS050,17CS45,25,0,25,F,0,72019,Regular
4JN17CS050,17CS46,13,0,13,F,0,72019,Regular
4JN17CS050,17CSL47,30,31,61,P,7,72019,Regular
4JN17CS050,17CSL48,22,8,30,F,0,72019,Regular
4JN17CS050,17CPH49,11,10,21,P,0,72019,Regular
4JN17CS050,17CS32,24,16,40,F,0,72019,Backlog
4JN17CS050,17CS33,20,0,20,A,0,72019,Backlog
4JN17CS050,17CS34,20,7,27,F,0,72019,Backlog
4JN17CS050,17CS35,19,1,20,F,0,72019,Backlog
4JN17CS050,17CS36,20,0,20,A,0,72019,Backlog
4JN17CS050,17CSL38,29,0,29,F,0,72019,Backlog
4JN17CS050,17CHE22,15,33,48,P,5,72019,Backlog
4JN17CS050,17ELN25,19,3,22,F,0,72019,Backlog
4JN17CS051,17MAT41,37,35,72,P,8,72019,Regular
4JN17CS051,17CS42,38,21,59,P,6,72019,Regular
4JN17CS051,17CS43,40,27,67,P,7,72019,Regular
4JN17CS051,17CS44,33,38,71,P,8,72019,Regular
4JN17CS051,17CS45,32,32,64,P,7,72019,Regular
4JN17CS051,17CS46,28,35,63,P,7,72019,Regular
4JN17CS051,17CSL47,36,27,63,P,7,72019,Regular
4JN17CS051,17CSL48,38,34,72,P,8,72019,Regular
4JN17CS051,17CPH49,14,10,24,P,0,72019,Regular
4JN17CS052,17MAT41,23,26,49,P,5,72019,Regular
4JN17CS052,17CS42,28,24,52,P,6,72019,Regular
4JN17CS052,17CS43,30,23,53,P,6,72019,Regular
4JN17CS052,17CS44,22,29,51,P,6,72019,Regular
4JN17CS052,17CS45,29,22,51,P,6,72019,Regular
4JN17CS052,17CS46,25,21,46,P,5,72019,Regular
4JN17CS052,17CSL47,38,26,64,P,7,72019,Regular
4JN17CS052,17CSL48,30,24,54,P,6,72019,Regular
4JN17CS052,17CPH49,13,12,25,P,0,72019,Regular
4JN17CS053,17MAT41,29,27,56,P,6,72019,Regular
4JN17CS053,17CS42,31,21,52,P,6,72019,Regular
4JN17CS053,17CS43,33,22,55,P,6,72019,Regular
4JN17CS053,17CS44,19,23,42,P,4,72019,Regular
4JN17CS053,17CS45,22,26,48,P,5,72019,Regular
4JN17CS053,17CS46,23,27,50,P,6,72019,Regular
4JN17CS053,17CSL47,38,41,79,P,8,72019,Regular
4JN17CS053,17CSL48,30,28,58,P,6,72019,Regular
4JN17CS053,17CPH49,13,10,23,P,0,72019,Regular
4JN17CS053,17CS33,20,0,20,A,0,72019,Backlog
4JN17CS053,17CS34,22,21,43,P,4,72019,Backlog
4JN17CS053,17CS35,21,0,21,A,0,72019,Backlog
4JN17CS053,17CS36,23,32,55,P,6,72019,Backlog
4JN17CS053,17ELN25,35,32,67,P,7,72019,Backlog
4JN17CS055,17MAT41,27,27,54,P,6,72019,Regular
4JN17CS055,17CS42,30,30,60,P,7,72019,Regular
4JN17CS055,17CS43,38,27,65,P,7,72019,Regular
4JN17CS055,17CS44,24,31,55,P,6,72019,Regular
4JN17CS055,17CS45,29,21,50,P,6,72019,Regular
4JN17CS055,17CS46,23,21,44,P,4,72019,Regular
4JN17CS055,17CSL47,38,30,68,P,7,72019,Regular
4JN17CS055,17CSL48,38,54,92,P,10,72019,Regular
4JN17CS055,17CPH49,14,10,24,P,0,72019,Regular
4JN17CS056,17MAT41,39,60,99,P,10,72019,Regular
4JN17CS056,17CS42,40,41,81,P,9,72019,Regular
4JN17CS056,17CS43,39,40,79,P,8,72019,Regular
4JN17CS056,17CS44,36,45,81,P,9,72019,Regular
4JN17CS056,17CS45,40,48,88,P,9,72019,Regular
4JN17CS056,17CS46,33,30,63,P,7,72019,Regular
4JN17CS056,17CSL47,38,57,95,P,10,72019,Regular
4JN17CS056,17CSL48,40,42,82,P,9,72019,Regular
4JN17CS056,17CPH49,15,17,32,P,0,72019,Regular
4JN17CS059,17MAT41,35,42,77,P,8,72019,Regular
4JN17CS059,17CS42,40,36,76,P,8,72019,Regular
4JN17CS059,17CS43,36,28,64,P,7,72019,Regular
4JN17CS059,17CS44,33,32,65,P,7,72019,Regular
4JN17CS059,17CS45,27,22,49,P,5,72019,Regular
4JN17CS059,17CS46,26,31,57,P,6,72019,Regular
4JN17CS059,17CSL47,40,59,99,P,10,72019,Regular
4JN17CS059,17CSL48,40,57,97,P,10,72019,Regular
4JN17CS059,17CPH49,14,13,27,P,0,72019,Regular
4JN17CS060,17MAT41,28,27,55,P,6,72019,Regular
4JN17CS060,17CS42,31,21,52,P,6,72019,Regular
4JN17CS060,17CS43,37,29,66,P,7,72019,Regular
4JN17CS060,17CS44,31,18,49,F,0,72019,Regular
4JN17CS060,17CS45,26,23,49,P,5,72019,Regular
4JN17CS060,17CS46,25,24,49,P,5,72019,Regular
4JN17CS060,17CSL47,38,18,56,F,0,72019,Regular
4JN17CS060,17CSL48,30,36,66,P,7,72019,Regular
4JN17CS060,17CPH49,12,10,22,P,0,72019,Regular
4JN17CS060,17CS33,30,31,61,P,7,72019,Backlog
4JN17CS060,17CS35,27,21,48,P,5,72019,Backlog
4JN17CS061,17MAT41,37,41,78,P,8,72019,Regular
4JN17CS061,17CS42,35,21,56,P,6,72019,Regular
4JN17CS061,17CS43,35,26,61,P,7,72019,Regular
4JN17CS061,17CS44,25,42,67,P,7,72019,Regular
4JN17CS061,17CS45,31,36,67,P,7,72019,Regular
4JN17CS061,17CS46,22,27,49,P,5,72019,Regular
4JN17CS061,17CSL47,38,53,91,P,10,72019,Regular
4JN17CS061,17CSL48,35,44,79,P,8,72019,Regular
4JN17CS061,17CPH49,14,17,31,P,0,72019,Regular
4JN17CS061,17CS34,28,31,59,P,6,72019,Backlog
4JN17CS061,17CSL38,31,36,67,P,7,72019,Backlog
4JN17CS062,17MAT41,40,55,95,P,10,72019,Regular
4JN17CS062,17CS42,40,38,78,P,8,72019,Regular
4JN17CS062,17CS43,40,35,75,P,8,72019,Regular
4JN17CS062,17CS44,40,36,76,P,8,72019,Regular
4JN17CS062,17CS45,39,39,78,P,8,72019,Regular
4JN17CS062,17CS46,35,28,63,P,7,72019,Regular
4JN17CS062,17CSL47,40,57,97,P,10,72019,Regular
4JN17CS062,17CSL48,40,60,100,P,10,72019,Regular
4JN17CS062,17CPH49,14,13,27,P,0,72019,Regular
4JN17CS067,17MAT41,38,30,68,P,7,72019,Regular
4JN17CS067,17CS42,35,33,68,P,7,72019,Regular
4JN17CS067,17CS43,34,33,67,P,7,72019,Regular
4JN17CS067,17CS44,28,30,58,P,6,72019,Regular
4JN17CS067,17CS45,36,28,64,P,7,72019,Regular
4JN17CS067,17CS46,22,21,43,P,4,72019,Regular
4JN17CS067,17CSL47,38,58,96,P,10,72019,Regular
4JN17CS067,17CSL48,40,60,100,P,10,72019,Regular
4JN17CS067,17CPH49,12,12,24,P,0,72019,Regular
4JN17CS067,17CS34,30,23,53,P,6,72019,Backlog
4JN17CS069,17MAT41,40,55,95,P,10,72019,Regular
4JN17CS069,17CS42,39,41,80,P,9,72019,Regular
4JN17CS069,17CS43,40,46,86,P,9,72019,Regular
4JN17CS069,17CS44,37,41,78,P,8,72019,Regular
4JN17CS069,17CS45,40,36,76,P,8,72019,Regular
4JN17CS069,17CS46,39,29,68,P,7,72019,Regular
4JN17CS069,17CSL47,40,59,99,P,10,72019,Regular
4JN17CS069,17CSL48,40,60,100,P,10,72019,Regular
4JN17CS069,17CPH49,16,14,30,P,0,72019,Regular
4JN17CS070,17MAT41,39,51,90,P,10,72019,Regular
4JN17CS070,17CS42,38,35,73,P,8,72019,Regular
4JN17CS070,17CS43,38,45,83,P,9,72019,Regular
4JN17CS070,17CS44,37,45,82,P,9,72019,Regular
4JN17CS070,17CS45,39,31,70,P,8,72019,Regular
4JN17CS070,17CS46,39,38,77,P,8,72019,Regular
4JN17CS070,17CSL47,38,59,97,P,10,72019,Regular
4JN17CS070,17CSL48,40,54,94,P,10,72019,Regular
4JN17CS070,17CPH49,14,10,24,P,0,72019,Regular
4JN17CS077,17MAT41,40,51,91,P,10,72019,Regular
4JN17CS077,17CS42,40,28,68,P,7,72019,Regular
4JN17CS077,17CS43,40,41,81,P,9,72019,Regular
4JN17CS077,17CS44,33,29,62,P,7,72019,Regular
4JN17CS077,17CS45,33,29,62,P,7,72019,Regular
4JN17CS077,17CS46,27,28,55,P,6,72019,Regular
4JN17CS077,17CSL47,40,48,88,P,9,72019,Regular
4JN17CS077,17CSL48,36,59,95,P,10,72019,Regular
4JN17CS077,17CPH49,14,11,25,P,0,72019,Regular
4JN17CS078,17MAT41,40,48,88,P,9,72019,Regular
4JN17CS078,17CS42,39,31,70,P,8,72019,Regular
4JN17CS078,17CS43,36,38,74,P,8,72019,Regular
4JN17CS078,17CS44,35,35,70,P,8,72019,Regular
4JN17CS078,17CS45,36,27,63,P,7,72019,Regular
4JN17CS078,17CS46,39,21,60,P,7,72019,Regular
4JN17CS078,17CSL47,38,59,97,P,10,72019,Regular
4JN17CS078,17CSL48,38,57,95,P,10,72019,Regular
4JN17CS078,17CPH49,14,14,28,P,0,72019,Regular
4JN17CS079,17MAT41,29,38,67,P,7,72019,Regular
4JN17CS079,17CS42,30,22,52,P,6,72019,Regular
4JN17CS079,17CS43,37,26,63,P,7,72019,Regular
4JN17CS079,17CS44,24,24,48,P,5,72019,Regular
4JN17CS079,17CS45,28,21,49,P,5,72019,Regular
4JN17CS079,17CS46,20,21,41,P,4,72019,Regular
4JN17CS079,17CSL47,38,48,86,P,9,72019,Regular
4JN17CS079,17CSL48,32,26,58,P,6,72019,Regular
4JN17CS079,17CPH49,15,13,28,P,0,72019,Regular
4JN17CS080,17MAT41,22,42,64,P,7,72019,Regular
4JN17CS080,17CS42,29,35,64,P,7,72019,Regular
4JN17CS080,17CS43,34,21,55,P,6,72019,Regular
4JN17CS080,17CS44,24,33,57,P,6,72019,Regular
4JN17CS080,17CS45,36,39,75,P,8,72019,Regular
4JN17CS080,17CS46,19,32,51,P,6,72019,Regular
4JN17CS080,17CSL47,38,39,77,P,8,72019,Regular
4JN17CS080,17CSL48,30,33,63,P,7,72019,Regular
4JN17CS080,17CPH49,14,12,26,P,0,72019,Regular
4JN17CS083,17MAT41,40,56,96,P,10,72019,Regular
4JN17CS083,17CS42,40,38,78,P,8,72019,Regular
4JN17CS083,17CS43,40,39,79,P,8,72019,Regular
4JN17CS083,17CS44,38,44,82,P,9,72019,Regular
4JN17CS083,17CS45,38,37,75,P,8,72019,Regular
4JN17CS083,17CS46,38,38,76,P,8,72019,Regular
4JN17CS083,17CSL47,40,59,99,P,10,72019,Regular
4JN17CS083,17CSL48,38,59,97,P,10,72019,Regular
4JN17CS083,17CPH49,16,13,29,P,0,72019,Regular
4JN17CS087,17MAT41,40,57,97,P,10,72019,Regular
4JN17CS087,17CS42,40,38,78,P,8,72019,Regular
4JN17CS087,17CS43,40,48,88,P,9,72019,Regular
4JN17CS087,17CS44,40,37,77,P,8,72019,Regular
4JN17CS087,17CS45,36,36,72,P,8,72019,Regular
4JN17CS087,17CS46,39,49,88,P,9,72019,Regular
4JN17CS087,17CSL47,40,60,100,P,10,72019,Regular
4JN17CS087,17CSL48,38,60,98,P,10,72019,Regular
4JN17CS087,17CPH49,15,19,34,P,0,72019,Regular
4JN17CS088,17MAT41,33,31,64,P,7,72019,Regular
4JN17CS088,17CS42,28,21,49,P,5,72019,Regular
4JN17CS088,17CS43,34,26,60,P,7,72019,Regular
4JN17CS088,17CS44,21,16,37,F,0,72019,Regular
4JN17CS088,17CS45,24,10,34,F,0,72019,Regular
4JN17CS088,17CS46,19,16,35,F,0,72019,Regular
4JN17CS088,17CSL47,38,56,94,P,10,72019,Regular
4JN17CS088,17CSL48,30,60,90,P,10,72019,Regular
4JN17CS088,17CPH49,13,10,23,P,0,72019,Regular
4JN17CS090,17MAT41,25,40,65,P,7,72019,Regular
4JN17CS090,17CS42,25,26,51,P,6,72019,Regular
4JN17CS090,17CS43,27,34,61,P,7,72019,Regular
4JN17CS090,17CS44,21,21,42,P,4,72019,Regular
4JN17CS090,17CS45,22,23,45,P,5,72019,Regular
4JN17CS090,17CS46,19,25,44,P,4,72019,Regular
4JN17CS090,17CSL47,32,51,83,P,9,72019,Regular
4JN17CS090,17CSL48,30,27,57,P,6,72019,Regular
4JN17CS090,17CPH49,12,10,22,P,0,72019,Regular
4JN17CS090,17CS33,23,21,44,P,4,72019,Backlog
4JN17CS091,17MAT41,28,25,53,P,6,72019,Regular
4JN17CS091,17CS42,30,22,52,P,6,72019,Regular
4JN17CS091,17CS43,35,30,65,P,7,72019,Regular
4JN17CS091,17CS44,20,17,37,F,0,72019,Regular
4JN17CS091,17CS45,23,27,50,P,6,72019,Regular
4JN17CS091,17CS46,19,21,40,P,4,72019,Regular
4JN17CS091,17CSL47,38,54,92,P,10,72019,Regular
4JN17CS091,17CSL48,30,51,81,P,9,72019,Regular
4JN17CS091,17CPH49,13,7,20,F,0,72019,Regular
4JN17CS091,17CS36,26,36,62,P,7,72019,Backlog
4JN17CS092,17MAT41,40,57,97,P,10,72019,Regular
4JN17CS092,17CS42,39,41,80,P,9,72019,Regular
4JN17CS092,17CS43,37,39,76,P,8,72019,Regular
4JN17CS092,17CS44,35,23,58,P,6,72019,Regular
4JN17CS092,17CS45,32,30,62,P,7,72019,Regular
4JN17CS092,17CS46,30,29,59,P,6,72019,Regular
4JN17CS092,17CSL47,40,59,99,P,10,72019,Regular
4JN17CS092,17CSL48,40,51,91,P,10,72019,Regular
4JN17CS092,17CPH49,13,10,23,P,0,72019,Regular
4JN17CS097,17MAT41,29,23,52,P,6,72019,Regular
4JN17CS097,17CS42,26,25,51,P,6,72019,Regular
4JN17CS097,17CS43,36,26,62,P,7,72019,Regular
4JN17CS097,17CS44,28,18,46,F,0,72019,Regular
4JN17CS097,17CS45,32,24,56,P,6,72019,Regular
4JN17CS097,17CS46,29,29,58,P,6,72019,Regular
4JN17CS097,17CSL47,38,18,56,F,0,72019,Regular
4JN17CS097,17CSL48,30,51,81,P,9,72019,Regular
4JN17CS097,17CPH49,15,10,25,P,0,72019,Regular
4JN17CS097,17CS36,20,30,50,P,6,72019,Backlog
4JN17CS097,17MAT21,26,21,47,P,5,72019,Backlog
4JN17CS098,17MAT41,39,60,99,P,10,72019,Regular
4JN17CS098,17CS42,36,41,77,P,8,72019,Regular
4JN17CS098,17CS43,39,42,81,P,9,72019,Regular
4JN17CS098,17CS44,35,28,63,P,7,72019,Regular
4JN17CS098,17CS45,39,38,77,P,8,72019,Regular
4JN17CS098,17CS46,29,38,67,P,7,72019,Regular
4JN17CS098,17CSL47,39,59,98,P,10,72019,Regular
4JN17CS098,17CSL48,40,54,94,P,10,72019,Regular
4JN17CS098,17CPH49,13,13,26,P,0,72019,Regular
4JN17CS103,17MAT41,20,13,33,F,0,72019,Regular
4JN17CS103,17CS42,36,28,64,P,7,72019,Regular
4JN17CS103,17CS43,34,21,55,P,6,72019,Regular
4JN17CS103,17CS44,21,22,43,P,4,72019,Regular
4JN17CS103,17CS45,32,33,65,P,7,72019,Regular
4JN17CS103,17CS46,20,35,55,P,6,72019,Regular
4JN17CS103,17CSL47,38,30,68,P,7,72019,Regular
4JN17CS103,17CSL48,30,24,54,P,6,72019,Regular
4JN17CS103,17CPH49,13,15,28,P,0,72019,Regular
4JN17CS103,17MAT31,19,24,43,P,4,72019,Backlog
4JN17CS103,17CS36,27,26,53,P,6,72019,Backlog
4JN17CS103,17CSL38,34,29,63,P,7,72019,Backlog
4JN17CS103,17MAT11,19,21,40,P,4,72019,Backlog
4JN17CS108,17MAT41,38,47,85,P,9,72019,Regular
4JN17CS108,17CS42,39,38,77,P,8,72019,Regular
4JN17CS108,17CS43,39,48,87,P,9,72019,Regular
4JN17CS108,17CS44,36,35,71,P,8,72019,Regular
4JN17CS108,17CS45,40,35,75,P,8,72019,Regular
4JN17CS108,17CS46,35,39,74,P,8,72019,Regular
4JN17CS108,17CSL47,40,59,99,P,10,72019,Regular
4JN17CS108,17CSL48,40,59,99,P,10,72019,Regular
4JN17CS108,17CPH49,15,16,31,P,0,72019,Regular
4JN17CS109,17MAT41,28,30,58,P,6,72019,Regular
4JN17CS109,17CS42,33,21,54,P,6,72019,Regular
4JN17CS109,17CS43,36,17,53,F,0,72019,Regular
4JN17CS109,17CS44,25,24,49,P,5,72019,Regular
4JN17CS109,17CS45,30,21,51,P,6,72019,Regular
4JN17CS109,17CS46,24,43,67,P,7,72019,Regular
4JN17CS109,17CSL47,40,59,99,P,10,72019,Regular
4JN17CS109,17CSL48,40,29,69,P,7,72019,Regular
4JN17CS109,17CPH49,15,8,23,F,0,72019,Regular
4JN17CS110,17MAT41,32,41,73,P,8,72019,Regular
4JN17CS110,17CS42,36,24,60,P,7,72019,Regular
4JN17CS110,17CS43,39,32,71,P,8,72019,Regular
4JN17CS110,17CS44,25,28,53,P,6,72019,Regular
4JN17CS110,17CS45,32,21,53,P,6,72019,Regular
4JN17CS110,17CS46,24,42,66,P,7,72019,Regular
4JN17CS110,17CSL47,40,33,73,P,8,72019,Regular
4JN17CS110,17CSL48,38,30,68,P,7,72019,Regular
4JN17CS110,17CPH49,15,13,28,P,0,72019,Regular
4JN17CS114,17MAT41,25,28,53,P,6,72019,Regular
4JN17CS114,17CS42,35,26,61,P,7,72019,Regular
4JN17CS114,17CS43,32,32,64,P,7,72019,Regular
4JN17CS114,17CS44,21,23,44,P,4,72019,Regular
4JN17CS114,17CS45,30,24,54,P,6,72019,Regular
4JN17CS114,17CS46,23,27,50,P,6,72019,Regular
4JN17CS114,17CSL47,34,57,91,P,10,72019,Regular
4JN17CS114,17CSL48,35,27,62,P,7,72019,Regular
4JN17CS114,17CPH49,15,10,25,P,0,72019,Regular
4JN17CS115,17MAT41,36,41,77,P,8,72019,Regular
4JN17CS115,17CS42,36,42,78,P,8,72019,Regular
4JN17CS115,17CS43,39,36,75,P,8,72019,Regular
4JN17CS115,17CS44,37,33,70,P,8,72019,Regular
4JN17CS115,17CS45,37,34,71,P,8,72019,Regular
4JN17CS115,17CS46,26,26,52,P,6,72019,Regular
4JN17CS115,17CSL47,38,59,97,P,10,72019,Regular
4JN17CS115,17CSL48,40,57,97,P,10,72019,Regular
4JN17CS115,17CPH49,13,12,25,P,0,72019,Regular
4JN17CS122,17MAT41,35,39,74,P,8,72019,Regular
4JN17CS122,17CS42,36,30,66,P,7,72019,Regular
4JN17CS122,17CS43,39,29,68,P,7,72019,Regular
4JN17CS122,17CS44,26,34,60,P,7,72019,Regular
4JN17CS122,17CS45,29,30,59,P,6,72019,Regular
4JN17CS122,17CS46,22,27,49,P,5,72019,Regular
4JN17CS122,17CSL47,34,58,92,P,10,72019,Regular
4JN17CS122,17CSL48,30,56,86,P,9,72019,Regular
4JN17CS122,17CPH49,17,14,31,P,0,72019,Regular
4JN17CS123,17MAT41,24,45,69,P,7,72019,Regular
4JN17CS123,17CS42,25,26,51,P,6,72019,Regular
4JN17CS123,17CS43,25,26,51,P,6,72019,Regular
4JN17CS123,17CS44,21,36,57,P,6,72019,Regular
4JN17CS123,17CS45,23,21,44,P,4,72019,Regular
4JN17CS123,17CS46,24,21,45,P,5,72019,Regular
4JN17CS123,17CSL47,35,39,74,P,8,72019,Regular
4JN17CS123,17CSL48,30,42,72,P,8,72019,Regular
4JN17CS123,17CPH49,15,14,29,P,0,72019,Regular
4JN17CS124,17MAT41,24,24,48,P,5,72019,Regular
4JN17CS124,17CS42,23,23,46,P,5,72019,Regular
4JN17CS124,17CS43,33,29,62,P,7,72019,Regular
4JN17CS124,17CS44,19,38,57,P,6,72019,Regular
4JN17CS124,17CS45,23,27,50,P,6,72019,Regular
4JN17CS124,17CS46,20,36,56,P,6,72019,Regular
4JN17CS124,17CSL47,36,39,75,P,8,72019,Regular
4JN17CS124,17CSL48,30,24,54,P,6,72019,Regular
4JN17CS124,17CPH49,12,10,22,P,0,72019,Regular
4JN17CS124,17CS36,30,36,66,P,7,72019,Backlog
4JN17CS127,17MAT41,34,25,59,P,6,72019,Regular
4JN17CS127,17CS42,27,33,60,P,7,72019,Regular
4JN17CS127,17CS43,32,26,58,P,6,72019,Regular
4JN17CS127,17CS44,23,30,53,P,6,72019,Regular
4JN17CS127,17CS45,27,30,57,P,6,72019,Regular
4JN17CS127,17CS46,22,25,47,P,5,72019,Regular
4JN17CS127,17CSL47,36,45,81,P,9,72019,Regular
4JN17CS127,17CSL48,38,57,95,P,10,72019,Regular
4JN17CS127,17CPH49,14,10,24,P,0,72019,Regular
4JN17CS127,17CS33,25,23,48,P,5,72019,Backlog
4JN17CS128,17MAT41,29,38,67,P,7,72019,Regular
4JN17CS128,17CS42,30,23,53,P,6,72019,Regular
4JN17CS128,17CS43,34,41,75,P,8,72019,Regular
4JN17CS128,17CS44,19,29,48,P,5,72019,Regular
4JN17CS128,17CS45,25,25,50,P,6,72019,Regular
4JN17CS128,17CS46,19,21,40,P,4,72019,Regular
4JN17CS128,17CSL47,34,48,82,P,9,72019,Regular
4JN17CS128,17CSL48,30,36,66,P,7,72019,Regular
4JN17CS128,17CPH49,12,10,22,P,0,72019,Regular
4JN17CS128,17CS36,32,29,61,P,7,72019,Backlog
4JN17CS129,17MAT41,30,35,65,P,7,72019,Regular
4JN17CS129,17CS42,30,29,59,P,6,72019,Regular
4JN17CS129,17CS43,29,27,56,P,6,72019,Regular
4JN17CS129,17CS44,22,23,45,P,5,72019,Regular
4JN17CS129,17CS45,23,21,44,P,4,72019,Regular
4JN17CS129,17CS46,19,24,43,P,4,72019,Regular
4JN17CS129,17CSL47,34,39,73,P,8,72019,Regular
4JN17CS129,17CSL48,35,30,65,P,7,72019,Regular
4JN17CS129,17CPH49,14,12,26,P,0,72019,Regular
4JN17CS130,17MAT41,22,41,63,P,7,72019,Regular
4JN17CS130,17CS42,24,32,56,P,6,72019,Regular
4JN17CS130,17CS43,31,30,61,P,7,72019,Regular
4JN17CS130,17CS44,23,39,62,P,7,72019,Regular
4JN17CS130,17CS45,23,27,50,P,6,72019,Regular
4JN17CS130,17CS46,22,30,52,P,6,72019,Regular
4JN17CS130,17CSL47,32,34,66,P,7,72019,Regular
4JN17CS130,17CSL48,30,36,66,P,7,72019,Regular
4JN17CS130,17CPH49,14,10,24,P,0,72019,Regular
4JN18CS400,17MAT41,21,9,30,F,0,72019,Regular
4JN18CS400,17MATDIP41,0,0,0,A,0,72019,Regular
4JN18CS400,17CS42,30,27,57,P,6,72019,Regular
4JN18CS400,17CS43,30,25,55,P,6,72019,Regular
4JN18CS400,17CS44,21,27,48,P,5,72019,Regular
4JN18CS400,17CS45,22,23,45,P,5,72019,Regular
4JN18CS400,17CS46,22,33,55,P,6,72019,Regular
4JN18CS400,17CSL47,31,27,58,P,6,72019,Regular
4JN18CS400,17CSL48,30,24,54,P,6,72019,Regular
4JN18CS400,17CPH49,14,8,22,F,0,72019,Regular
4JN18CS400,17MAT31,20,21,41,P,4,72019,Backlog
4JN18CS400,17MATDIP31,0,0,0,A,0,72019,Backlog
4JN18CS400,17CS33,19,21,40,P,4,72019,Backlog
4JN18CS400,17CS36,20,0,20,A,0,72019,Backlog
4JN18CS401,17MAT41,20,8,28,F,0,72019,Regular
4JN18CS401,17MATDIP41,0,0,0,A,0,72019,Regular
4JN18CS401,17CS42,38,42,80,P,9,72019,Regular
4JN18CS401,17CS43,30,18,48,F,0,72019,Regular
4JN18CS401,17CS44,19,35,54,P,6,72019,Regular
4JN18CS401,17CS45,23,27,50,P,6,72019,Regular
4JN18CS401,17CS46,22,27,49,P,5,72019,Regular
4JN18CS401,17CSL47,34,36,70,P,8,72019,Regular
4JN18CS401,17CSL48,30,26,56,P,6,72019,Regular
4JN18CS401,17CPH49,12,7,19,F,0,72019,Regular
4JN18CS401,17MAT31,20,29,49,P,5,72019,Backlog
4JN18CS401,17CS36,26,21,47,P,5,72019,Backlog
4JN18CS404,17MAT41,28,27,55,P,6,72019,Regular
4JN18CS404,17MATDIP41,0,0,0,A,0,72019,Regular
4JN18CS404,17CS42,29,34,63,P,7,72019,Regular
4JN18CS404,17CS43,36,29,65,P,7,72019,Regular
4JN18CS404,17CS44,25,26,51,P,6,72019,Regular
4JN18CS404,17CS45,30,36,66,P,7,72019,Regular
4JN18CS404,17CS46,25,27,52,P,6,72019,Regular
4JN18CS404,17CSL47,36,58,94,P,10,72019,Regular
4JN18CS404,17CSL48,30,36,66,P,7,72019,Regular
4JN18CS404,17CPH49,12,7,19,F,0,72019,Regular
4JN18CS409,17MAT41,26,21,47,P,5,72019,Regular
4JN18CS409,17MATDIP41,0,0,0,A,0,72019,Regular
4JN18CS409,17CS42,31,24,55,P,6,72019,Regular
4JN18CS409,17CS43,33,22,55,P,6,72019,Regular
4JN18CS409,17CS44,27,23,50,P,6,72019,Regular
4JN18CS409,17CS45,29,23,52,P,6,72019,Regular
4JN18CS409,17CS46,21,21,42,P,4,72019,Regular
4JN18CS409,17CSL47,36,53,89,P,9,72019,Regular
4JN18CS409,17CSL48,37,42,79,P,8,72019,Regular
4JN18CS409,17CPH49,14,13,27,P,0,72019,Regular
4JN18CS409,17CS32,33,18,51,F,0,72019,Backlog
4JN18CS411,17MATDIP41,0,7,7,F,0,72019,Regular
4JN18CS411,17MAT41,21,8,29,F,0,72019,Regular
4JN18CS411,17CS42,29,31,60,P,7,72019,Regular
4JN18CS411,17CS43,31,18,49,F,0,72019,Regular
4JN18CS411,17CS44,23,29,52,P,6,72019,Regular
4JN18CS411,17CS45,32,21,53,P,6,72019,Regular
4JN18CS411,17CS46,24,29,53,P,6,72019,Regular
4JN18CS411,17CSL47,34,9,43,F,0,72019,Regular
4JN18CS411,17CSL48,30,26,56,P,6,72019,Regular
4JN18CS411,17CPH49,13,10,23,P,0,72019,Regular
4JN18CS411,17MAT31,19,16,35,F,0,72019,Backlog
4JN18CS411,17CS36,24,23,47,P,5,72019,Backlog
4JN18CS412,17MATDIP41,0,12,12,F,0,72019,Regular
4JN18CS412,17MAT41,27,24,51,P,6,72019,Regular
4JN18CS412,17CS42,38,27,65,P,7,72019,Regular
4JN18CS412,17CS43,39,25,64,P,7,72019,Regular
4JN18CS412,17CS44,25,35,60,P,7,72019,Regular
4JN18CS412,17CS45,28,36,64,P,7,72019,Regular
4JN18CS412,17CS46,23,32,55,P,6,72019,Regular
4JN18CS412,17CSL47,40,8,48,F,0,72019,Regular
4JN18CS412,17CSL48,35,26,61,P,7,72019,Regular
4JN18CS412,17CPH49,14,10,24,P,0,72019,Regular
4JN18CS413,17MATDIP41,0,0,0,A,0,72019,Regular
4JN18CS413,17MAT41,26,21,47,P,5,72019,Regular
4JN18CS413,17CS42,32,39,71,P,8,72019,Regular
4JN18CS413,17CS43,33,41,74,P,8,72019,Regular
4JN18CS413,17CS44,27,36,63,P,7,72019,Regular
4JN18CS413,17CS45,29,28,57,P,6,72019,Regular
4JN18CS413,17CS46,24,29,53,P,6,72019,Regular
4JN18CS413,17CSL47,34,57,91,P,10,72019,Regular
4JN18CS413,17CSL48,30,42,72,P,8,72019,Regular
4JN18CS413,17CPH49,13,10,23,P,0,72019,Regular
4JN18CS413,17CS33,29,27,56,P,6,72019,Backlog
4JN18CS413,17CS34,25,32,57,P,6,72019,Backlog
4JN18CS414,17MAT41,19,0,19,A,0,72019,Regular
4JN18CS414,17MATDIP41,0,0,0,A,0,72019,Regular
4JN18CS414,17CS42,23,17,40,F,0,72019,Regular
4JN18CS414,17CS43,23,21,44,P,4,72019,Regular
4JN18CS414,17CS44,20,12,32,F,0,72019,Regular
4JN18CS414,17CS45,23,6,29,F,0,72019,Regular
4JN18CS414,17CS46,19,17,36,F,0,72019,Regular
4JN18CS414,17CSL47,36,8,44,F,0,72019,Regular
4JN18CS414,17CSL48,37,26,63,P,7,72019,Regular
4JN18CS414,17CPH49,13,8,21,F,0,72019,Regular
4JN18CS414,17CS32,30,0,30,A,0,72019,Backlog
4JN18CS414,17CS34,29,16,45,F,0,72019,Backlog
4JN18CS414,17CS36,21,0,21,A,0,72019,Backlog
4JN18CS416,17MAT41,25,26,51,P,6,72019,Regular
4JN18CS416,17MATDIP41,0,0,0,A,0,72019,Regular
4JN18CS416,17CS42,37,30,67,P,7,72019,Regular
4JN18CS416,17CS43,40,38,78,P,8,72019,Regular
4JN18CS416,17CS44,30,43,73,P,8,72019,Regular
4JN18CS416,17CS45,38,39,77,P,8,72019,Regular
4JN18CS416,17CS46,29,41,70,P,8,72019,Regular
4JN18CS416,17CSL47,38,45,83,P,9,72019,Regular
4JN18CS416,17CSL48,30,26,56,P,6,72019,Regular
4JN18CS416,17CPH49,14,15,29,P,0,72019,Regular
4JN18CS416,17MAT31,22,21,43,P,4,72019,Backlog
4JN18CS420,17MATDIP41,0,0,0,A,0,72019,Regular
4JN18CS420,17MAT41,19,11,30,F,0,72019,Regular
4JN18CS420,17CS42,25,24,49,P,5,72019,Regular
4JN18CS420,17CS43,24,21,45,P,5,72019,Regular
4JN18CS420,17CS44,16,8,24,F,0,72019,Regular
4JN18CS420,17CS45,22,17,39,F,0,72019,Regular
4JN18CS420,17CS46,20,22,42,P,4,72019,Regular
4JN18CS420,17CSL47,35,45,80,P,9,72019,Regular
4JN18CS420,17CSL48,30,26,56,P,6,72019,Regular
4JN18CS420,17CPH49,13,15,28,P,0,72019,Regular
4JN18CS420,17MATDIP31,0,5,5,F,0,72019,Backlog
4JN18CS420,17MAT31,19,0,19,A,0,72019,Backlog
4JN18CS420,17CS32,27,17,44,F,0,72019,Backlog
4JN18CS420,17CS33,25,21,46,P,5,72019,Backlog
4JN18CS420,17CS36,20,21,41,P,4,72019,Backlog
4JN18CS422,17MATDIP41,0,0,0,A,0,72019,Regular
4JN18CS422,17MAT41,25,33,58,P,6,72019,Regular
4JN18CS422,17CS42,35,31,66,P,7,72019,Regular
4JN18CS422,17CS43,35,32,67,P,7,72019,Regular
4JN18CS422,17CS44,22,27,49,P,5,72019,Regular
4JN18CS422,17CS45,32,31,63,P,7,72019,Regular
4JN18CS422,17CS46,28,31,59,P,6,72019,Regular
4JN18CS422,17CSL47,34,29,63,P,7,72019,Regular
4JN18CS422,17CSL48,30,26,56,P,6,72019,Regular
4JN18CS422,17CPH49,13,11,24,P,0,72019,Regular
4JN18CS422,17CS36,26,23,49,P,5,72019,Backlog
4JN18CS423,17MATDIP41,0,0,0,A,0,72019,Regular
4JN18CS423,17MAT41,21,21,42,P,4,72019,Regular
4JN18CS423,17CS42,37,27,64,P,7,72019,Regular
4JN18CS423,17CS43,33,33,66,P,7,72019,Regular
4JN18CS423,17CS44,26,21,47,P,5,72019,Regular
4JN18CS423,17CS45,27,30,57,P,6,72019,Regular
4JN18CS423,17CS46,22,33,55,P,6,72019,Regular
4JN18CS423,17CSL47,35,35,70,P,8,72019,Regular
4JN18CS423,17CSL48,30,42,72,P,8,72019,Regular
4JN18CS423,17CPH49,12,12,24,P,0,72019,Regular
4JN18CS423,17MAT31,21,26,47,P,5,72019,Backlog
4JN16CS004,17MAT41,31,32,63,P,7,72019,Regular
4JN16CS004,17CS42,22,26,48,P,5,72019,Regular
4JN16CS004,17CS43,28,28,56,P,6,72019,Regular
4JN16CS004,17CS44,31,26,57,P,6,72019,Regular
4JN16CS004,17CS45,34,21,55,P,6,72019,Regular
4JN16CS004,17CS46,21,21,42,P,4,72019,Regular
4JN16CS004,17CSL47,32,32,64,P,7,72019,Regular
4JN16CS004,17CSL48,25,42,67,P,7,72019,Regular
4JN16CS068,17MAT41,12,28,40,P,4,72019,Regular
4JN16CS068,17CS42,12,29,41,P,4,72019,Regular
4JN16CS068,17CS43,18,22,40,P,4,72019,Regular
4JN16CS068,17CS44,17,23,40,P,4,72019,Regular
4JN16CS068,17CS45,9,14,23,F,0,72019,Regular
4JN16CS068,17CS46,10,21,31,F,0,72019,Regular
4JN16CS068,17CSL47,28,17,45,F,0,72019,Regular
4JN16CS068,17CSL48,25,26,51,P,6,72019,Regular
4JN16CS068,17CPH49,12,10,22,P,0,72019,Regular
4JN17CS002,17MAT41,25,30,55,P,6,72019,Regular
4JN17CS002,17CS42,19,18,37,F,0,72019,Regular
4JN17CS002,17CS43,25,29,54,P,6,72019,Regular
4JN17CS002,17CS44,23,21,44,P,4,72019,Regular
4JN17CS002,17CS45,30,25,55,P,6,72019,Regular
4JN17CS002,17CS46,27,24,51,P,6,72019,Regular
4JN17CS002,17CSL47,32,41,73,P,8,72019,Regular
4JN17CS002,17CSL48,25,30,55,P,6,72019,Regular
4JN17CS002,17CPH49,16,10,26,P,0,72019,Regular
4JN17CS004,17MAT41,39,51,90,P,10,72019,Regular
4JN17CS004,17CS42,30,42,72,P,8,72019,Regular
4JN17CS004,17CS43,37,29,66,P,7,72019,Regular
4JN17CS004,17CS44,35,38,73,P,8,72019,Regular
4JN17CS004,17CS45,37,38,75,P,8,72019,Regular
4JN17CS004,17CS46,35,38,73,P,8,72019,Regular
4JN17CS004,17CSL47,40,55,95,P,10,72019,Regular
4JN17CS004,17CSL48,40,59,99,P,10,72019,Regular
4JN17CS004,17CPH49,15,12,27,P,0,72019,Regular
4JN17CS010,17MAT41,34,43,77,P,8,72019,Regular
4JN17CS010,17CS42,28,36,64,P,7,72019,Regular
4JN17CS010,17CS43,33,23,56,P,6,72019,Regular
4JN17CS010,17CS44,30,28,58,P,6,72019,Regular
4JN17CS010,17CS45,33,41,74,P,8,72019,Regular
4JN17CS010,17CS46,29,27,56,P,6,72019,Regular
4JN17CS010,17CSL47,33,59,92,P,10,72019,Regular
4JN17CS010,17CSL48,30,26,56,P,6,72019,Regular
4JN17CS010,17CPH49,19,12,31,P,0,72019,Regular
4JN17CS012,17MAT41,37,37,74,P,8,72019,Regular
4JN17CS012,17CS42,32,21,53,P,6,72019,Regular
4JN17CS012,17CS43,39,38,77,P,8,72019,Regular
4JN17CS012,17CS44,33,29,62,P,7,72019,Regular
4JN17CS012,17CS45,36,24,60,P,7,72019,Regular
4JN17CS012,17CS46,32,30,62,P,7,72019,Regular
4JN17CS012,17CSL47,33,59,92,P,10,72019,Regular
4JN19CS001,18MAT11,37,50,87,P,9,12020,Regular
4JN19CS001,18PHY12,25,44,69,P,7,12020,Regular
4JN19CS001,18ELE13,26,26,52,P,6,12020,Regular
4JN19CS001,18CIV14,36,25,61,P,7,12020,Regular
4JN19CS001,18EGDL15,38,45,83,P,9,12020,Regular
4JN19CS001,18PHYL16,35,42,77,P,8,12020,Regular
4JN19CS001,18ELEL17,38,53,91,P,10,12020,Regular
4JN19CS001,18EGH18,33,39,72,P,8,12020,Regular
4JN19CS002,18MAT11,37,51,88,P,9,12020,Regular
4JN19CS002,18PHY12,27,48,75,P,8,12020,Regular
4JN19CS002,18ELE13,36,36,72,P,8,12020,Regular
4JN19CS002,18CIV14,37,38,75,P,8,12020,Regular
4JN19CS002,18EGDL15,38,56,94,P,10,12020,Regular
4JN19CS002,18PHYL16,40,42,82,P,9,12020,Regular
4JN19CS002,18ELEL17,39,54,93,P,10,12020,Regular
4JN19CS002,18EGH18,27,43,70,P,8,12020,Regular
4JN19CS003,18MAT11,38,56,94,P,10,12020,Regular
4JN19CS003,18PHY12,32,57,89,P,9,12020,Regular
4JN19CS003,18ELE13,36,41,77,P,8,12020,Regular
4JN19CS003,18CIV14,38,33,71,P,8,12020,Regular
4JN19CS003,18EGDL15,38,54,92,P,10,12020,Regular
4JN19CS003,18PHYL16,40,41,81,P,9,12020,Regular
4JN19CS003,18ELEL17,39,57,96,P,10,12020,Regular
4JN19CS003,18EGH18,32,49,81,P,9,12020,Regular
4JN19CS004,18MAT11,26,29,55,P,6,12020,Regular
4JN19CS004,18PHY12,19,39,58,P,6,12020,Regular
4JN19CS004,18ELE13,22,31,53,P,6,12020,Regular
4JN19CS004,18CIV14,27,27,54,P,6,12020,Regular
4JN19CS004,18EGDL15,20,24,44,P,4,12020,Regular
4JN19CS004,18PHYL16,23,12,35,F,0,12020,Regular
4JN19CS004,18ELEL17,35,47,82,P,9,12020,Regular
4JN19CS004,18EGH18,30,39,69,P,7,12020,Regular
4JN19CS005,18MAT11,40,55,95,P,10,12020,Regular
4JN19CS005,18PHY12,37,47,84,P,9,12020,Regular
4JN19CS005,18ELE13,36,45,81,P,9,12020,Regular
4JN19CS005,18CIV14,37,32,69,P,7,12020,Regular
4JN19CS005,18EGDL15,40,47,87,P,9,12020,Regular
4JN19CS005,18PHYL16,37,53,90,P,10,12020,Regular
4JN19CS005,18ELEL17,38,54,92,P,10,12020,Regular
4JN19CS005,18EGH18,33,47,80,P,9,12020,Regular
4JN19CS006,18MAT11,38,50,88,P,9,12020,Regular
4JN19CS006,18PHY12,30,48,78,P,8,12020,Regular
4JN19CS006,18ELE13,33,26,59,P,6,12020,Regular
4JN19CS006,18CIV14,37,27,64,P,7,12020,Regular
4JN19CS006,18EGDL15,40,50,90,P,10,12020,Regular
4JN19CS006,18PHYL16,38,46,84,P,9,12020,Regular
4JN19CS006,18ELEL17,39,57,96,P,10,12020,Regular
4JN19CS006,18EGH18,22,42,64,P,7,12020,Regular
4JN19CS007,18MAT11,34,32,66,P,7,12020,Regular
4JN19CS007,18PHY12,29,45,74,P,8,12020,Regular
4JN19CS007,18ELE13,30,28,58,P,6,12020,Regular
4JN19CS007,18CIV14,34,38,72,P,8,12020,Regular
4JN19CS007,18EGDL15,40,56,96,P,10,12020,Regular
4JN19CS007,18PHYL16,36,44,80,P,9,12020,Regular
4JN19CS007,18ELEL17,37,57,94,P,10,12020,Regular
4JN19CS007,18EGH18,27,47,74,P,8,12020,Regular
4JN19CS008,18MAT11,32,38,70,P,8,12020,Regular
4JN19CS008,18PHY12,27,48,75,P,8,12020,Regular
4JN19CS008,18ELE13,29,30,59,P,6,12020,Regular
4JN19CS008,18CIV14,35,33,68,P,7,12020,Regular
4JN19CS008,18EGDL15,40,55,95,P,10,12020,Regular
4JN19CS008,18PHYL16,37,50,87,P,9,12020,Regular
4JN19CS008,18ELEL17,38,56,94,P,10,12020,Regular
4JN19CS008,18EGH18,29,37,66,P,7,12020,Regular
4JN19CS009,18MAT11,28,26,54,P,6,12020,Regular
4JN19CS009,18PHY12,16,34,50,P,6,12020,Regular
4JN19CS009,18ELE13,23,21,44,P,4,12020,Regular
4JN19CS009,18CIV14,24,16,40,F,0,12020,Regular
4JN19CS009,18EGDL15,20,36,56,P,6,12020,Regular
4JN19CS009,18PHYL16,31,20,51,F,0,12020,Regular
4JN19CS009,18ELEL17,35,53,88,P,9,12020,Regular
4JN19CS009,18EGH18,22,32,54,P,6,12020,Regular
4JN19CS010,18MAT11,21,33,54,P,6,12020,Regular
4JN19CS010,18PHY12,16,24,40,P,4,12020,Regular
4JN19CS010,18ELE13,16,12,28,F,0,12020,Regular
4JN19CS010,18CIV14,26,21,47,P,6,12020,Regular
4JN19CS010,18EGDL15,38,47,85,P,9,12020,Regular
4JN19CS010,18PHYL16,36,20,56,F,0,12020,Regular
4JN19CS010,18ELEL17,36,49,85,P,9,12020,Regular
4JN19CS010,18EGH18,29,45,74,P,8,12020,Regular
4JN19CS011,18MAT11,40,57,97,P,10,12020,Regular
4JN19CS011,18PHY12,34,44,78,P,8,12020,Regular
4JN19CS011,18ELE13,38,44,82,P,9,12020,Regular
4JN19CS011,18CIV14,38,36,74,P,8,12020,Regular
4JN19CS011,18EGDL15,40,53,93,P,10,12020,Regular
4JN19CS011,18PHYL16,38,30,68,P,7,12020,Regular
4JN19CS011,18ELEL17,39,57,96,P,10,12020,Regular
4JN19CS011,18EGH18,29,46,75,P,8,12020,Regular
4JN19CS012,18MAT11,38,45,83,P,9,12020,Regular
4JN19CS012,18PHY12,29,39,68,P,7,12020,Regular
4JN19CS012,18ELE13,36,30,66,P,7,12020,Regular
4JN19CS012,18CIV14,32,29,61,P,7,12020,Regular
4JN19CS012,18EGDL15,36,55,91,P,10,12020,Regular
4JN19CS012,18PHYL16,21,45,66,P,7,12020,Regular
4JN19CS012,18ELEL17,39,57,96,P,10,12020,Regular
4JN19CS012,18EGH18,28,45,73,P,8,12020,Regular
4JN19CS013,18MAT11,40,51,91,P,10,12020,Regular
4JN19CS013,18PHY12,32,38,70,P,8,12020,Regular
4JN19CS013,18ELE13,32,36,68,P,7,12020,Regular
4JN19CS013,18CIV14,36,30,66,P,7,12020,Regular
4JN19CS013,18EGDL15,40,30,70,P,8,12020,Regular
4JN19CS013,18PHYL16,40,54,94,P,10,12020,Regular
4JN19CS013,18ELEL17,39,59,98,P,10,12020,Regular
4JN19CS013,18EGH18,30,48,78,P,8,12020,Regular
4JN19CS014,18MAT11,38,48,86,P,9,12020,Regular
4JN19CS014,18PHY12,31,43,74,P,8,12020,Regular
4JN19CS014,18ELE13,32,45,77,P,8,12020,Regular
4JN19CS014,18CIV14,35,36,71,P,8,12020,Regular
4JN19CS014,18EGDL15,40,54,94,P,10,12020,Regular
4JN19CS014,18PHYL16,37,46,83,P,9,12020,Regular
4JN19CS014,18ELEL17,39,58,97,P,10,12020,Regular
4JN19CS014,18EGH18,33,48,81,P,9,12020,Regular
4JN19CS015,18MAT11,36,45,81,P,9,12020,Regular
4JN19CS015,18PHY12,28,38,66,P,7,12020,Regular
4JN19CS015,18ELE13,30,29,59,P,6,12020,Regular
4JN19CS015,18CIV14,33,27,60,P,7,12020,Regular
4JN19CS015,18EGDL15,40,48,88,P,9,12020,Regular
4JN19CS015,18PHYL16,40,44,84,P,9,12020,Regular
4JN19CS015,18ELEL17,39,56,95,P,10,12020,Regular
4JN19CS015,18EGH18,26,38,64,P,7,12020,Regular
4JN19CS016,18MAT11,33,44,77,P,8,12020,Regular
4JN19CS016,18PHY12,24,38,62,P,7,12020,Regular
4JN19CS016,18ELE13,28,13,41,F,0,Jan-20,
4JN19CS016,18CIV14,37,40,77,P,8,12020,Regular
4JN19CS016,18EGDL15,36,37,73,P,8,12020,Regular
4JN19CS016,18PHYL16,25,41,66,P,7,12020,Regular
4JN19CS016,18ELEL17,37,54,91,P,10,12020,Regular
4JN19CS016,18EGH18,32,45,77,P,8,12020,Regular
4JN19CS017,18MAT11,31,23,54,P,6,12020,Regular
4JN19CS017,18PHY12,20,32,52,P,6,12020,Regular
4JN19CS017,18ELE13,24,32,56,P,6,12020,Regular
4JN19CS017,18CIV14,29,33,62,P,7,12020,Regular
4JN19CS017,18EGDL15,39,41,80,P,9,12020,Regular
4JN19CS017,18PHYL16,32,44,76,P,8,12020,Regular
4JN19CS017,18ELEL17,39,51,90,P,10,12020,Regular
4JN19CS017,18EGH18,29,36,65,P,7,12020,Regular
4JN19CS018,18MAT11,40,50,90,P,10,12020,Regular
4JN19CS018,18PHY12,36,46,82,P,9,12020,Regular
4JN19CS018,18ELE13,29,41,70,P,8,12020,Regular
4JN19CS018,18CIV14,35,42,77,P,8,12020,Regular
4JN19CS018,18EGDL15,37,32,69,P,7,12020,Regular
4JN19CS018,18PHYL16,37,47,84,P,9,12020,Regular
4JN19CS018,18ELEL17,37,54,91,P,10,12020,Regular
4JN19CS018,18EGH18,34,52,86,P,9,12020,Regular
4JN19CS019,18MAT11,33,50,83,P,9,12020,Regular
4JN19CS019,18PHY12,28,46,74,P,8,12020,Regular
4JN19CS019,18ELE13,29,39,68,P,7,12020,Regular
4JN19CS019,18CIV14,36,32,68,P,7,12020,Regular
4JN19CS019,18EGDL15,38,30,68,P,7,12020,Regular
4JN19CS019,18PHYL16,38,44,82,P,9,12020,Regular
4JN19CS019,18ELEL17,38,53,91,P,10,12020,Regular
4JN19CS019,18EGH18,30,45,75,P,8,12020,Regular
4JN19CS020,18MAT11,38,53,91,P,10,12020,Regular
4JN19CS020,18PHY12,25,50,75,P,8,12020,Regular
4JN19CS020,18ELE13,37,38,75,P,8,12020,Regular
4JN19CS020,18CIV14,34,39,73,P,8,12020,Regular
4JN19CS020,18EGDL15,39,24,63,P,7,12020,Regular
4JN19CS020,18PHYL16,40,46,86,P,9,12020,Regular
4JN19CS020,18ELEL17,38,55,93,P,10,12020,Regular
4JN19CS020,18EGH18,30,41,71,P,8,12020,Regular
4JN19CS022,18MAT11,37,58,95,P,10,12020,Regular
4JN19CS022,18PHY12,33,46,79,P,8,12020,Regular
4JN19CS022,18ELE13,33,33,66,P,7,12020,Regular
4JN19CS022,18CIV14,34,33,67,P,7,12020,Regular
4JN19CS022,18EGDL15,40,50,90,P,10,12020,Regular
4JN19CS022,18PHYL16,34,50,84,P,9,12020,Regular
4JN19CS022,18ELEL17,38,56,94,P,10,12020,Regular
4JN19CS022,18EGH18,28,41,69,P,7,12020,Regular
4JN19CS023,18MAT11,33,38,71,P,8,12020,Regular
4JN19CS023,18PHY12,30,48,78,P,8,12020,Regular
4JN19CS023,18ELE13,29,38,67,P,7,12020,Regular
4JN19CS023,18CIV14,34,40,74,P,8,12020,Regular
4JN19CS023,18EGDL15,37,24,61,P,7,12020,Regular
4JN19CS023,18PHYL16,21,49,70,P,8,12020,Regular
4JN19CS023,18ELEL17,38,56,94,P,10,12020,Regular
4JN19CS023,18EGH18,33,42,75,P,8,12020,Regular
4JN19CS024,18MAT11,33,31,64,P,7,12020,Regular
4JN19CS024,18PHY12,27,29,56,P,6,12020,Regular
4JN19CS024,18ELE13,30,30,60,P,7,12020,Regular
4JN19CS024,18CIV14,35,38,73,P,8,12020,Regular
4JN19CS024,18EGDL15,40,42,82,P,9,12020,Regular
4JN19CS024,18PHYL16,27,33,60,P,7,12020,Regular
4JN19CS024,18ELEL17,36,54,90,P,10,12020,Regular
4JN19CS024,18EGH18,23,41,64,P,7,12020,Regular
4JN19CS025,18MAT11,34,50,84,P,9,12020,Regular
4JN19CS025,18PHY12,22,38,60,P,7,12020,Regular
4JN19CS025,18ELE13,28,41,69,P,7,12020,Regular
4JN19CS025,18CIV14,38,36,74,P,8,12020,Regular
4JN19CS025,18EGDL15,40,44,84,P,9,12020,Regular
4JN19CS025,18PHYL16,23,45,68,P,7,12020,Regular
4JN19CS025,18ELEL17,37,56,93,P,10,12020,Regular
4JN19CS025,18EGH18,26,47,73,P,8,12020,Regular
4JN19CS026,18MAT11,40,60,100,P,10,12020,Regular
4JN19CS026,18PHY12,33,52,85,P,9,12020,Regular
4JN19CS026,18ELE13,38,45,83,P,9,12020,Regular
4JN19CS026,18CIV14,39,43,82,P,9,12020,Regular
4JN19CS026,18EGDL15,40,57,97,P,10,12020,Regular
4JN19CS026,18PHYL16,38,51,89,P,9,12020,Regular
4JN19CS026,18ELEL17,37,55,92,P,10,12020,Regular
4JN19CS026,18EGH18,32,47,79,P,8,12020,Regular
4JN19CS027,18MAT11,40,57,97,P,10,12020,Regular
4JN19CS027,18PHY12,37,58,95,P,10,12020,Regular
4JN19CS027,18ELE13,36,52,88,P,9,12020,Regular
4JN19CS027,18CIV14,36,36,72,P,8,12020,Regular
4JN19CS027,18EGDL15,40,58,98,P,10,12020,Regular
4JN19CS027,18PHYL16,38,54,92,P,10,12020,Regular
4JN19CS027,18ELEL17,37,45,82,P,9,12020,Regular
4JN19CS027,18EGH18,32,45,77,P,8,12020,Regular
4JN19CS028,18MAT11,25,25,50,P,6,12020,Regular
4JN19CS028,18PHY12,19,18,37,F,0,12020,Regular
4JN19CS028,18ELE13,18,27,45,P,6,12020,Regular
4JN19CS028,18CIV14,24,14,38,F,0,12020,Regular
4JN19CS028,18EGDL15,37,40,77,P,8,12020,Regular
4JN19CS028,18PHYL16,20,36,56,P,6,12020,Regular
4JN19CS028,18ELEL17,38,44,82,P,9,12020,Regular
4JN19CS028,18EGH18,22,30,52,P,6,12020,Regular
4JN19CS029,18MAT11,25,32,57,P,6,12020,Regular
4JN19CS029,18PHY12,19,23,42,P,4,12020,Regular
4JN19CS029,18ELE13,20,15,35,F,0,Jan-20,
4JN19CS029,18CIV14,26,15,41,F,0,Jan-20,
4JN19CS029,18EGDL15,36,26,62,P,7,12020,Regular
4JN19CS029,18PHYL16,30,28,58,P,6,12020,Regular
4JN19CS029,18ELEL17,37,48,85,P,9,12020,Regular
4JN19CS029,18EGH18,31,42,73,P,8,12020,Regular
4JN19CS030,18MAT11,28,38,66,P,7,12020,Regular
4JN19CS030,18PHY12,20,24,44,P,4,12020,Regular
4JN19CS030,18ELE13,22,27,49,P,6,12020,Regular
4JN19CS030,18CIV14,26,24,50,P,6,12020,Regular
4JN19CS030,18EGDL15,37,49,86,P,9,12020,Regular
4JN19CS030,18PHYL16,32,43,75,P,8,12020,Regular
4JN19CS030,18ELEL17,37,50,87,P,9,12020,Regular
4JN19CS030,18EGH18,22,46,68,P,7,12020,Regular
4JN19CS031,18MAT11,23,53,76,P,8,12020,Regular
4JN19CS031,18PHY12,26,43,69,P,7,12020,Regular
4JN19CS031,18ELE13,29,34,63,P,7,12020,Regular
4JN19CS031,18CIV14,36,38,74,P,8,12020,Regular
4JN19CS031,18EGDL15,35,39,74,P,8,12020,Regular
4JN19CS031,18PHYL16,31,42,73,P,8,12020,Regular
4JN19CS031,18ELEL17,38,51,89,P,9,12020,Regular
4JN19CS031,18EGH18,27,33,60,P,7,12020,Regular
4JN19CS032,18MAT11,18,22,40,P,4,12020,Regular
4JN19CS032,18PHY12,16,10,26,F,0,12020,Regular
4JN19CS032,18ELE13,16,5,21,F,0,12020,Regular
4JN19CS032,18CIV14,22,3,25,F,0,12020,Regular
4JN19CS032,18EGDL15,36,24,60,P,7,12020,Regular
4JN19CS032,18PHYL16,28,24,52,P,6,12020,Regular
4JN19CS032,18ELEL17,33,39,72,P,8,12020,Regular
4JN19CS032,18EGH18,20,35,55,P,6,12020,Regular
4JN19CS033,18MAT11,32,48,80,P,9,12020,Regular
4JN19CS033,18PHY12,20,41,61,P,7,12020,Regular
4JN19CS033,18ELE13,33,30,63,P,7,12020,Regular
4JN19CS033,18CIV14,38,28,66,P,7,12020,Regular
4JN19CS033,18EGDL15,37,51,88,P,9,12020,Regular
4JN19CS033,18PHYL16,35,43,78,P,8,12020,Regular
4JN19CS033,18ELEL17,39,49,88,P,9,12020,Regular
4JN19CS033,18EGH18,26,32,58,P,6,12020,Regular
4JN19CS034,18MAT11,34,46,80,P,9,12020,Regular
4JN19CS034,18PHY12,26,38,64,P,7,12020,Regular
4JN19CS034,18ELE13,32,30,62,P,7,12020,Regular
4JN19CS034,18CIV14,28,21,49,P,6,12020,Regular
4JN19CS034,18EGDL15,38,41,79,P,8,12020,Regular
4JN19CS034,18PHYL16,33,33,66,P,7,12020,Regular
4JN19CS034,18ELEL17,37,51,88,P,9,12020,Regular
4JN19CS034,18EGH18,30,40,70,P,8,12020,Regular
4JN19CS035,18MAT11,38,48,86,P,9,12020,Regular
4JN19CS035,18PHY12,27,39,66,P,7,12020,Regular
4JN19CS035,18ELE13,36,36,72,P,8,12020,Regular
4JN19CS035,18CIV14,37,26,63,P,7,12020,Regular
4JN19CS035,18EGDL15,40,47,87,P,9,12020,Regular
4JN19CS035,18PHYL16,38,49,87,P,9,12020,Regular
4JN19CS035,18ELEL17,39,51,90,P,10,12020,Regular
4JN19CS035,18EGH18,26,45,71,P,8,12020,Regular
4JN19CS036,18MAT11,37,39,76,P,8,12020,Regular
4JN19CS036,18PHY12,29,47,76,P,8,12020,Regular
4JN19CS036,18ELE13,36,41,77,P,8,12020,Regular
4JN19CS036,18CIV14,36,37,73,P,8,12020,Regular
4JN19CS036,18EGDL15,39,48,87,P,9,12020,Regular
4JN19CS036,18PHYL16,30,45,75,P,8,12020,Regular
4JN19CS036,18ELEL17,38,53,91,P,10,12020,Regular
4JN19CS036,18EGH18,30,42,72,P,8,12020,Regular
4JN19CS037,18MAT11,38,56,94,P,10,12020,Regular
4JN19CS037,18PHY12,29,49,78,P,8,12020,Regular
4JN19CS037,18ELE13,38,45,83,P,9,12020,Regular
4JN19CS037,18CIV14,35,21,56,P,6,12020,Regular
4JN19CS037,18EGDL15,39,36,75,P,8,12020,Regular
4JN19CS037,18PHYL16,31,51,82,P,9,12020,Regular
4JN19CS037,18ELEL17,39,51,90,P,10,12020,Regular
4JN19CS037,18EGH18,22,35,57,P,6,12020,Regular
4JN19CS038,18MAT11,40,57,97,P,10,12020,Regular
4JN19CS038,18PHY12,35,54,89,P,9,12020,Regular
4JN19CS038,18ELE13,40,46,86,P,9,12020,Regular
4JN19CS038,18CIV14,40,27,67,P,7,12020,Regular
4JN19CS038,18EGDL15,38,51,89,P,9,12020,Regular
4JN19CS038,18PHYL16,37,51,88,P,9,12020,Regular
4JN19CS038,18ELEL17,39,51,90,P,10,12020,Regular
4JN19CS038,18EGH18,33,45,78,P,8,12020,Regular
4JN19CS039,18MAT11,34,33,67,P,7,12020,Regular
4JN19CS039,18PHY12,24,29,53,P,6,12020,Regular
4JN19CS039,18ELE13,26,33,59,P,6,12020,Regular
4JN19CS039,18CIV14,29,11,40,F,0,Jan-20,
4JN19CS039,18EGDL15,38,24,62,P,7,12020,Regular
4JN19CS039,18PHYL16,32,47,79,P,8,12020,Regular
4JN19CS039,18ELEL17,37,51,88,P,9,12020,Regular
4JN19CS039,18EGH18,22,39,61,P,7,12020,Regular
4JN19CS040,18MAT11,33,45,78,P,8,12020,Regular
4JN19CS040,18PHY12,23,30,53,P,6,12020,Regular
4JN19CS040,18ELE13,34,31,65,P,7,12020,Regular
4JN19CS040,18CIV14,38,21,59,P,6,12020,Regular
4JN19CS040,18EGDL15,39,38,77,P,8,12020,Regular
4JN19CS040,18PHYL16,32,43,75,P,8,12020,Regular
4JN19CS040,18ELEL17,37,50,87,P,9,12020,Regular
4JN19CS040,18EGH18,20,36,56,P,6,12020,Regular
4JN19CS041,18MAT11,37,51,88,P,9,12020,Regular
4JN19CS041,18PHY12,33,53,86,P,9,12020,Regular
4JN19CS041,18ELE13,39,47,86,P,9,12020,Regular
4JN19CS041,18CIV14,32,45,77,P,8,12020,Regular
4JN19CS041,18EGDL15,39,44,83,P,9,12020,Regular
4JN19CS041,18PHYL16,38,43,81,P,9,12020,Regular
4JN19CS041,18ELEL17,38,53,91,P,10,12020,Regular
4JN19CS041,18EGH18,29,42,71,P,8,12020,Regular
4JN19CS042,18MAT11,38,48,86,P,9,12020,Regular
4JN19CS042,18PHY12,28,43,71,P,8,12020,Regular
4JN19CS042,18ELE13,34,29,63,P,7,12020,Regular
4JN19CS042,18CIV14,37,21,58,P,6,12020,Regular
4JN19CS042,18EGDL15,39,45,84,P,9,12020,Regular
4JN19CS042,18PHYL16,28,51,79,P,8,12020,Regular
4JN19CS042,18ELEL17,38,48,86,P,9,12020,Regular
4JN19CS042,18EGH18,22,33,55,P,6,12020,Regular
4JN19CS043,18MAT11,30,45,75,P,8,12020,Regular
4JN19CS043,18PHY12,22,32,54,P,6,12020,Regular
4JN19CS043,18ELE13,33,24,57,P,6,Jan-20,
4JN19CS043,18CIV14,32,21,53,P,6,Jan-20,
4JN19CS043,18EGDL15,37,26,63,P,7,12020,Regular
4JN19CS043,18PHYL16,25,51,76,P,8,12020,Regular
4JN19CS043,18ELEL17,37,50,87,P,9,12020,Regular
4JN19CS043,18EGH18,25,48,73,P,8,12020,Regular
4JN19CS044,18MAT11,35,40,75,P,8,Jan-20,
4JN19CS044,18PHY12,30,50,80,P,9,12020,Regular
4JN19CS044,18ELE13,38,38,76,P,8,12020,Regular
4JN19CS044,18CIV14,34,32,66,P,7,12020,Regular
4JN19CS044,18EGDL15,39,49,88,P,9,12020,Regular
4JN19CS044,18PHYL16,33,47,80,P,9,12020,Regular
4JN19CS044,18ELEL17,38,52,90,P,10,12020,Regular
4JN19CS044,18EGH18,28,42,70,P,8,12020,Regular
4JN19CS045,18MAT11,27,22,49,P,6,12020,Regular
4JN19CS045,18PHY12,19,21,40,P,4,12020,Regular
4JN19CS045,18ELE13,30,8,38,F,0,12020,Regular
4JN19CS045,18CIV14,30,15,45,F,0,12020,Regular
4JN19CS045,18EGDL15,38,51,89,P,9,12020,Regular
4JN19CS045,18PHYL16,29,42,71,P,8,12020,Regular
4JN19CS045,18ELEL17,38,51,89,P,9,12020,Regular
4JN19CS045,18EGH18,30,36,66,P,7,12020,Regular
4JN19CS046,18MAT11,40,48,88,P,9,12020,Regular
4JN19CS046,18PHY12,27,34,61,P,7,12020,Regular
4JN19CS046,18ELE13,38,33,71,P,8,12020,Regular
4JN19CS046,18CIV14,38,33,71,P,8,12020,Regular
4JN19CS046,18EGDL15,38,33,71,P,8,12020,Regular
4JN19CS046,18PHYL16,32,53,85,P,9,12020,Regular
4JN19CS046,18ELEL17,37,53,90,P,10,12020,Regular
4JN19CS046,18EGH18,29,44,73,P,8,12020,Regular
4JN19CS047,18MAT11,40,54,94,P,10,12020,Regular
4JN19CS047,18PHY12,38,50,88,P,9,12020,Regular
4JN19CS047,18ELE13,38,42,80,P,9,12020,Regular
4JN19CS047,18CIV14,40,48,88,P,9,12020,Regular
4JN19CS047,18EGDL15,39,54,93,P,10,12020,Regular
4JN19CS047,18PHYL16,39,54,93,P,10,12020,Regular
4JN19CS047,18ELEL17,39,56,95,P,10,12020,Regular
4JN19CS047,18EGH18,29,50,79,P,8,12020,Regular
4JN19CS048,18MAT11,32,41,73,P,8,12020,Regular
4JN19CS048,18PHY12,23,40,63,P,7,12020,Regular
4JN19CS048,18ELE13,37,25,62,P,7,12020,Regular
4JN19CS048,18CIV14,36,22,58,P,6,Jan-20,
4JN19CS048,18EGDL15,24,50,74,P,8,12020,Regular
4JN19CS048,18PHYL16,31,48,79,P,8,12020,Regular
4JN19CS048,18ELEL17,36,47,83,P,9,12020,Regular
4JN19CS048,18EGH18,24,35,59,P,6,12020,Regular
4JN19CS049,18MAT11,39,53,92,P,10,12020,Regular
4JN19CS049,18PHY12,32,38,70,P,8,12020,Regular
4JN19CS049,18ELE13,37,41,78,P,8,12020,Regular
4JN19CS049,18CIV14,39,27,66,P,7,12020,Regular
4JN19CS049,18EGDL15,30,50,80,P,9,12020,Regular
4JN19CS049,18PHYL16,32,40,72,P,8,12020,Regular
4JN19CS049,18ELEL17,37,51,88,P,9,12020,Regular
4JN19CS049,18EGH18,29,43,72,P,8,12020,Regular
4JN19CS050,18MAT11,40,60,100,P,10,12020,Regular
4JN19CS050,18PHY12,33,52,85,P,9,12020,Regular
4JN19CS050,18ELE13,39,46,85,P,9,12020,Regular
4JN19CS050,18CIV14,39,41,80,P,9,12020,Regular
4JN19CS050,18EGDL15,33,56,89,P,9,12020,Regular
4JN19CS050,18PHYL16,32,40,72,P,8,12020,Regular
4JN19CS050,18ELEL17,37,53,90,P,10,12020,Regular
4JN19CS050,18EGH18,31,42,73,P,8,12020,Regular
4JN19CS051,18MAT11,40,51,91,P,10,12020,Regular
4JN19CS051,18PHY12,30,42,72,P,8,12020,Regular
4JN19CS051,18ELE13,34,38,72,P,8,12020,Regular
4JN19CS051,18CIV14,40,32,72,P,8,12020,Regular
4JN19CS051,18EGDL15,38,56,94,P,10,12020,Regular
4JN19CS051,18PHYL16,39,39,78,P,8,12020,Regular
4JN19CS051,18ELEL17,38,50,88,P,9,12020,Regular
4JN19CS051,18EGH18,30,45,75,P,8,12020,Regular
4JN19CS052,18MAT11,34,44,78,P,8,12020,Regular
4JN19CS052,18PHY12,24,38,62,P,7,12020,Regular
4JN19CS052,18ELE13,32,32,64,P,7,12020,Regular
4JN19CS052,18CIV14,38,25,63,P,7,12020,Regular
4JN19CS052,18EGDL15,34,54,88,P,9,12020,Regular
4JN19CS052,18PHYL16,33,48,81,P,9,12020,Regular
4JN19CS052,18ELEL17,38,51,89,P,9,12020,Regular
4JN19CS052,18EGH18,32,47,79,P,8,12020,Regular
4JN19CS053,18MAT11,40,54,94,P,10,12020,Regular
4JN19CS053,18PHY12,24,32,56,P,6,12020,Regular
4JN19CS053,18ELE13,35,28,63,P,7,12020,Regular
4JN19CS053,18CIV14,37,32,69,P,7,12020,Regular
4JN19CS053,18EGDL15,30,47,77,P,8,12020,Regular
4JN19CS053,18PHYL16,34,44,78,P,8,12020,Regular
4JN19CS053,18ELEL17,36,48,84,P,9,12020,Regular
4JN19CS053,18EGH18,30,36,66,P,7,12020,Regular
4JN19CS054,18MAT11,32,41,73,P,8,12020,Regular
4JN19CS054,18PHY12,23,27,50,P,6,12020,Regular
4JN19CS054,18ELE13,33,26,59,P,6,12020,Regular
4JN19CS054,18CIV14,32,27,59,P,6,12020,Regular
4JN19CS054,18EGDL15,30,44,74,P,8,12020,Regular
4JN19CS054,18PHYL16,33,36,69,P,7,12020,Regular
4JN19CS054,18ELEL17,36,50,86,P,9,12020,Regular
4JN19CS054,18EGH18,29,41,70,P,8,12020,Regular
4JN19CS055,18MAT11,26,21,47,P,6,12020,Regular
4JN19CS055,18PHY12,20,21,41,P,4,12020,Regular
4JN19CS055,18ELE13,27,32,59,P,6,12020,Regular
4JN19CS055,18CIV14,26,21,47,P,6,12020,Regular
4JN19CS055,18EGDL15,29,53,82,P,9,12020,Regular
4JN19CS055,18PHYL16,35,33,68,P,7,12020,Regular
4JN19CS055,18ELEL17,38,50,88,P,9,12020,Regular
4JN19CS055,18EGH18,26,33,59,P,6,12020,Regular
4JN19CS056,18MAT11,37,39,76,P,8,12020,Regular
4JN19CS056,18PHY12,25,37,62,P,7,12020,Regular
4JN19CS056,18ELE13,37,30,67,P,7,12020,Regular
4JN19CS056,18CIV14,34,25,59,P,6,12020,Regular
4JN19CS056,18EGDL15,28,47,75,P,8,12020,Regular
4JN19CS056,18PHYL16,33,38,71,P,8,12020,Regular
4JN19CS056,18ELEL17,37,48,85,P,9,12020,Regular
4JN19CS056,18EGH18,25,38,63,P,7,12020,Regular
4JN19CS057,18MAT11,40,57,97,P,10,12020,Regular
4JN19CS057,18PHY12,31,39,70,P,8,12020,Regular
4JN19CS057,18ELE13,40,56,96,P,10,12020,Regular
4JN19CS057,18CIV14,40,32,72,P,8,12020,Regular
4JN19CS057,18EGDL15,40,54,94,P,10,12020,Regular
4JN19CS057,18PHYL16,36,50,86,P,9,12020,Regular
4JN19CS057,18ELEL17,39,53,92,P,10,12020,Regular
4JN19CS057,18EGH18,31,44,75,P,8,12020,Regular
4JN19CS058,18MAT11,37,55,92,P,10,12020,Regular
4JN19CS058,18PHY12,29,31,60,P,7,12020,Regular
4JN19CS058,18ELE13,38,33,71,P,8,12020,Regular
4JN19CS058,18CIV14,38,34,72,P,8,12020,Regular
4JN19CS058,18EGDL15,32,54,86,P,9,12020,Regular
4JN19CS058,18PHYL16,36,44,80,P,9,12020,Regular
4JN19CS058,18ELEL17,38,55,93,P,10,12020,Regular
4JN19CS058,18EGH18,28,45,73,P,8,12020,Regular
4JN19CS059,18MAT11,40,60,100,P,10,12020,Regular
4JN19CS059,18PHY12,33,47,80,P,9,12020,Regular
4JN19CS059,18ELE13,40,36,76,P,8,12020,Regular
4JN19CS059,18CIV14,39,32,71,P,8,12020,Regular
4JN19CS059,18EGDL15,32,54,86,P,9,12020,Regular
4JN19CS059,18PHYL16,38,38,76,P,8,12020,Regular
4JN19CS059,18ELEL17,39,59,98,P,10,12020,Regular
4JN19CS059,18EGH18,31,44,75,P,8,12020,Regular
4JN19CS060,18MAT11,27,39,66,P,7,12020,Regular
4JN19CS060,18PHY12,23,35,58,P,6,12020,Regular
4JN19CS060,18ELE13,31,27,58,P,6,12020,Regular
4JN19CS060,18CIV14,33,21,54,P,6,12020,Regular
4JN19CS060,18EGDL15,36,24,60,P,7,12020,Regular
4JN19CS060,18PHYL16,32,44,76,P,8,12020,Regular
4JN19CS060,18ELEL17,37,54,91,P,10,12020,Regular
4JN19CS060,18EGH18,30,41,71,P,8,12020,Regular
4JN19CS061,18MAT11,34,47,81,P,9,12020,Regular
4JN19CS061,18PHY12,28,27,55,P,6,12020,Regular
4JN19CS061,18ELE13,33,24,57,P,6,12020,Regular
4JN19CS061,18CIV14,34,28,62,P,7,12020,Regular
4JN19CS061,18EGDL15,31,51,82,P,9,12020,Regular
4JN19CS061,18PHYL16,33,48,81,P,9,12020,Regular
4JN19CS061,18ELEL17,37,51,88,P,9,12020,Regular
4JN19CS061,18EGH18,31,41,72,P,8,12020,Regular
4JN19CS062,18MAT11,40,60,100,P,10,12020,Regular
4JN19CS062,18PHY12,33,47,80,P,9,12020,Regular
4JN19CS062,18ELE13,39,40,79,P,8,12020,Regular
4JN19CS062,18CIV14,39,38,77,P,8,12020,Regular
4JN19CS062,18EGDL15,39,55,94,P,10,12020,Regular
4JN19CS062,18PHYL16,39,56,95,P,10,12020,Regular
4JN19CS062,18ELEL17,38,59,97,P,10,12020,Regular
4JN19CS062,18EGH18,29,46,75,P,8,12020,Regular
4JN19CS063,18MAT11,40,52,92,P,10,12020,Regular
4JN19CS063,18PHY12,37,52,89,P,9,12020,Regular
4JN19CS063,18ELE13,40,44,84,P,9,12020,Regular
4JN19CS063,18CIV14,37,33,70,P,8,12020,Regular
4JN19CS063,18EGDL15,33,42,75,P,8,12020,Regular
4JN19CS063,18PHYL16,35,53,88,P,9,12020,Regular
4JN19CS063,18ELEL17,38,57,95,P,10,12020,Regular
4JN19CS063,18EGH18,32,44,76,P,8,12020,Regular
4JN19CS064,18MAT11,24,14,38,F,0,12020,Regular
4JN19CS064,18PHY12,16,27,43,P,4,12020,Regular
4JN19CS064,18ELE13,25,15,40,F,0,12020,Regular
4JN19CS064,18CIV14,22,21,43,P,4,12020,Regular
4JN19CS064,18EGDL15,32,43,75,P,8,12020,Regular
4JN19CS064,18PHYL16,28,33,61,P,7,12020,Regular
4JN19CS064,18ELEL17,34,42,76,P,8,12020,Regular
4JN19CS064,18EGH18,22,33,55,P,6,12020,Regular
4JN19CS065,18MAT11,40,57,97,P,10,12020,Regular
4JN19CS065,18PHY12,39,54,93,P,10,12020,Regular
4JN19CS065,18ELE13,40,50,90,P,10,12020,Regular
4JN19CS065,18CIV14,40,54,94,P,10,12020,Regular
4JN19CS065,18EGDL15,37,54,91,P,10,12020,Regular
4JN19CS065,18PHYL16,40,56,96,P,10,12020,Regular
4JN19CS065,18ELEL17,39,59,98,P,10,12020,Regular
4JN19CS065,18EGH18,32,53,85,P,9,12020,Regular
4JN19CS066,18MAT11,34,36,70,P,8,12020,Regular
4JN19CS066,18PHY12,31,40,71,P,8,12020,Regular
4JN19CS066,18ELE13,34,45,79,P,8,12020,Regular
4JN19CS066,18CIV14,29,35,64,P,7,12020,Regular
4JN19CS066,18EGDL15,40,46,86,P,9,12020,Regular
4JN19CS066,18PHYL16,40,53,93,P,10,12020,Regular
4JN19CS066,18ELEL17,39,54,93,P,10,12020,Regular
4JN19CS066,18EGH18,32,44,76,P,8,12020,Regular
4JN19CS067,18MAT11,36,46,82,P,9,12020,Regular
4JN19CS067,18PHY12,26,47,73,P,8,12020,Regular
4JN19CS067,18ELE13,32,30,62,P,7,12020,Regular
4JN19CS067,18CIV14,34,27,61,P,7,12020,Regular
4JN19CS067,18EGDL15,38,45,83,P,9,12020,Regular
4JN19CS067,18PHYL16,25,33,58,P,6,12020,Regular
4JN19CS067,18ELEL17,38,53,91,P,10,12020,Regular
4JN19CS067,18EGH18,29,43,72,P,8,12020,Regular
4JN19CS068,18MAT11,26,24,50,P,6,12020,Regular
4JN19CS068,18PHY12,20,26,46,P,6,12020,Regular
4JN19CS068,18ELE13,28,25,53,P,6,12020,Regular
4JN19CS068,18CIV14,27,25,52,P,6,12020,Regular
4JN19CS068,18EGDL15,38,41,79,P,8,12020,Regular
4JN19CS068,18PHYL16,28,35,63,P,7,12020,Regular
4JN19CS068,18ELEL17,38,53,91,P,10,12020,Regular
4JN19CS068,18EGH18,23,39,62,P,7,12020,Regular
4JN19CS069,18MAT11,40,50,90,P,10,12020,Regular
4JN19CS069,18PHY12,33,49,82,P,9,12020,Regular
4JN19CS069,18ELE13,39,41,80,P,9,12020,Regular
4JN19CS069,18CIV14,39,32,71,P,8,12020,Regular
4JN19CS069,18EGDL15,40,58,98,P,10,12020,Regular
4JN19CS069,18PHYL16,39,51,90,P,10,12020,Regular
4JN19CS069,18ELEL17,39,59,98,P,10,12020,Regular
4JN19CS069,18EGH18,32,44,76,P,8,12020,Regular
4JN19CS070,18MAT11,39,48,87,P,9,12020,Regular
4JN19CS070,18PHY12,28,29,57,P,6,12020,Regular
4JN19CS070,18ELE13,38,35,73,P,8,12020,Regular
4JN19CS070,18CIV14,37,21,58,P,6,12020,Regular
4JN19CS070,18EGDL15,40,53,93,P,10,12020,Regular
4JN19CS070,18PHYL16,39,49,88,P,9,12020,Regular
4JN19CS070,18ELEL17,38,55,93,P,10,12020,Regular
4JN19CS070,18EGH18,31,48,79,P,8,12020,Regular
4JN19CS071,18MAT11,31,34,65,P,7,12020,Regular
4JN19CS071,18PHY12,22,33,55,P,6,12020,Regular
4JN19CS071,18ELE13,32,28,60,P,7,12020,Regular
4JN19CS071,18CIV14,24,29,53,P,6,12020,Regular
4JN19CS071,18EGDL15,37,53,90,P,10,12020,Regular
4JN19CS071,18PHYL16,31,41,72,P,8,12020,Regular
4JN19CS071,18ELEL17,38,54,92,P,10,12020,Regular
4JN19CS071,18EGH18,29,35,64,P,7,12020,Regular
4JN19CS072,18MAT11,35,48,83,P,9,12020,Regular
4JN19CS072,18PHY12,18,28,46,P,6,12020,Regular
4JN19CS072,18ELE13,32,21,53,P,6,12020,Regular
4JN19CS072,18CIV14,26,21,47,P,6,12020,Regular
4JN19CS072,18EGDL15,37,14,51,F,0,12020,Regular
4JN19CS072,18PHYL16,23,31,54,P,6,12020,Regular
4JN19CS072,18ELEL17,37,54,91,P,10,12020,Regular
4JN19CS072,18EGH18,28,47,75,P,8,12020,Regular
4JN19CS073,18MAT11,36,32,68,P,7,12020,Regular
4JN19CS073,18PHY12,27,36,63,P,7,12020,Regular
4JN19CS073,18ELE13,36,25,61,P,7,12020,Regular
4JN19CS073,18CIV14,32,23,55,P,6,12020,Regular
4JN19CS073,18EGDL15,35,39,74,P,8,12020,Regular
4JN19CS073,18PHYL16,32,60,92,P,10,12020,Regular
4JN19CS073,18ELEL17,39,54,93,P,10,12020,Regular
4JN19CS073,18EGH18,28,38,66,P,7,12020,Regular
4JN19CS074,18MAT11,39,46,85,P,9,12020,Regular
4JN19CS074,18PHY12,30,40,70,P,8,12020,Regular
4JN19CS074,18ELE13,39,37,76,P,8,12020,Regular
4JN19CS074,18CIV14,36,39,75,P,8,12020,Regular
4JN19CS074,18EGDL15,40,44,84,P,9,12020,Regular
4JN19CS074,18PHYL16,36,45,81,P,9,12020,Regular
4JN19CS074,18ELEL17,39,54,93,P,10,12020,Regular
4JN19CS074,18EGH18,29,39,68,P,7,12020,Regular
4JN19CS075,18MAT11,39,45,84,P,9,12020,Regular
4JN19CS075,18PHY12,32,39,71,P,8,12020,Regular
4JN19CS075,18ELE13,39,36,75,P,8,12020,Regular
4JN19CS075,18CIV14,39,38,77,P,8,12020,Regular
4JN19CS075,18EGDL15,37,48,85,P,9,12020,Regular
4JN19CS075,18PHYL16,35,49,84,P,9,12020,Regular
4JN19CS075,18ELEL17,39,59,98,P,10,12020,Regular
4JN19CS075,18EGH18,30,34,64,P,7,12020,Regular
4JN19CS076,18MAT11,32,44,76,P,8,12020,Regular
4JN19CS076,18PHY12,27,47,74,P,8,12020,Regular
4JN19CS076,18ELE13,34,36,70,P,8,12020,Regular
4JN19CS076,18CIV14,33,35,68,P,7,12020,Regular
4JN19CS076,18EGDL15,38,45,83,P,9,12020,Regular
4JN19CS076,18PHYL16,32,42,74,P,8,12020,Regular
4JN19CS076,18ELEL17,39,58,97,P,10,12020,Regular
4JN19CS076,18EGH18,29,41,70,P,8,12020,Regular
4JN19CS077,18MAT11,38,47,85,P,9,12020,Regular
4JN19CS077,18PHY12,23,38,61,P,7,12020,Regular
4JN19CS077,18ELE13,35,21,56,P,6,12020,Regular
4JN19CS077,18CIV14,36,21,57,P,6,12020,Regular
4JN19CS077,18EGDL15,38,35,73,P,8,12020,Regular
4JN19CS077,18PHYL16,35,31,66,P,7,12020,Regular
4JN19CS077,18ELEL17,39,59,98,P,10,12020,Regular
4JN19CS077,18EGH18,30,39,69,P,7,12020,Regular
4JN19CS078,18MAT11,29,30,59,P,6,12020,Regular
4JN19CS078,18PHY12,21,37,58,P,6,12020,Regular
4JN19CS078,18ELE13,29,15,44,F,0,Jan-20,
4JN19CS078,18CIV14,27,12,39,F,0,Jan-20,
4JN19CS078,18EGDL15,38,34,72,P,8,12020,Regular
4JN19CS078,18PHYL16,29,26,55,P,6,12020,Regular
4JN19CS078,18ELEL17,38,57,95,P,10,12020,Regular
4JN19CS078,18EGH18,24,40,64,P,7,12020,Regular
4JN19CS079,18MAT11,38,48,86,P,9,12020,Regular
4JN19CS079,18PHY12,31,45,76,P,8,12020,Regular
4JN19CS079,18ELE13,33,34,67,P,7,12020,Regular
4JN19CS079,18CIV14,33,24,57,P,6,12020,Regular
4JN19CS079,18EGDL15,37,33,70,P,8,12020,Regular
4JN19CS079,18PHYL16,32,37,69,P,7,12020,Regular
4JN19CS079,18ELEL17,39,59,98,P,10,12020,Regular
4JN19CS079,18EGH18,24,41,65,P,7,12020,Regular
4JN19CS080,18MAT11,38,39,77,P,8,12020,Regular
4JN19CS080,18PHY12,29,58,87,P,9,12020,Regular
4JN19CS080,18ELE13,38,34,72,P,8,12020,Regular
4JN19CS080,18CIV14,36,22,58,P,6,12020,Regular
4JN19CS080,18EGDL15,37,42,79,P,8,12020,Regular
4JN19CS080,18PHYL16,30,36,66,P,7,12020,Regular
4JN19CS080,18ELEL17,39,57,96,P,10,12020,Regular
4JN19CS080,18EGH18,23,36,59,P,6,12020,Regular
4JN19CS081,18MAT11,33,23,56,P,6,12020,Regular
4JN19CS081,18PHY12,27,44,71,P,8,12020,Regular
4JN19CS081,18ELE13,35,33,68,P,7,12020,Regular
4JN19CS081,18CIV14,32,23,55,P,6,12020,Regular
4JN19CS081,18EGDL15,35,48,83,P,9,12020,Regular
4JN19CS081,18PHYL16,38,37,75,P,8,12020,Regular
4JN19CS081,18ELEL17,38,58,96,P,10,12020,Regular
4JN19CS081,18EGH18,28,45,73,P,8,12020,Regular
4JN19CS082,18MAT11,40,54,94,P,10,12020,Regular
4JN19CS082,18PHY12,37,39,76,P,8,12020,Regular
4JN19CS082,18ELE13,40,44,84,P,9,12020,Regular
4JN19CS082,18CIV14,40,29,69,P,7,12020,Regular
4JN19CS082,18EGDL15,39,54,93,P,10,12020,Regular
4JN19CS082,18PHYL16,38,49,87,P,9,12020,Regular
4JN19CS082,18ELEL17,39,59,98,P,10,12020,Regular
4JN19CS082,18EGH18,30,45,75,P,8,12020,Regular
4JN19CS083,18MAT11,36,38,74,P,8,12020,Regular
4JN19CS083,18PHY12,29,34,63,P,7,12020,Regular
4JN19CS083,18ELE13,36,35,71,P,8,12020,Regular
4JN19CS083,18CIV14,32,26,58,P,6,12020,Regular
4JN19CS083,18EGDL15,38,47,85,P,9,12020,Regular
4JN19CS083,18PHYL16,34,45,79,P,8,12020,Regular
4JN19CS083,18ELEL17,39,57,96,P,10,12020,Regular
4JN19CS083,18EGH18,27,34,61,P,7,12020,Regular
4JN19CS084,18MAT11,33,48,81,P,9,12020,Regular
4JN19CS084,18PHY12,32,36,68,P,7,12020,Regular
4JN19CS084,18ELE13,34,24,58,P,6,12020,Regular
4JN19CS084,18CIV14,33,26,59,P,6,12020,Regular
4JN19CS084,18EGDL15,39,57,96,P,10,12020,Regular
4JN19CS084,18PHYL16,29,33,62,P,7,12020,Regular
4JN19CS084,18ELEL17,35,57,92,P,10,12020,Regular
4JN19CS084,18EGH18,27,40,67,P,7,12020,Regular
4JN19CS085,18MAT11,38,54,92,P,10,12020,Regular
4JN19CS085,18PHY12,35,41,76,P,8,12020,Regular
4JN19CS085,18ELE13,36,31,67,P,7,12020,Regular
4JN19CS085,18CIV14,38,30,68,P,7,12020,Regular
4JN19CS085,18EGDL15,37,42,79,P,8,12020,Regular
4JN19CS085,18PHYL16,34,46,80,P,9,12020,Regular
4JN19CS085,18ELEL17,38,52,90,P,10,12020,Regular
4JN19CS085,18EGH18,29,44,73,P,8,12020,Regular
4JN19CS086,18MAT11,38,60,98,P,10,12020,Regular
4JN19CS086,18PHY12,37,54,91,P,10,12020,Regular
4JN19CS086,18ELE13,40,51,91,P,10,12020,Regular
4JN19CS086,18CIV14,38,39,77,P,8,12020,Regular
4JN19CS086,18EGDL15,35,41,76,P,8,12020,Regular
4JN19CS086,18PHYL16,36,39,75,P,8,12020,Regular
4JN19CS086,18ELEL17,39,59,98,P,10,12020,Regular
4JN19CS086,18EGH18,32,44,76,P,8,12020,Regular
4JN19CS087,18MAT11,31,35,66,P,7,12020,Regular
4JN19CS087,18PHY12,26,47,73,P,8,12020,Regular
4JN19CS087,18ELE13,34,30,64,P,7,12020,Regular
4JN19CS087,18CIV14,34,23,57,P,6,12020,Regular
4JN19CS087,18EGDL15,35,36,71,P,8,12020,Regular
4JN19CS087,18PHYL16,27,17,44,F,0,12020,Regular
4JN19CS087,18ELEL17,37,50,87,P,9,12020,Regular
4JN19CS087,18EGH18,26,33,59,P,6,12020,Regular
4JN19CS088,18MAT11,27,39,66,P,7,12020,Regular
4JN19CS088,18CHE12,27,51,78,P,8,12020,Regular
4JN19CS088,18CPS13,27,38,65,P,7,12020,Regular
4JN19CS088,18ELN14,24,26,50,P,6,12020,Regular
4JN19CS088,18ME15,30,30,60,P,7,12020,Regular
4JN19CS088,18CHEL16,24,32,56,P,6,12020,Regular
4JN19CS088,18CPL17,25,57,82,P,9,12020,Regular
4JN19CS088,18EGH18,31,39,70,P,8,12020,Regular
4JN19CS089,18MAT11,31,30,61,P,7,12020,Regular
4JN19CS089,18PHY12,22,33,55,P,6,12020,Regular
4JN19CS089,18ELE13,29,29,58,P,6,12020,Regular
4JN19CS089,18CIV14,29,29,58,P,6,12020,Regular
4JN19CS089,18EGDL15,37,50,87,P,9,12020,Regular
4JN19CS089,18PHYL16,35,30,65,P,7,12020,Regular
4JN19CS089,18ELEL17,35,51,86,P,9,12020,Regular
4JN19CS089,18EGH18,32,47,79,P,8,12020,Regular
4JN19CS090,18MAT11,34,51,85,P,9,12020,Regular
4JN19CS090,18PHY12,26,37,63,P,7,12020,Regular
4JN19CS090,18ELE13,38,42,80,P,9,12020,Regular
4JN19CS090,18CIV14,33,22,55,P,6,12020,Regular
4JN19CS090,18EGDL15,38,55,93,P,10,12020,Regular
4JN19CS090,18PHYL16,29,40,69,P,7,12020,Regular
4JN19CS090,18ELEL17,39,53,92,P,10,12020,Regular
4JN19CS090,18EGH18,30,47,77,P,8,12020,Regular
4JN19CS091,18MAT11,22,18,40,F,0,Jan-20,
4JN19CS091,18PHY12,16,21,37,F,0,Jan-20,
4JN19CS091,18ELE13,24,23,47,P,6,Jan-20,
4JN19CS091,18CIV14,22,18,40,F,0,Jan-20,
4JN19CS091,18EGDL15,37,46,83,P,9,12020,Regular
4JN19CS091,18PHYL16,22,30,52,P,6,12020,Regular
4JN19CS091,18ELEL17,37,53,90,P,10,12020,Regular
4JN19CS091,18EGH18,26,36,62,P,7,12020,Regular
4JN19CS092,18MAT11,38,51,89,P,9,12020,Regular
4JN19CS092,18PHY12,30,48,78,P,8,12020,Regular
4JN19CS092,18ELE13,36,35,71,P,8,12020,Regular
4JN19CS092,18CIV14,35,25,60,P,7,12020,Regular
4JN19CS092,18EGDL15,38,43,81,P,9,12020,Regular
4JN19CS092,18PHYL16,34,48,82,P,9,12020,Regular
4JN19CS092,18ELEL17,38,55,93,P,10,12020,Regular
4JN19CS092,18EGH18,31,44,75,P,8,12020,Regular
4JN19CS093,18MAT11,40,49,89,P,9,12020,Regular
4JN19CS093,18PHY12,32,39,71,P,8,12020,Regular
4JN19CS093,18ELE13,39,44,83,P,9,12020,Regular
4JN19CS093,18CIV14,36,33,69,P,7,12020,Regular
4JN19CS093,18EGDL15,40,56,96,P,10,12020,Regular
4JN19CS093,18PHYL16,35,59,94,P,10,12020,Regular
4JN19CS093,18ELEL17,39,55,94,P,10,12020,Regular
4JN19CS093,18EGH18,32,48,80,P,9,12020,Regular
4JN19CS094,18MAT11,22,21,43,P,4,12020,Regular
4JN19CS094,18PHY12,18,14,32,F,0,12020,Regular
4JN19CS094,18ELE13,21,8,29,F,0,12020,Regular
4JN19CS094,18CIV14,23,3,26,F,0,12020,Regular
4JN19CS094,18EGDL15,30,12,42,F,0,12020,Regular
4JN19CS094,18PHYL16,30,25,55,P,6,12020,Regular
4JN19CS094,18ELEL17,38,53,91,P,10,12020,Regular
4JN19CS094,18EGH18,24,35,59,P,6,12020,Regular
4JN19CS095,18MAT11,34,47,81,P,9,12020,Regular
4JN19CS095,18PHY12,32,48,80,P,9,12020,Regular
4JN19CS095,18ELE13,28,27,55,P,6,12020,Regular
4JN19CS095,18CIV14,37,36,73,P,8,12020,Regular
4JN19CS095,18EGDL15,32,42,74,P,8,12020,Regular
4JN19CS095,18PHYL16,28,33,61,P,7,12020,Regular
4JN19CS095,18ELEL17,39,54,93,P,10,12020,Regular
4JN19CS095,18EGH18,30,47,77,P,8,12020,Regular
4JN19CS096,18MAT11,31,50,81,P,9,12020,Regular
4JN19CS096,18PHY12,27,39,66,P,7,12020,Regular
4JN19CS096,18ELE13,27,9,36,F,0,Jan-20,
4JN19CS096,18CIV14,25,31,56,P,6,12020,Regular
4JN19CS096,18EGDL15,38,47,85,P,9,12020,Regular
4JN19CS096,18PHYL16,37,43,80,P,9,12020,Regular
4JN19CS096,18ELEL17,39,54,93,P,10,12020,Regular
4JN19CS096,18EGH18,31,47,78,P,8,12020,Regular
4JN19CS097,18MAT11,33,52,85,P,9,12020,Regular
4JN19CS097,18PHY12,32,45,77,P,8,12020,Regular
4JN19CS097,18ELE13,30,37,67,P,7,12020,Regular
4JN19CS097,18CIV14,34,24,58,P,6,12020,Regular
4JN19CS097,18EGDL15,35,35,70,P,8,12020,Regular
4JN19CS097,18PHYL16,31,52,83,P,9,12020,Regular
4JN19CS097,18ELEL17,39,51,90,P,10,12020,Regular
4JN19CS097,18EGH18,31,47,78,P,8,12020,Regular
4JN19CS098,18MAT11,37,44,81,P,9,12020,Regular
4JN19CS098,18PHY12,34,39,73,P,8,12020,Regular
4JN19CS098,18ELE13,33,38,71,P,8,12020,Regular
4JN19CS098,18CIV14,36,39,75,P,8,12020,Regular
4JN19CS098,18EGDL15,35,44,79,P,8,12020,Regular
4JN19CS098,18PHYL16,37,49,86,P,9,12020,Regular
4JN19CS098,18ELEL17,39,53,92,P,10,12020,Regular
4JN19CS098,18EGH18,30,43,73,P,8,12020,Regular
4JN19CS099,18MAT11,35,47,82,P,9,12020,Regular
4JN19CS099,18PHY12,31,50,81,P,9,12020,Regular
4JN19CS099,18ELE13,27,29,56,P,6,12020,Regular
4JN19CS099,18CIV14,31,38,69,P,7,12020,Regular
4JN19CS099,18EGDL15,38,59,97,P,10,12020,Regular
4JN19CS099,18PHYL16,35,50,85,P,9,12020,Regular
4JN19CS099,18ELEL17,39,54,93,P,10,12020,Regular
4JN19CS099,18EGH18,30,43,73,P,8,12020,Regular
4JN19CS100,18MAT11,31,42,73,P,8,12020,Regular
4JN19CS100,18PHY12,24,27,51,P,6,12020,Regular
4JN19CS100,18ELE13,26,22,48,P,6,12020,Regular
4JN19CS100,18CIV14,31,23,54,P,6,12020,Regular
4JN19CS100,18EGDL15,32,34,66,P,7,12020,Regular
4JN19CS100,18PHYL16,31,27,58,P,6,12020,Regular
4JN19CS100,18ELEL17,38,53,91,P,10,12020,Regular
4JN19CS100,18EGH18,25,41,66,P,7,12020,Regular
4JN19CS101,18MAT11,20,29,49,P,6,12020,Regular
4JN19CS101,18PHY12,21,27,48,P,6,12020,Regular
4JN19CS101,18ELE13,19,26,45,P,6,12020,Regular
4JN19CS101,18CIV14,21,22,43,P,4,12020,Regular
4JN19CS101,18EGDL15,28,24,52,P,6,12020,Regular
4JN19CS101,18PHYL16,35,31,66,P,7,12020,Regular
4JN19CS101,18ELEL17,38,55,93,P,10,12020,Regular
4JN19CS101,18EGH18,26,46,72,P,8,12020,Regular
4JN19CS102,18MAT11,35,44,79,P,8,12020,Regular
4JN19CS102,18PHY12,34,46,80,P,9,12020,Regular
4JN19CS102,18ELE13,29,44,73,P,8,12020,Regular
4JN19CS102,18CIV14,35,45,80,P,9,12020,Regular
4JN19CS102,18EGDL15,35,36,71,P,8,12020,Regular
4JN19CS102,18PHYL16,35,56,91,P,10,12020,Regular
4JN19CS102,18ELEL17,39,54,93,P,10,12020,Regular
4JN19CS102,18EGH18,33,45,78,P,8,12020,Regular
4JN19CS103,18MAT11,36,36,72,P,8,12020,Regular
4JN19CS103,18PHY12,34,41,75,P,8,12020,Regular
4JN19CS103,18ELE13,32,39,71,P,8,12020,Regular
4JN19CS103,18CIV14,34,26,60,P,7,12020,Regular
4JN19CS103,18EGDL15,38,46,84,P,9,12020,Regular
4JN19CS103,18PHYL16,36,53,89,P,9,12020,Regular
4JN19CS103,18ELEL17,39,54,93,P,10,12020,Regular
4JN19CS103,18EGH18,25,42,67,P,7,12020,Regular
4JN19CS104,18MAT11,40,55,95,P,10,12020,Regular
4JN19CS104,18PHY12,35,54,89,P,9,12020,Regular
4JN19CS104,18ELE13,36,47,83,P,9,12020,Regular
4JN19CS104,18CIV14,38,41,79,P,8,12020,Regular
4JN19CS104,18EGDL15,38,59,97,P,10,12020,Regular
4JN19CS104,18PHYL16,37,54,91,P,10,12020,Regular
4JN19CS104,18ELEL17,39,54,93,P,10,12020,Regular
4JN19CS104,18EGH18,32,48,80,P,9,12020,Regular
4JN19CS105,18MAT11,34,41,75,P,8,12020,Regular
4JN19CS105,18PHY12,32,44,76,P,8,12020,Regular
4JN19CS105,18ELE13,31,45,76,P,8,12020,Regular
4JN19CS105,18CIV14,34,31,65,P,7,12020,Regular
4JN19CS105,18EGDL15,36,41,77,P,8,12020,Regular
4JN19CS105,18PHYL16,36,57,93,P,10,12020,Regular
4JN19CS105,18ELEL17,38,53,91,P,10,12020,Regular
4JN19CS105,18EGH18,30,46,76,P,8,12020,Regular
4JN19CS106,18MAT11,32,38,70,P,8,12020,Regular
4JN19CS106,18PHY12,21,0,21,A,0,12020,Regular
4JN19CS106,18ELE13,20,27,47,P,6,12020,Regular
4JN19CS106,18CIV14,29,0,29,A,0,12020,Regular
4JN19CS106,18EGDL15,31,0,31,A,0,12020,Regular
4JN19CS106,18PHYL16,30,0,30,A,0,12020,Regular
4JN19CS106,18ELEL17,39,0,39,A,0,12020,Regular
4JN19CS106,18EGH18,27,39,66,P,7,12020,Regular
4JN19CS107,18MAT11,35,45,80,P,9,12020,Regular
4JN19CS107,18PHY12,33,41,74,P,8,12020,Regular
4JN19CS107,18ELE13,29,39,68,P,7,12020,Regular
4JN19CS107,18CIV14,39,27,66,P,7,12020,Regular
4JN19CS107,18EGDL15,38,58,96,P,10,12020,Regular
4JN19CS107,18PHYL16,36,57,93,P,10,12020,Regular
4JN19CS107,18ELEL17,39,53,92,P,10,12020,Regular
4JN19CS107,18EGH18,30,42,72,P,8,12020,Regular
4JN19CS108,18MAT11,36,50,86,P,9,12020,Regular
4JN19CS108,18PHY12,24,38,62,P,7,12020,Regular
4JN19CS108,18ELE13,21,23,44,P,4,Jan-20,
4JN19CS108,18CIV14,34,28,62,P,7,12020,Regular
4JN19CS108,18EGDL15,36,59,95,P,10,12020,Regular
4JN19CS108,18PHYL16,26,53,79,P,8,12020,Regular
4JN19CS108,18ELEL17,38,54,92,P,10,12020,Regular
4JN19CS108,18EGH18,33,45,78,P,8,12020,Regular
4JN19CS109,18MAT11,27,38,65,P,7,12020,Regular
4JN19CS109,18PHY12,20,31,51,P,6,12020,Regular
4JN19CS109,18ELE13,25,32,57,P,6,12020,Regular
4JN19CS109,18CIV14,23,23,46,P,6,12020,Regular
4JN19CS109,18EGDL15,39,44,83,P,9,12020,Regular
4JN19CS109,18PHYL16,29,42,71,P,8,12020,Regular
4JN19CS109,18ELEL17,39,54,93,P,10,12020,Regular
4JN19CS109,18EGH18,25,29,54,P,6,12020,Regular
4JN19CS110,18MAT11,40,46,86,P,9,12020,Regular
4JN19CS110,18PHY12,35,56,91,P,10,12020,Regular
4JN19CS110,18ELE13,34,47,81,P,9,12020,Regular
4JN19CS110,18CIV14,40,47,87,P,9,12020,Regular
4JN19CS110,18EGDL15,38,60,98,P,10,12020,Regular
4JN19CS110,18PHYL16,37,56,93,P,10,12020,Regular
4JN19CS110,18ELEL17,39,54,93,P,10,12020,Regular
4JN19CS110,18EGH18,33,51,84,P,9,12020,Regular
4JN19CS111,18MAT11,30,45,75,P,8,12020,Regular
4JN19CS111,18PHY12,24,42,66,P,7,12020,Regular
4JN19CS111,18ELE13,27,29,56,P,6,12020,Regular
4JN19CS111,18CIV14,29,21,50,P,6,12020,Regular
4JN19CS111,18EGDL15,38,52,90,P,10,12020,Regular
4JN19CS111,18PHYL16,34,47,81,P,9,12020,Regular
4JN19CS111,18ELEL17,39,56,95,P,10,12020,Regular
4JN19CS111,18EGH18,27,39,66,P,7,12020,Regular
4JN19CS112,18MAT11,31,50,81,P,9,12020,Regular
4JN19CS112,18PHY12,29,33,62,P,7,12020,Regular
4JN19CS112,18ELE13,27,26,53,P,6,12020,Regular
4JN19CS112,18CIV14,35,23,58,P,6,12020,Regular
4JN19CS112,18EGDL15,39,51,90,P,10,12020,Regular
4JN19CS112,18PHYL16,31,47,78,P,8,12020,Regular
4JN19CS112,18ELEL17,39,54,93,P,10,12020,Regular
4JN19CS112,18EGH18,28,40,68,P,7,12020,Regular
4JN19CS113,18MAT11,23,24,47,P,6,12020,Regular
4JN19CS113,18PHY12,24,23,47,P,6,12020,Regular
4JN19CS113,18ELE13,25,21,46,P,6,12020,Regular
4JN19CS113,18CIV14,27,27,54,P,6,12020,Regular
4JN19CS113,18EGDL15,38,54,92,P,10,12020,Regular
4JN19CS113,18PHYL16,32,35,67,P,7,12020,Regular
4JN19CS113,18ELEL17,35,53,88,P,9,12020,Regular
4JN19CS113,18EGH18,26,41,67,P,7,12020,Regular
4JN19CS114,18MAT11,37,56,93,P,10,12020,Regular
4JN19CS114,18PHY12,32,41,73,P,8,12020,Regular
4JN19CS114,18ELE13,34,32,66,P,7,12020,Regular
4JN19CS114,18CIV14,38,23,61,P,7,12020,Regular
4JN19CS114,18EGDL15,38,53,91,P,10,12020,Regular
4JN19CS114,18PHYL16,38,50,88,P,9,12020,Regular
4JN19CS114,18ELEL17,38,54,92,P,10,12020,Regular
4JN19CS114,18EGH18,31,46,77,P,8,12020,Regular
4JN19CS115,18MAT11,40,54,94,P,10,12020,Regular
4JN19CS115,18PHY12,39,59,98,P,10,12020,Regular
4JN19CS115,18ELE13,35,45,80,P,9,12020,Regular
4JN19CS115,18CIV14,39,50,89,P,9,12020,Regular
4JN19CS115,18EGDL15,38,60,98,P,10,12020,Regular
4JN19CS115,18PHYL16,38,53,91,P,10,12020,Regular
4JN19CS115,18ELEL17,39,55,94,P,10,12020,Regular
4JN19CS115,18EGH18,33,44,77,P,8,12020,Regular
4JN19CS116,18MAT11,29,0,29,A,0,12020,Regular
4JN19CS116,18PHY12,25,17,42,F,0,12020,Regular
4JN19CS116,18ELE13,21,10,31,F,0,12020,Regular
4JN19CS116,18CIV14,30,4,34,F,0,12020,Regular
4JN19CS116,18EGDL15,37,0,37,A,0,12020,Regular
4JN19CS116,18PHYL16,33,17,50,F,0,12020,Regular
4JN19CS116,18ELEL17,36,53,89,P,9,12020,Regular
4JN19CS116,18EGH18,32,45,77,P,8,12020,Regular
4JN19CS117,18MAT11,33,30,63,P,7,12020,Regular
4JN19CS117,18PHY12,24,24,48,P,6,12020,Regular
4JN19CS117,18ELE13,26,28,54,P,6,12020,Regular
4JN19CS117,18CIV14,27,15,42,F,0,Jan-20,
4JN19CS117,18EGDL15,38,36,74,P,8,12020,Regular
4JN19CS117,18PHYL16,31,26,57,P,6,12020,Regular
4JN19CS117,18ELEL17,35,48,83,P,9,12020,Regular
4JN19CS117,18EGH18,22,34,56,P,6,12020,Regular
4JN19CS118,18MAT11,32,38,70,P,8,12020,Regular
4JN19CS118,18PHY12,23,30,53,P,6,12020,Regular
4JN19CS118,18ELE13,27,21,48,P,6,12020,Regular
4JN19CS118,18CIV14,32,24,56,P,6,12020,Regular
4JN19CS118,18EGDL15,37,9,46,F,0,12020,Regular
4JN19CS118,18PHYL16,30,41,71,P,8,12020,Regular
4JN19CS118,18ELEL17,38,54,92,P,10,12020,Regular
4JN19CS118,18EGH18,22,45,67,P,7,12020,Regular
4JN19CS119,18MAT11,40,57,97,P,10,12020,Regular
4JN19CS119,18PHY12,35,47,82,P,9,12020,Regular
4JN19CS119,18ELE13,32,44,76,P,8,12020,Regular
4JN19CS119,18CIV14,38,36,74,P,8,12020,Regular
4JN19CS119,18EGDL15,38,59,97,P,10,12020,Regular
4JN19CS119,18PHYL16,35,53,88,P,9,12020,Regular
4JN19CS119,18ELEL17,40,57,97,P,10,12020,Regular
4JN19CS119,18EGH18,34,45,79,P,8,12020,Regular
4JN19CS120,18MAT11,27,32,59,P,6,12020,Regular
4JN19CS120,18PHY12,22,30,52,P,6,12020,Regular
4JN19CS120,18ELE13,25,36,61,P,7,12020,Regular
4JN19CS120,18CIV14,25,21,46,P,6,12020,Regular
4JN19CS120,18EGDL15,38,47,85,P,9,12020,Regular
4JN19CS120,18PHYL16,30,27,57,P,6,12020,Regular
4JN19CS120,18ELEL17,38,48,86,P,9,12020,Regular
4JN19CS120,18EGH18,23,38,61,P,7,12020,Regular
4JN19CS121,18MAT11,27,39,66,P,7,12020,Regular
4JN19CS121,18PHY12,27,38,65,P,7,12020,Regular
4JN19CS121,18ELE13,25,32,57,P,6,12020,Regular
4JN19CS121,18CIV14,28,32,60,P,7,12020,Regular
4JN19CS121,18EGDL15,38,54,92,P,10,12020,Regular
4JN19CS121,18PHYL16,35,32,67,P,7,12020,Regular
4JN19CS121,18ELEL17,38,54,92,P,10,12020,Regular
4JN19CS121,18EGH18,29,44,73,P,8,12020,Regular
4JN19CS122,18MAT11,24,39,63,P,7,12020,Regular
4JN19CS122,18PHY12,23,23,46,P,6,12020,Regular
4JN19CS122,18ELE13,24,23,47,P,6,12020,Regular
4JN19CS122,18CIV14,26,21,47,P,6,12020,Regular
4JN19CS122,18EGDL15,37,34,71,P,8,12020,Regular
4JN19CS122,18PHYL16,29,42,71,P,8,12020,Regular
4JN19CS122,18ELEL17,35,52,87,P,9,12020,Regular
4JN19CS122,18EGH18,22,39,61,P,7,12020,Regular
4JN19CS123,18MAT11,37,51,88,P,9,12020,Regular
4JN19CS123,18PHY12,34,54,88,P,9,Jan-20,
4JN19CS123,18ELE13,34,38,72,P,8,12020,Regular
4JN19CS123,18CIV14,37,38,75,P,8,12020,Regular
4JN19CS123,18EGDL15,37,54,91,P,10,12020,Regular
4JN19CS123,18PHYL16,37,54,91,P,10,12020,Regular
4JN19CS123,18ELEL17,39,59,98,P,10,12020,Regular
4JN19CS123,18EGH18,30,42,72,P,8,12020,Regular
4JN19CS124,18MAT11,27,48,75,P,8,12020,Regular
4JN19CS124,18PHY12,26,15,41,F,0,Jan-20,
4JN19CS124,18ELE13,21,17,38,F,0,Jan-20,
4JN19CS124,18CIV14,28,26,54,P,6,12020,Regular
4JN19CS124,18EGDL15,37,42,79,P,8,12020,Regular
4JN19CS124,18PHYL16,28,26,54,P,6,12020,Regular
4JN19CS124,18ELEL17,37,51,88,P,9,12020,Regular
4JN19CS124,18EGH18,28,37,65,P,7,12020,Regular
4JN19CS125,18MAT11,40,56,96,P,10,12020,Regular
4JN19CS125,18PHY12,35,39,74,P,8,12020,Regular
4JN19CS125,18ELE13,31,42,73,P,8,12020,Regular
4JN19CS125,18CIV14,34,36,70,P,8,12020,Regular
4JN19CS125,18EGDL15,38,57,95,P,10,12020,Regular
4JN19CS125,18PHYL16,38,52,90,P,10,12020,Regular
4JN19CS125,18ELEL17,39,59,98,P,10,12020,Regular
4JN19CS125,18EGH18,33,44,77,P,8,12020,Regular
4JN19CS126,18MAT11,30,45,75,P,8,12020,Regular
4JN19CS126,18PHY12,30,44,74,P,8,12020,Regular
4JN19CS126,18ELE13,25,33,58,P,6,12020,Regular
4JN19CS126,18CIV14,34,25,59,P,6,12020,Regular
4JN19CS126,18EGDL15,38,53,91,P,10,12020,Regular
4JN19CS126,18PHYL16,24,38,62,P,7,12020,Regular
4JN19CS126,18ELEL17,39,55,94,P,10,12020,Regular
4JN19CS126,18EGH18,26,43,69,P,7,12020,Regular
4JN16CS050,18MAT31,16,0,16,A,0,12020,Regular
4JN16CS050,18CS32,19,0,19,A,0,12020,Regular
4JN16CS050,18CS33,16,0,16,A,0,12020,Regular
4JN16CS050,18CS34,16,0,16,A,0,12020,Regular
4JN16CS050,18CS35,27,0,27,A,0,12020,Regular
4JN16CS050,18CS36,19,0,19,A,0,12020,Regular
4JN16CS050,18CSL37,22,45,67,P,7,12020,Regular
4JN16CS050,18CSL38,30,16,46,F,0,12020,Regular
4JN16CS050,18KVK39,87,0,87,P,9,12020,Regular
4JN16CS050,15MAT21,15,0,15,A,0,12020,Backlog
4JN16CS050,15ELN25,14,0,14,A,0,12020,Backlog
4JN16CS050,15ELE15,12,0,12,A,0,12020,Backlog
4JN17CS094,18MAT31,19,6,25,F,0,12020,Regular
4JN17CS094,18CS32,19,23,42,P,4,12020,Regular
4JN17CS094,18CS33,18,10,28,F,0,Jan-20,
4JN17CS094,18CS34,16,5,21,F,0,12020,Regular
4JN17CS094,18CS35,24,25,49,P,6,12020,Regular
4JN17CS094,18CS36,23,28,51,P,6,12020,Regular
4JN17CS094,18CSL37,25,9,34,F,0,12020,Regular
4JN17CS094,18CSL38,30,14,44,F,0,12020,Regular
4JN17CS094,18KVK39,87,0,87,P,9,12020,Regular
4JN17CS094,18ELN24,19,5,24,F,0,12020,Backlog
4JN17CS094,18ELE13,23,11,34,F,0,Jan-20,
4JN17CS094,18CIV14,30,14,44,F,0,Jan-20,
4JN18CS001,18MAT31,19,39,58,P,6,12020,Regular
4JN18CS001,18CS32,19,21,40,P,4,12020,Regular
4JN18CS001,18CS33,23,22,45,P,6,12020,Regular
4JN18CS001,18CS34,24,14,38,F,0,12020,Regular
4JN18CS001,18CS35,28,0,28,A,0,12020,Regular
4JN18CS001,18CS36,27,8,35,F,0,12020,Regular
4JN18CS001,18CSL37,25,15,40,F,0,12020,Regular
4JN18CS001,18CSL38,30,39,69,P,7,12020,Regular
4JN18CS001,18KVK39,78,0,78,P,8,12020,Regular
4JN18CS002,18MAT31,30,47,77,P,8,12020,Regular
4JN18CS002,18CS32,34,45,79,P,8,12020,Regular
4JN18CS002,18CS33,29,32,61,P,7,12020,Regular
4JN18CS002,18CS34,27,27,54,P,6,12020,Regular
4JN18CS002,18CS35,35,22,57,P,6,12020,Regular
4JN18CS002,18CS36,27,42,69,P,7,12020,Regular
4JN18CS002,18CSL37,33,59,92,P,10,12020,Regular
4JN18CS002,18CSL38,37,54,91,P,10,12020,Regular
4JN18CS002,18KAK39,79,0,79,P,8,12020,Regular
4JN18CS003,18MAT31,31,39,70,P,8,12020,Regular
4JN18CS003,18CS32,31,35,66,P,7,12020,Regular
4JN18CS003,18CS33,32,21,53,P,6,12020,Regular
4JN18CS003,18CS34,40,32,72,P,8,12020,Regular
4JN18CS003,18CS35,38,26,64,P,7,12020,Regular
4JN18CS003,18CS36,33,29,62,P,7,12020,Regular
4JN18CS003,18CSL37,38,50,88,P,9,12020,Regular
4JN18CS003,18CSL38,35,60,95,P,10,12020,Regular
4JN18CS003,18KAK39,88,0,88,P,9,12020,Regular
4JN18CS004,18MAT31,22,27,49,P,6,12020,Regular
4JN18CS004,18CS32,22,26,48,P,6,12020,Regular
4JN18CS004,18CS33,19,7,26,F,0,Jan-20,
4JN18CS004,18CS34,18,22,40,P,4,12020,Regular
4JN18CS004,18CS35,25,15,40,F,0,Jan-20,
4JN18CS004,18CS36,23,22,45,P,6,12020,Regular
4JN18CS004,18CSL37,30,41,71,P,8,12020,Regular
4JN18CS004,18CSL38,34,59,93,P,10,12020,Regular
4JN18CS004,18KAK39,88,0,88,P,9,12020,Regular
4JN18CS004,18CHE22,24,26,50,P,6,12020,Backlog
4JN18CS004,18CPS23,32,24,56,P,6,12020,Backlog
4JN18CS004,18ELN24,21,21,42,P,4,12020,Backlog
4JN18CS005,18MAT31,21,16,37,F,0,Jan-20,
4JN18CS005,18CS32,28,16,44,F,0,Jan-20,
4JN18CS005,18CS33,28,21,49,P,6,12020,Regular
4JN18CS005,18CS34,24,22,46,P,6,12020,Regular
4JN18CS005,18CS35,28,17,45,F,0,Jan-20,
4JN18CS005,18CS36,22,15,37,F,0,Jan-20,
4JN18CS005,18CSL37,33,59,92,P,10,12020,Regular
4JN18CS005,18CSL38,36,51,87,P,9,12020,Regular
4JN18CS005,18KAK39,73,0,73,P,8,12020,Regular
4JN18CS006,18MAT31,29,30,59,P,6,12020,Regular
4JN18CS006,18CS32,27,32,59,P,6,12020,Regular
4JN18CS006,18CS33,31,32,63,P,7,12020,Regular
4JN18CS006,18CS34,31,21,52,P,6,12020,Regular
4JN18CS006,18CS35,34,29,63,P,7,12020,Regular
4JN18CS006,18CS36,29,29,58,P,6,12020,Regular
4JN18CS006,18CSL37,37,56,93,P,10,12020,Regular
4JN18CS006,18CSL38,35,59,94,P,10,12020,Regular
4JN18CS006,18KAK39,88,0,88,P,9,12020,Regular
4JN18CS007,18MAT31,19,25,44,P,4,12020,Regular
4JN18CS007,18CS32,22,21,43,P,4,12020,Regular
4JN18CS007,18CS33,27,21,48,P,6,12020,Regular
4JN18CS007,18CS34,25,26,51,P,6,12020,Regular
4JN18CS007,18CS35,29,29,58,P,6,12020,Regular
4JN18CS007,18CS36,24,21,45,P,6,12020,Regular
4JN18CS007,18CSL37,30,26,56,P,6,12020,Regular
4JN18CS007,18CSL38,34,45,79,P,8,12020,Regular
4JN18CS007,18KAK39,81,0,81,P,9,12020,Regular
4JN18CS008,18MAT31,27,42,69,P,7,12020,Regular
4JN18CS008,18CS32,31,41,72,P,8,12020,Regular
4JN18CS008,18CS33,32,26,58,P,6,12020,Regular
4JN18CS008,18CS34,35,30,65,P,7,12020,Regular
4JN18CS008,18CS35,38,26,64,P,7,12020,Regular
4JN18CS008,18CS36,31,28,59,P,6,12020,Regular
4JN18CS008,18CSL37,38,59,97,P,10,12020,Regular
4JN18CS008,18CSL38,36,48,84,P,9,12020,Regular
4JN18CS008,18KAK39,85,0,85,P,9,12020,Regular
4JN18CS009,18MAT31,30,33,63,P,7,12020,Regular
4JN18CS009,18CS32,32,43,75,P,8,12020,Regular
4JN18CS009,18CS33,35,29,64,P,7,12020,Regular
4JN18CS009,18CS34,35,28,63,P,7,12020,Regular
4JN18CS009,18CS35,39,33,72,P,8,12020,Regular
4JN18CS009,18CS36,32,40,72,P,8,12020,Regular
4JN18CS009,18CSL37,38,54,92,P,10,12020,Regular
4JN18CS009,18CSL38,36,47,83,P,9,12020,Regular
4JN18CS009,18KAK39,94,0,94,P,10,12020,Regular
4JN18CS010,18MAT31,28,35,63,P,7,12020,Regular
4JN18CS010,18CS32,35,36,71,P,8,12020,Regular
4JN18CS010,18CS33,25,21,46,P,6,Jan-20,
4JN18CS010,18CS34,27,28,55,P,6,12020,Regular
4JN18CS010,18CS35,27,23,50,P,6,12020,Regular
4JN18CS010,18CS36,29,35,64,P,7,12020,Regular
4JN18CS010,18CSL37,30,51,81,P,9,12020,Regular
4JN18CS010,18CSL38,40,59,99,P,10,12020,Regular
4JN18CS010,18KAK39,62,0,62,P,7,12020,Regular
4JN18CS011,18MAT31,34,38,72,P,8,12020,Regular
4JN18CS011,18CS32,33,35,68,P,7,12020,Regular
4JN18CS011,18CS33,34,22,56,P,6,12020,Regular
4JN18CS011,18CS34,34,38,72,P,8,12020,Regular
4JN18CS011,18CS35,39,21,60,P,7,12020,Regular
4JN18CS011,18CS36,33,29,62,P,7,12020,Regular
4JN18CS011,18CSL37,39,57,96,P,10,12020,Regular
4JN18CS011,18CSL38,37,48,85,P,9,12020,Regular
4JN18CS011,18KAK39,79,0,79,P,8,12020,Regular
4JN18CS013,18MAT31,23,51,74,P,8,12020,Regular
4JN18CS013,18CS32,31,29,60,P,7,12020,Regular
4JN18CS013,18CS33,29,24,53,P,6,12020,Regular
4JN18CS013,18CS34,24,36,60,P,7,12020,Regular
4JN18CS013,18CS35,37,27,64,P,7,12020,Regular
4JN18CS013,18CS36,28,38,66,P,7,12020,Regular
4JN18CS013,18CSL37,35,58,93,P,10,12020,Regular
4JN18CS013,18CSL38,36,56,92,P,10,12020,Regular
4JN18CS013,18KVK39,82,0,82,P,9,12020,Regular
4JN18CS014,18MAT31,35,45,80,P,9,12020,Regular
4JN18CS014,18CS32,34,44,78,P,8,12020,Regular
4JN18CS014,18CS33,37,33,70,P,8,12020,Regular
4JN18CS014,18CS34,40,33,73,P,8,12020,Regular
4JN18CS014,18CS35,40,29,69,P,7,12020,Regular
4JN18CS014,18CS36,36,45,81,P,9,12020,Regular
4JN18CS014,18CSL37,40,59,99,P,10,12020,Regular
4JN18CS014,18CSL38,38,60,98,P,10,12020,Regular
4JN18CS014,18KAK39,91,0,91,P,10,12020,Regular
4JN18CS015,18MAT31,29,48,77,P,8,12020,Regular
4JN18CS015,18CS32,29,40,69,P,7,12020,Regular
4JN18CS015,18CS33,28,30,58,P,6,12020,Regular
4JN18CS015,18CS34,30,23,53,P,6,12020,Regular
4JN18CS015,18CS35,38,24,62,P,7,12020,Regular
4JN18CS015,18CS36,33,51,84,P,9,12020,Regular
4JN18CS015,18CSL37,36,33,69,P,7,12020,Regular
4JN18CS015,18CSL38,37,59,96,P,10,12020,Regular
4JN18CS015,18KAK39,88,0,88,P,9,12020,Regular
4JN18CS016,18MAT31,25,33,58,P,6,12020,Regular
4JN18CS016,18CS32,30,46,76,P,8,12020,Regular
4JN18CS016,18CS33,32,33,65,P,7,12020,Regular
4JN18CS016,18CS34,38,32,70,P,8,12020,Regular
4JN18CS016,18CS35,38,24,62,P,7,12020,Regular
4JN18CS016,18CS36,31,45,76,P,8,12020,Regular
4JN18CS016,18CSL37,40,59,99,P,10,12020,Regular
4JN18CS016,18CSL38,36,31,67,P,7,12020,Regular
4JN18CS016,18KAK39,92,0,92,P,10,12020,Regular
4JN18CS017,18MAT31,21,23,44,P,4,12020,Regular
4JN18CS017,18CS32,28,27,55,P,6,12020,Regular
4JN18CS017,18CS33,24,29,53,P,6,12020,Regular
4JN18CS017,18CS34,28,30,58,P,6,12020,Regular
4JN18CS017,18CS35,32,23,55,P,6,12020,Regular
4JN18CS017,18CS36,25,27,52,P,6,12020,Regular
4JN18CS017,18CSL37,37,41,78,P,8,12020,Regular
4JN18CS017,18CSL38,37,60,97,P,10,12020,Regular
4JN18CS017,18KAK39,78,0,78,P,8,12020,Regular
4JN18CS018,18MAT31,21,25,46,P,6,12020,Regular
4JN18CS018,18CS32,28,31,59,P,6,12020,Regular
4JN18CS018,18CS33,25,23,48,P,6,12020,Regular
4JN18CS018,18CS34,29,31,60,P,7,12020,Regular
4JN18CS018,18CS35,31,21,52,P,6,Jan-20,
4JN18CS018,18CS36,25,14,39,F,0,Jan-20,
4JN18CS018,18CSL37,33,44,77,P,8,12020,Regular
4JN18CS018,18CSL38,36,54,90,P,10,12020,Regular
4JN18CS018,18KAK39,81,0,81,P,9,12020,Regular
4JN18CS018,18ELN24,26,21,47,P,6,12020,Backlog
4JN18CS019,18MAT31,38,54,92,P,10,12020,Regular
4JN18CS019,18CS32,34,47,81,P,9,12020,Regular
4JN18CS019,18CS33,38,34,72,P,8,12020,Regular
4JN18CS019,18CS34,35,35,70,P,8,12020,Regular
4JN18CS019,18CS35,38,31,69,P,7,12020,Regular
4JN18CS019,18CS36,33,44,77,P,8,12020,Regular
4JN18CS019,18CSL37,40,59,99,P,10,12020,Regular
4JN18CS019,18CSL38,36,56,92,P,10,12020,Regular
4JN18CS019,18KAK39,89,0,89,P,9,12020,Regular
4JN18CS020,18MAT31,33,38,71,P,8,12020,Regular
4JN18CS020,18CS32,32,39,71,P,8,12020,Regular
4JN18CS020,18CS33,38,32,70,P,8,Jan-20,
4JN18CS020,18CS34,36,33,69,P,7,12020,Regular
4JN18CS020,18CS35,39,39,78,P,8,12020,Regular
4JN18CS020,18CS36,37,40,77,P,8,12020,Regular
4JN18CS020,18CSL37,38,59,97,P,10,12020,Regular
4JN18CS020,18CSL38,38,48,86,P,9,12020,Regular
4JN18CS020,18KAK39,91,0,91,P,10,12020,Regular
4JN18CS021,18MAT31,39,56,95,P,10,12020,Regular
4JN18CS021,18CS32,38,48,86,P,9,12020,Regular
4JN18CS021,18CS33,38,36,74,P,8,12020,Regular
4JN18CS021,18CS34,37,29,66,P,7,12020,Regular
4JN18CS021,18CS35,40,41,81,P,9,12020,Regular
4JN18CS021,18CS36,37,42,79,P,8,12020,Regular
4JN18CS021,18CSL37,40,59,99,P,10,12020,Regular
4JN18CS021,18CSL38,39,59,98,P,10,12020,Regular
4JN18CS021,18KAK39,93,0,93,P,10,12020,Regular
4JN18CS026,18MAT31,25,27,52,P,6,12020,Regular
4JN18CS026,18CS32,27,23,50,P,6,12020,Regular
4JN18CS026,18CS33,28,14,42,F,0,Jan-20,
4JN18CS026,18CS34,25,21,46,P,6,12020,Regular
4JN18CS026,18CS35,32,14,46,F,0,Jan-20,
4JN18CS026,18CS36,25,21,46,P,6,12020,Regular
4JN18CS026,18CSL37,30,35,65,P,7,12020,Regular
4JN18CS026,18CSL38,33,39,72,P,8,12020,Regular
4JN18CS026,18KAK39,84,0,84,P,9,12020,Regular
4JN18CS028,18MAT31,19,21,40,P,4,12020,Regular
4JN18CS028,18CS32,19,21,40,P,4,12020,Regular
4JN18CS028,18CS33,22,15,37,F,0,Jan-20,
4JN18CS028,18CS34,24,21,45,P,6,12020,Regular
4JN18CS028,18CS35,28,11,39,F,0,Jan-20,
4JN18CS028,18CS36,20,15,35,F,0,Jan-20,
4JN18CS028,18CSL37,33,17,50,F,0,12020,Regular
4JN18CS028,18CSL38,33,50,83,P,9,12020,Regular
4JN18CS028,18KAK39,60,0,60,P,7,12020,Regular
4JN18CS030,18MAT31,35,51,86,P,9,12020,Regular
4JN18CS030,18CS32,39,51,90,P,10,12020,Regular
4JN18CS030,18CS33,35,29,64,P,7,12020,Regular
4JN18CS030,18CS34,32,21,53,P,6,12020,Regular
4JN18CS030,18CS35,38,33,71,P,8,12020,Regular
4JN18CS030,18CS36,36,36,72,P,8,12020,Regular
4JN18CS030,18CSL37,40,59,99,P,10,12020,Regular
4JN18CS030,18CSL38,40,59,99,P,10,12020,Regular
4JN18CS030,18KAK39,94,0,94,P,10,12020,Regular
4JN18CS031,18MAT31,38,58,96,P,10,12020,Regular
4JN18CS031,18CS32,37,35,72,P,8,12020,Regular
4JN18CS031,18CS33,39,26,65,P,7,12020,Regular
4JN18CS031,18CS34,34,38,72,P,8,12020,Regular
4JN18CS031,18CS35,38,30,68,P,7,12020,Regular
4JN18CS031,18CS36,38,51,89,P,9,12020,Regular
4JN18CS031,18CSL37,40,58,98,P,10,12020,Regular
4JN18CS031,18CSL38,40,59,99,P,10,12020,Regular
4JN18CS031,18KAK39,87,0,87,P,9,12020,Regular
4JN18CS034,18MAT31,26,33,59,P,6,12020,Regular
4JN18CS034,18CS32,37,43,80,P,9,12020,Regular
4JN18CS034,18CS33,39,28,67,P,7,12020,Regular
4JN18CS034,18CS34,36,36,72,P,8,12020,Regular
4JN18CS034,18CS35,39,37,76,P,8,12020,Regular
4JN18CS034,18CS36,32,31,63,P,7,12020,Regular
4JN18CS034,18CSL37,38,56,94,P,10,12020,Regular
4JN18CS034,18CSL38,38,55,93,P,10,12020,Regular
4JN18CS034,18KAK39,94,0,94,P,10,12020,Regular
4JN18CS035,18MAT31,20,21,41,P,4,12020,Regular
4JN18CS035,18CS32,19,25,44,P,4,12020,Regular
4JN18CS035,18CS33,23,21,44,P,4,Jan-20,
4JN18CS035,18CS34,23,21,44,P,4,Jan-20,
4JN18CS035,18CS35,33,12,45,F,0,Jan-20,
4JN18CS035,18CS36,26,21,47,P,6,12020,Regular
4JN18CS035,18CSL37,37,45,82,P,9,12020,Regular
4JN18CS035,18CSL38,33,27,60,P,7,12020,Regular
4JN18CS035,18KAK39,76,0,76,P,8,12020,Regular
4JN18CS040,18MAT31,26,34,60,P,7,12020,Regular
4JN18CS040,18CS32,25,37,62,P,7,12020,Regular
4JN18CS040,18CS33,21,29,50,P,6,12020,Regular
4JN18CS040,18CS34,21,29,50,P,6,12020,Regular
4JN18CS040,18CS35,30,23,53,P,6,12020,Regular
4JN18CS040,18CS36,23,27,50,P,6,12020,Regular
4JN18CS040,18CSL37,40,59,99,P,10,12020,Regular
4JN18CS040,18CSL38,34,59,93,P,10,12020,Regular
4JN18CS040,18KAK39,78,0,78,P,8,12020,Regular
4JN18CS044,18MAT31,24,27,51,P,6,12020,Regular
4JN18CS044,18CS32,28,29,57,P,6,12020,Regular
4JN18CS044,18CS33,27,25,52,P,6,12020,Regular
4JN18CS044,18CS34,34,40,74,P,8,12020,Regular
4JN18CS044,18CS35,35,35,70,P,8,12020,Regular
4JN18CS044,18CS36,29,32,61,P,7,12020,Regular
4JN18CS044,18CSL37,35,59,94,P,10,12020,Regular
4JN18CS044,18CSL38,34,58,92,P,10,12020,Regular
4JN18CS044,18KAK39,90,0,90,P,10,12020,Regular
4JN18CS067,18MAT31,19,21,40,P,4,12020,Regular
4JN18CS067,18CS32,22,38,60,P,7,12020,Regular
4JN18CS067,18CS33,23,17,40,F,0,Jan-20,
4JN18CS067,18CS34,26,16,42,F,0,Jan-20,
4JN18CS067,18CS35,28,24,52,P,6,12020,Regular
4JN18CS067,18CS36,28,24,52,P,6,12020,Regular
4JN18CS067,18CSL37,35,27,62,P,7,12020,Regular
4JN18CS067,18CSL38,35,28,63,P,7,12020,Regular
4JN18CS067,18KAK39,78,0,78,P,8,12020,Regular
4JN18CS067,18ELN24,25,24,49,P,6,12020,Backlog
4JN18CS068,18MAT31,29,30,59,P,6,12020,Regular
4JN18CS068,18CS32,31,36,67,P,7,12020,Regular
4JN18CS068,18CS33,33,21,54,P,6,12020,Regular
4JN18CS068,18CS34,28,32,60,P,7,12020,Regular
4JN18CS068,18CS35,37,31,68,P,7,12020,Regular
4JN18CS068,18CS36,29,26,55,P,6,12020,Regular
4JN18CS068,18CSL37,40,59,99,P,10,12020,Regular
4JN18CS068,18CSL38,37,54,91,P,10,12020,Regular
4JN18CS068,18KAK39,77,0,77,P,8,12020,Regular
4JN18CS072,18MAT31,33,48,81,P,9,12020,Regular
4JN18CS072,18CS32,37,32,69,P,7,12020,Regular
4JN18CS072,18CS33,35,38,73,P,8,12020,Regular
4JN18CS072,18CS34,35,38,73,P,8,12020,Regular
4JN18CS072,18CS35,40,27,67,P,7,12020,Regular
4JN18CS072,18CS36,35,30,65,P,7,12020,Regular
4JN18CS072,18CSL37,40,57,97,P,10,12020,Regular
4JN18CS072,18CSL38,38,41,79,P,8,12020,Regular
4JN18CS072,18KAK39,91,0,91,P,10,12020,Regular
4JN18CS079,18MAT31,34,42,76,P,8,12020,Regular
4JN18CS079,18CS32,33,36,69,P,7,12020,Regular
4JN18CS079,18CS33,33,29,62,P,7,12020,Regular
4JN18CS079,18CS34,30,28,58,P,6,12020,Regular
4JN18CS079,18CS35,35,27,62,P,7,12020,Regular
4JN18CS079,18CS36,36,32,68,P,7,12020,Regular
4JN18CS079,18CSL37,35,57,92,P,10,12020,Regular
4JN18CS079,18CSL38,37,59,96,P,10,12020,Regular
4JN18CS079,18KAK39,85,0,85,P,9,12020,Regular
4JN18CS081,18MAT31,28,35,63,P,7,12020,Regular
4JN18CS081,18CS32,28,32,60,P,7,12020,Regular
4JN18CS081,18CS33,34,24,58,P,6,12020,Regular
4JN18CS081,18CS34,34,27,61,P,7,12020,Regular
4JN18CS081,18CS35,37,27,64,P,7,12020,Regular
4JN18CS081,18CS36,30,29,59,P,6,12020,Regular
4JN18CS081,18CSL37,38,57,95,P,10,12020,Regular
4JN18CS081,18CSL38,37,38,75,P,8,12020,Regular
4JN18CS081,18KAK39,90,0,90,P,10,12020,Regular
4JN18CS087,18MAT31,22,29,51,P,6,12020,Regular
4JN18CS087,18CS32,26,36,62,P,7,12020,Regular
4JN18CS087,18CS33,33,21,54,P,6,12020,Regular
4JN18CS087,18CS34,31,32,63,P,7,12020,Regular
4JN18CS087,18CS35,35,33,68,P,7,12020,Regular
4JN18CS087,18CS36,29,26,55,P,6,12020,Regular
4JN18CS087,18CSL37,36,53,89,P,9,12020,Regular
4JN18CS087,18CSL38,37,57,94,P,10,12020,Regular
4JN18CS087,18KAK39,89,0,89,P,9,12020,Regular
4JN18CS087,18ELN24,19,31,50,P,6,12020,Backlog
4JN18CS087,18EGH28,32,25,57,P,6,12020,Backlog
4JN18CS087,18PHY12,16,24,40,P,4,12020,Backlog
4JN18CS089,18MAT31,29,45,74,P,8,12020,Regular
4JN18CS089,18CS32,23,21,44,P,4,12020,Regular
4JN18CS089,18CS33,25,23,48,P,6,Jan-20,
4JN18CS089,18CS34,24,21,45,P,6,Jan-20,
4JN18CS089,18CS35,30,27,57,P,6,12020,Regular
4JN18CS089,18CS36,28,30,58,P,6,12020,Regular
4JN18CS089,18CSL37,30,39,69,P,7,12020,Regular
4JN18CS089,18CSL38,34,56,90,P,10,12020,Regular
4JN18CS089,18KAK39,73,0,73,P,8,12020,Regular
4JN18CS091,18MAT31,31,37,68,P,7,12020,Regular
4JN18CS091,18CS32,27,35,62,P,7,12020,Regular
4JN18CS091,18CS33,33,28,61,P,7,12020,Regular
4JN18CS091,18CS34,32,32,64,P,7,12020,Regular
4JN18CS091,18CS35,39,23,62,P,7,12020,Regular
4JN18CS091,18CS36,30,26,56,P,6,12020,Regular
4JN18CS091,18CSL37,35,57,92,P,10,12020,Regular
4JN18CS091,18CSL38,36,34,70,P,8,12020,Regular
4JN18CS091,18KAK39,93,0,93,P,10,12020,Regular
4JN18CS096,18MAT31,31,39,70,P,8,12020,Regular
4JN18CS096,18CS32,33,42,75,P,8,12020,Regular
4JN18CS096,18CS33,36,32,68,P,7,12020,Regular
4JN18CS096,18CS34,36,42,78,P,8,12020,Regular
4JN18CS096,18CS35,29,21,50,P,6,Jan-20,
4JN18CS096,18CS36,34,39,73,P,8,12020,Regular
4JN18CS096,18CSL37,40,51,91,P,10,12020,Regular
4JN18CS096,18CSL38,40,35,75,P,8,12020,Regular
4JN18CS096,18KAK39,82,0,82,P,9,12020,Regular
4JN18CS101,18MAT31,33,38,71,P,8,12020,Regular
4JN18CS101,18CS32,34,46,80,P,9,12020,Regular
4JN18CS101,18CS33,21,21,42,P,4,12020,Regular
4JN18CS101,18CS34,16,12,28,F,0,12020,Regular
4JN18CS101,18CS35,29,11,40,F,0,Jan-20,
4JN18CS101,18CS36,24,18,42,F,0,Jan-20,
4JN18CS101,18CSL37,33,51,84,P,9,12020,Regular
4JN18CS101,18CSL38,38,57,95,P,10,12020,Regular
4JN18CS101,18KVK39,69,0,69,P,7,12020,Regular
4JN18CS102,18MAT31,30,49,79,P,8,12020,Regular
4JN18CS102,18CS32,25,21,46,P,6,12020,Regular
4JN18CS102,18CS33,29,27,56,P,6,12020,Regular
4JN18CS102,18CS34,31,25,56,P,6,12020,Regular
4JN18CS102,18CS35,38,38,76,P,8,12020,Regular
4JN18CS102,18CS36,31,21,52,P,6,12020,Regular
4JN18CS102,18CSL37,35,53,88,P,9,12020,Regular
4JN18CS102,18CSL38,34,32,66,P,7,12020,Regular
4JN18CS102,18KAK39,94,0,94,P,10,12020,Regular
4JN18CS105,18MAT31,20,22,42,P,4,12020,Regular
4JN18CS105,18CS32,26,23,49,P,6,12020,Regular
4JN18CS105,18CS33,23,21,44,P,4,Jan-20,
4JN18CS105,18CS34,25,29,54,P,6,12020,Regular
4JN18CS105,18CS35,30,14,44,F,0,Jan-20,
4JN18CS105,18CS36,28,24,52,P,6,Jan-20,
4JN18CS105,18CSL37,33,48,81,P,9,12020,Regular
4JN18CS105,18CSL38,35,35,70,P,8,12020,Regular
4JN18CS105,18KAK39,93,0,93,P,10,12020,Regular
4JN18CS106,18MAT31,37,42,79,P,8,12020,Regular
4JN18CS106,18CS32,25,42,67,P,7,12020,Regular
4JN18CS106,18CS33,36,33,69,P,7,12020,Regular
4JN18CS106,18CS34,30,21,51,P,6,12020,Regular
4JN18CS106,18CS35,36,21,57,P,6,12020,Regular
4JN18CS106,18CS36,34,33,67,P,7,12020,Regular
4JN18CS106,18CSL37,40,56,96,P,10,12020,Regular
4JN18CS106,18CSL38,35,33,68,P,7,12020,Regular
4JN18CS106,18KAK39,89,0,89,P,9,12020,Regular
4JN18CS107,18MAT31,28,35,63,P,7,12020,Regular
4JN18CS107,18CS32,29,24,53,P,6,12020,Regular
4JN18CS107,18CS33,28,21,49,P,6,Jan-20,
4JN18CS107,18CS34,30,12,42,F,0,Jan-20,
4JN18CS107,18CS35,34,22,56,P,6,12020,Regular
4JN18CS107,18CS36,30,21,51,P,6,Jan-20,
4JN18CS107,18CSL37,36,56,92,P,10,12020,Regular
4JN18CS107,18CSL38,35,55,90,P,10,12020,Regular
4JN18CS107,18KAK39,90,0,90,P,10,12020,Regular
4JN18CS109,18MAT31,33,39,72,P,8,12020,Regular
4JN18CS109,18CS32,34,28,62,P,7,12020,Regular
4JN18CS109,18CS33,30,28,58,P,6,12020,Regular
4JN18CS109,18CS34,28,26,54,P,6,12020,Regular
4JN18CS109,18CS35,33,21,54,P,6,12020,Regular
4JN18CS109,18CS36,26,27,53,P,6,12020,Regular
4JN18CS109,18CSL37,40,59,99,P,10,12020,Regular
4JN18CS109,18CSL38,38,59,97,P,10,12020,Regular
4JN18CS109,18KAK39,68,0,68,P,7,12020,Regular
4JN18CS110,18MAT31,28,27,55,P,6,12020,Regular
4JN18CS110,18CS32,24,35,59,P,6,12020,Regular
4JN18CS110,18CS33,26,21,47,P,6,12020,Regular
4JN18CS110,18CS34,24,27,51,P,6,12020,Regular
4JN18CS110,18CS35,33,31,64,P,7,12020,Regular
4JN18CS110,18CS36,29,26,55,P,6,12020,Regular
4JN18CS110,18CSL37,35,57,92,P,10,12020,Regular
4JN18CS110,18CSL38,35,30,65,P,7,12020,Regular
4JN18CS110,18KAK39,83,0,83,P,9,12020,Regular
4JN18CS111,18MAT31,36,52,88,P,9,12020,Regular
4JN18CS111,18CS32,29,40,69,P,7,12020,Regular
4JN18CS111,18CS33,33,33,66,P,7,12020,Regular
4JN18CS111,18CS34,34,36,70,P,8,12020,Regular
4JN18CS111,18CS35,38,42,80,P,9,12020,Regular
4JN18CS111,18CS36,34,49,83,P,9,12020,Regular
4JN18CS111,18CSL37,40,51,91,P,10,12020,Regular
4JN18CS111,18CSL38,36,29,65,P,7,12020,Regular
4JN18CS111,18KAK39,93,0,93,P,10,12020,Regular
4JN18CS112,18MAT31,33,44,77,P,8,12020,Regular
4JN18CS112,18CS32,27,32,59,P,6,12020,Regular
4JN18CS112,18CS33,35,26,61,P,7,12020,Regular
4JN18CS112,18CS34,31,30,61,P,7,12020,Regular
4JN18CS112,18CS35,38,21,59,P,6,Jan-20,
4JN18CS112,18CS36,29,32,61,P,7,12020,Regular
4JN18CS112,18CSL37,40,42,82,P,9,12020,Regular
4JN18CS112,18CSL38,36,28,64,P,7,12020,Regular
4JN18CS112,18KAK39,92,0,92,P,10,12020,Regular
4JN18CS114,18MAT31,20,21,41,P,4,12020,Regular
4JN18CS114,18CS32,21,33,54,P,6,12020,Regular
4JN18CS114,18CS33,20,12,32,F,0,12020,Regular
4JN18CS114,18CS34,20,26,46,P,6,12020,Regular
4JN18CS114,18CS35,26,12,38,F,0,Jan-20,
4JN18CS114,18CS36,23,18,41,F,0,Jan-20,
4JN18CS114,18CSL37,30,47,77,P,8,12020,Regular
4JN18CS114,18CSL38,34,27,61,P,7,12020,Regular
4JN18CS114,18KVK39,84,0,84,P,9,12020,Regular
4JN18CS114,18MAT21,19,21,40,P,4,12020,Backlog
4JN18CS114,18CPS23,20,27,47,P,6,12020,Backlog
4JN18CS114,18ELN24,16,29,45,P,6,12020,Backlog
4JN18CS115,18MAT31,37,48,85,P,9,12020,Regular
4JN18CS115,18CS32,40,41,81,P,9,12020,Regular
4JN18CS115,18CS33,38,26,64,P,7,12020,Regular
4JN18CS115,18CS34,38,38,76,P,8,12020,Regular
4JN18CS115,18CS35,40,26,66,P,7,12020,Regular
4JN18CS115,18CS36,36,36,72,P,8,12020,Regular
4JN18CS115,18CSL37,40,57,97,P,10,12020,Regular
4JN18CS115,18CSL38,40,54,94,P,10,12020,Regular
4JN18CS115,18KAK39,96,0,96,P,10,12020,Regular
4JN18CS116,18MAT31,39,51,90,P,10,12020,Regular
4JN18CS116,18CS32,36,50,86,P,9,12020,Regular
4JN18CS116,18CS33,39,32,71,P,8,12020,Regular
4JN18CS116,18CS34,37,38,75,P,8,12020,Regular
4JN18CS116,18CS35,39,32,71,P,8,12020,Regular
4JN18CS116,18CS36,33,41,74,P,8,12020,Regular
4JN18CS116,18CSL37,40,57,97,P,10,12020,Regular
4JN18CS116,18CSL38,38,56,94,P,10,12020,Regular
4JN18CS116,18KAK39,86,0,86,P,9,12020,Regular
4JN18CS117,18MAT31,24,23,47,P,6,12020,Regular
4JN18CS117,18CS32,27,21,48,P,6,12020,Regular
4JN18CS117,18CS33,29,33,62,P,7,12020,Regular
4JN18CS117,18CS34,27,24,51,P,6,12020,Regular
4JN18CS117,18CS35,33,33,66,P,7,12020,Regular
4JN18CS117,18CS36,30,37,67,P,7,12020,Regular
4JN18CS117,18CSL37,33,56,89,P,9,12020,Regular
4JN18CS117,18CSL38,34,12,46,F,0,12020,Regular
4JN18CS117,18KVK39,91,0,91,P,10,12020,Regular
4JN18CS118,18MAT31,38,42,80,P,9,12020,Regular
4JN18CS118,18CS32,35,33,68,P,7,12020,Regular
4JN18CS118,18CS33,31,27,58,P,6,12020,Regular
4JN18CS118,18CS34,34,30,64,P,7,12020,Regular
4JN18CS118,18CS35,36,26,62,P,7,12020,Regular
4JN18CS118,18CS36,34,48,82,P,9,12020,Regular
4JN18CS118,18CSL37,40,54,94,P,10,12020,Regular
4JN18CS118,18CSL38,38,56,94,P,10,12020,Regular
4JN18CS118,18KAK39,83,0,83,P,9,12020,Regular
4JN18CS119,18MAT31,20,33,53,P,6,12020,Regular
4JN18CS119,18CS32,23,39,62,P,7,12020,Regular
4JN18CS119,18CS33,32,26,58,P,6,12020,Regular
4JN18CS119,18CS34,27,23,50,P,6,12020,Regular
4JN18CS119,18CS35,35,23,58,P,6,12020,Regular
4JN18CS119,18CS36,27,23,50,P,6,12020,Regular
4JN18CS119,18CSL37,38,53,91,P,10,12020,Regular
4JN18CS119,18CSL38,37,27,64,P,7,12020,Regular
4JN18CS119,18KAK39,90,0,90,P,10,12020,Regular
4JN18CS120,18MAT31,33,45,78,P,8,12020,Regular
4JN18CS120,18CS32,33,44,77,P,8,12020,Regular
4JN18CS120,18CS33,36,26,62,P,7,12020,Regular
4JN18CS120,18CS34,32,27,59,P,6,12020,Regular
4JN18CS120,18CS35,37,24,61,P,7,12020,Regular
4JN18CS120,18CS36,31,47,78,P,8,12020,Regular
4JN18CS120,18CSL37,40,47,87,P,9,12020,Regular
4JN18CS120,18CSL38,36,54,90,P,10,12020,Regular
4JN18CS120,18KAK39,90,0,90,P,10,12020,Regular
4JN18CS121,18MAT31,39,55,94,P,10,12020,Regular
4JN18CS121,18CS32,40,48,88,P,9,12020,Regular
4JN18CS121,18CS33,40,39,79,P,8,12020,Regular
4JN18CS121,18CS34,39,39,78,P,8,12020,Regular
4JN18CS121,18CS35,40,36,76,P,8,12020,Regular
4JN18CS121,18CS36,37,47,84,P,9,12020,Regular
4JN18CS121,18CSL37,40,58,98,P,10,12020,Regular
4JN18CS121,18CSL38,40,57,97,P,10,12020,Regular
4JN18CS121,18KAK39,87,0,87,P,9,12020,Regular
4JN18CS122,18MAT31,38,56,94,P,10,12020,Regular
4JN18CS122,18CS32,33,35,68,P,7,12020,Regular
4JN18CS122,18CS33,39,40,79,P,8,12020,Regular
4JN18CS122,18CS34,39,38,77,P,8,12020,Regular
4JN18CS122,18CS35,38,29,67,P,7,12020,Regular
4JN18CS122,18CS36,37,38,75,P,8,12020,Regular
4JN18CS122,18CSL37,40,57,97,P,10,12020,Regular
4JN18CS122,18CSL38,37,27,64,P,7,12020,Regular
4JN18CS122,18KAK39,97,0,97,P,10,12020,Regular
4JN18CS123,18MAT31,36,57,93,P,10,12020,Regular
4JN18CS123,18CS32,31,34,65,P,7,12020,Regular
4JN18CS123,18CS33,32,24,56,P,6,12020,Regular
4JN18CS123,18CS34,37,27,64,P,7,12020,Regular
4JN18CS123,18CS35,37,21,58,P,6,12020,Regular
4JN18CS123,18CS36,35,30,65,P,7,12020,Regular
4JN18CS123,18CSL37,35,50,85,P,9,12020,Regular
4JN18CS123,18CSL38,35,46,81,P,9,12020,Regular
4JN18CS123,18KAK39,87,0,87,P,9,12020,Regular
4JN18CS124,18MAT31,19,11,30,F,0,12020,Regular
4JN18CS124,18CS32,19,18,37,F,0,Jan-20,
4JN18CS124,18CS33,21,17,38,F,0,Jan-20,
4JN18CS124,18CS34,23,18,41,F,0,Jan-20,
4JN18CS124,18CS35,24,6,30,F,0,12020,Regular
4JN18CS124,18CS36,19,10,29,F,0,12020,Regular
4JN18CS124,18CSL37,28,30,58,P,6,12020,Regular
4JN18CS124,18CSL38,34,41,75,P,8,12020,Regular
4JN18CS124,18KAK39,82,0,82,P,9,12020,Regular
4JN18CS124,18CHE22,22,24,46,P,6,12020,Backlog
4JN18CS124,18CPS23,23,15,38,F,0,Jan-20,
4JN18CS124,18ELN24,16,11,27,F,0,12020,Backlog
4JN18CS124,18CPL27,38,48,86,P,9,12020,Backlog
4JN18CS125,18MAT31,22,24,46,P,6,12020,Regular
4JN18CS125,18CS32,26,22,48,P,6,12020,Regular
4JN18CS125,18CS33,26,17,43,F,0,12020,Regular
4JN18CS125,18CS34,21,15,36,F,0,12020,Regular
4JN18CS125,18CS35,26,31,57,P,6,12020,Regular
4JN18CS125,18CS36,29,21,50,P,6,12020,Regular
4JN18CS125,18CSL37,38,50,88,P,9,12020,Regular
4JN18CS125,18CSL38,35,56,91,P,10,12020,Regular
4JN18CS125,18KAK39,82,0,82,P,9,12020,Regular
4JN18CS127,18MAT31,21,22,43,P,4,12020,Regular
4JN18CS127,18CS32,24,26,50,P,6,12020,Regular
4JN18CS127,18CS33,23,29,52,P,6,12020,Regular
4JN18CS127,18CS34,28,16,44,F,0,12020,Regular
4JN18CS127,18CS35,35,24,59,P,6,12020,Regular
4JN18CS127,18CS36,26,10,36,F,0,12020,Regular
4JN18CS127,18CSL37,33,39,72,P,8,12020,Regular
4JN18CS127,18CSL38,35,27,62,P,7,12020,Regular
4JN18CS127,18KAK39,67,0,67,P,7,12020,Regular
4JN18CS129,18MAT31,40,53,93,P,10,12020,Regular
4JN18CS129,18CS32,35,36,71,P,8,12020,Regular
4JN18CS129,18CS33,38,27,65,P,7,12020,Regular
4JN18CS129,18CS34,39,38,77,P,8,12020,Regular
4JN18CS129,18CS35,40,33,73,P,8,12020,Regular
4JN18CS129,18CS36,30,38,68,P,7,12020,Regular
4JN18CS129,18CSL37,40,59,99,P,10,12020,Regular
4JN18CS129,18CSL38,39,54,93,P,10,12020,Regular
4JN18CS129,18KAK39,88,0,88,P,9,12020,Regular
4JN18CS130,18MAT31,40,58,98,P,10,12020,Regular
4JN18CS130,18CS32,37,35,72,P,8,12020,Regular
4JN18CS130,18CS33,39,34,73,P,8,12020,Regular
4JN18CS130,18CS34,39,36,75,P,8,12020,Regular
4JN18CS130,18CS35,40,31,71,P,8,12020,Regular
4JN18CS130,18CS36,36,41,77,P,8,12020,Regular
4JN18CS130,18CSL37,40,56,96,P,10,12020,Regular
4JN18CS130,18CSL38,38,57,95,P,10,12020,Regular
4JN18CS130,18KAK39,95,0,95,P,10,12020,Regular
4JN18CS131,18MAT31,35,54,89,P,9,12020,Regular
4JN18CS131,18CS32,36,47,83,P,9,12020,Regular
4JN18CS131,18CS33,37,34,71,P,8,12020,Regular
4JN18CS131,18CS34,36,34,70,P,8,12020,Regular
4JN18CS131,18CS35,39,30,69,P,7,12020,Regular
4JN18CS131,18CS36,35,49,84,P,9,12020,Regular
4JN18CS131,18CSL37,40,59,99,P,10,12020,Regular
4JN18CS131,18CSL38,38,59,97,P,10,12020,Regular
4JN18CS131,18KAK39,93,0,93,P,10,12020,Regular
4JN19CS400,18MATDIP31,20,8,28,F,0,12020,Regular
4JN19CS400,18MAT31,19,21,40,P,4,12020,Regular
4JN19CS400,18CS32,28,31,59,P,6,12020,Regular
4JN19CS400,18CS33,26,22,48,P,6,12020,Regular
4JN19CS400,18CS34,29,21,50,P,6,12020,Regular
4JN19CS400,18CS35,33,21,54,P,6,12020,Regular
4JN19CS400,18CS36,29,27,56,P,6,12020,Regular
4JN19CS400,18CSL37,37,59,96,P,10,12020,Regular
4JN19CS400,18CSL38,36,11,47,F,0,12020,Regular
4JN19CS400,18KAK39,78,0,78,P,8,12020,Regular
4JN19CS401,18MATDIP31,25,33,58,P,6,12020,Regular
4JN19CS401,18MAT31,24,6,30,F,0,12020,Regular
4JN19CS401,18CS32,29,38,67,P,7,12020,Regular
4JN19CS401,18CS33,24,23,47,P,6,12020,Regular
4JN19CS401,18CS34,24,24,48,P,6,12020,Regular
4JN19CS401,18CS35,33,25,58,P,6,12020,Regular
4JN19CS401,18CS36,23,10,33,F,0,12020,Regular
4JN19CS401,18CSL37,37,39,76,P,8,12020,Regular
4JN19CS401,18CSL38,34,54,88,P,9,12020,Regular
4JN19CS401,18KAK39,88,0,88,P,9,12020,Regular
4JN19CS404,18MATDIP31,21,27,48,P,6,12020,Regular
4JN19CS404,18MAT31,19,33,52,P,6,12020,Regular
4JN19CS404,18CS32,28,34,62,P,7,12020,Regular
4JN19CS404,18CS33,29,33,62,P,7,12020,Regular
4JN19CS404,18CS34,28,24,52,P,6,12020,Regular
4JN19CS404,18CS35,37,31,68,P,7,12020,Regular
4JN19CS404,18CS36,26,30,56,P,6,12020,Regular
4JN19CS404,18CSL37,37,42,79,P,8,12020,Regular
4JN19CS404,18CSL38,35,25,60,P,7,12020,Regular
4JN19CS404,18KAK39,82,0,82,P,9,12020,Regular
4JN19CS407,18MATDIP31,20,16,36,F,0,12020,Regular
4JN19CS407,18MAT31,19,16,35,F,0,12020,Regular
4JN19CS407,18CS32,28,25,53,P,6,12020,Regular
4JN19CS407,18CS33,26,25,51,P,6,12020,Regular
4JN19CS407,18CS34,27,17,44,F,0,12020,Regular
4JN19CS407,18CS35,29,16,45,F,0,12020,Regular
4JN19CS407,18CS36,27,36,63,P,7,12020,Regular
4JN19CS407,18CSL37,37,36,73,P,8,12020,Regular
4JN19CS407,18CSL38,35,24,59,P,6,12020,Regular
4JN19CS407,18KAK39,85,0,85,P,9,12020,Regular
4JN19CS409,18MATDIP31,22,16,38,F,0,12020,Regular
4JN19CS409,18MAT31,21,21,42,P,4,12020,Regular
4JN19CS409,18CS32,25,23,48,P,6,12020,Regular
4JN19CS409,18CS33,25,15,40,F,0,12020,Regular
4JN19CS409,18CS34,30,27,57,P,6,12020,Regular
4JN19CS409,18CS35,30,16,46,F,0,12020,Regular
4JN19CS409,18CS36,27,38,65,P,7,12020,Regular
4JN19CS409,18CSL37,37,36,73,P,8,12020,Regular
4JN19CS409,18CSL38,34,24,58,P,6,12020,Regular
4JN19CS409,18KAK39,89,0,89,P,9,12020,Regular
4JN19CS410,18MATDIP31,22,29,51,P,6,12020,Regular
4JN19CS410,18MAT31,21,23,44,P,4,12020,Regular
4JN19CS410,18CS32,27,29,56,P,6,12020,Regular
4JN19CS410,18CS33,21,3,24,F,0,12020,Regular
4JN19CS410,18CS34,27,22,49,P,6,12020,Regular
4JN19CS410,18CS35,29,6,35,F,0,12020,Regular
4JN19CS410,18CS36,24,30,54,P,6,12020,Regular
4JN19CS410,18CSL37,37,53,90,P,10,12020,Regular
4JN19CS410,18CSL38,34,29,63,P,7,12020,Regular
4JN19CS410,18KAK39,83,0,83,P,9,12020,Regular
4JN19CS411,18MATDIP31,20,12,32,F,0,Jan-20,
4JN19CS411,18MAT31,19,8,27,F,0,12020,Regular
4JN19CS411,18CS32,20,30,50,P,6,12020,Regular
4JN19CS411,18CS33,26,16,42,F,0,Jan-20,
4JN19CS411,18CS34,25,26,51,P,6,12020,Regular
4JN19CS411,18CS35,30,11,41,F,0,Jan-20,
4JN19CS411,18CS36,22,26,48,P,6,12020,Regular
4JN19CS411,18CSL37,37,30,67,P,7,12020,Regular
4JN19CS411,18CSL38,34,9,43,F,0,12020,Regular
4JN19CS411,18KAK39,85,0,85,P,9,12020,Regular
4JN17CS006,18MAT31,19,11,30,F,0,Jan-20,
4JN17CS006,18CS32,24,21,45,P,6,12020,Regular
4JN17CS006,18CS33,27,14,41,F,0,Jan-20,
4JN17CS006,18CS34,23,22,45,P,6,12020,Regular
4JN17CS006,18CS35,39,32,71,P,8,12020,Regular
4JN17CS006,18CS36,25,23,48,P,6,12020,Regular
4JN17CS006,18CSL37,36,32,68,P,7,12020,Regular
4JN17CS006,18CSL38,34,11,45,F,0,12020,Regular
4JN17CS006,18KAK39,87,0,87,P,9,12020,Regular
4JN17CS006,17MAT21,10,0,10,A,0,12020,Backlog
4JN17CS006,17ELN25,16,29,45,P,6,12020,Backlog
4JN17CS006,17MAT11,19,6,25,F,0,Jan-20,
4JN17CS006,17PHY12,16,8,24,F,0,Jan-20,
4JN17CS058,18MAT31,19,12,31,F,0,Jan-20,
4JN17CS058,18CS32,19,21,40,P,4,12020,Regular
4JN17CS058,18CS33,21,5,26,F,0,12020,Regular
4JN17CS058,18CS34,22,6,28,F,0,Jan-20,
4JN17CS058,18CS35,20,14,34,F,0,Jan-20,
4JN17CS058,18CS36,22,17,39,F,0,Jan-20,
4JN17CS058,18CSL37,32,54,86,P,9,12020,Regular
4JN17CS058,18CSL38,28,24,52,P,6,12020,Regular
4JN17CS058,18KAK39,84,0,84,P,9,12020,Regular
4JN17CS058,17MAT21,19,11,30,F,0,Jan-20,
4JN17CS058,17CHE22,23,15,38,F,0,Jan-20,
4JN17CS058,17PHY12,21,15,36,F,0,Jan-20,
4JN17CS065,18MAT31,19,13,32,F,0,Jan-20,
4JN17CS065,18CS32,26,26,52,P,6,12020,Regular
4JN17CS065,18CS33,29,27,56,P,6,12020,Regular
4JN17CS065,18CS34,25,29,54,P,6,12020,Regular
4JN17CS065,18CS35,27,27,54,P,6,12020,Regular
4JN17CS065,18CS36,25,39,64,P,7,12020,Regular
4JN17CS065,18CSL37,38,57,95,P,10,12020,Regular
4JN17CS065,18CSL38,29,27,56,P,6,12020,Regular
4JN17CS065,18KAK39,89,0,89,P,9,12020,Regular
4JN17CS065,17MAT21,13,0,13,A,0,12020,Backlog
4JN17CS072,18MAT31,19,27,46,P,6,12020,Regular
4JN17CS072,18CS32,26,32,58,P,6,12020,Regular
4JN17CS072,18CS33,21,17,38,F,0,12020,Regular
4JN17CS072,18CS34,21,15,36,F,0,12020,Regular
4JN17CS072,18CS35,20,9,29,F,0,12020,Regular
4JN17CS072,18CS36,22,13,35,F,0,12020,Regular
4JN17CS072,18CSL37,34,51,85,P,9,12020,Regular
4JN17CS072,18CSL38,28,14,42,F,0,12020,Regular
4JN17CS072,18KAK39,86,0,86,P,9,12020,Regular
4JN17CS082,18MAT31,19,12,31,F,0,12020,Regular
4JN17CS082,18CS32,21,18,39,F,0,12020,Regular
4JN17CS082,18CS33,17,4,21,F,0,12020,Regular
4JN17CS082,18CS34,19,14,33,F,0,12020,Regular
4JN17CS082,18CS35,20,9,29,F,0,12020,Regular
4JN17CS082,18CS36,21,3,24,F,0,12020,Regular
4JN17CS082,18CSL37,30,11,41,F,0,12020,Regular
4JN17CS082,18CSL38,31,24,55,P,6,12020,Regular
4JN17CS082,18KAK39,42,0,42,P,4,12020,Regular
4JN17CS082,17MAT11,13,2,15,F,0,12020,Backlog
4JN17CS082,17PHY12,15,9,24,F,0,12020,Backlog
4JN17CS104,18MAT31,19,9,28,F,0,Jan-20,
4JN17CS104,18CS32,19,21,40,P,4,12020,Regular
4JN17CS104,18CS33,23,12,35,F,0,Jan-20,
4JN17CS104,18CS34,19,27,46,P,6,12020,Regular
4JN17CS104,18CS35,20,12,32,F,0,Jan-20,
4JN17CS104,18CS36,23,21,44,P,4,12020,Regular
4JN17CS104,18CSL37,36,44,80,P,9,12020,Regular
4JN17CS104,18CSL38,28,15,43,F,0,12020,Regular
4JN17CS104,18KAK39,87,0,87,P,9,12020,Regular
4JN17CS104,17MAT21,19,21,40,P,4,Jan-20,
4JN18CS012,18MAT31,29,22,51,P,6,12020,Regular
4JN18CS012,18CS32,33,26,59,P,6,12020,Regular
4JN18CS012,18CS33,34,34,68,P,7,12020,Regular
4JN18CS012,18CS34,31,28,59,P,6,12020,Regular
4JN18CS012,18CS35,37,31,68,P,7,12020,Regular
4JN18CS012,18CS36,36,27,63,P,7,12020,Regular
4JN18CS012,18CSL37,40,59,99,P,10,12020,Regular
4JN18CS012,18CSL38,36,57,93,P,10,12020,Regular
4JN18CS012,18KAK39,94,0,94,P,10,12020,Regular
4JN18CS022,18MAT31,32,50,82,P,9,12020,Regular
4JN18CS022,18CS32,38,41,79,P,8,12020,Regular
4JN18CS022,18CS33,36,35,71,P,8,12020,Regular
4JN18CS022,18CS34,33,45,78,P,8,12020,Regular
4JN18CS022,18CS35,38,26,64,P,7,12020,Regular
4JN18CS022,18CS36,36,47,83,P,9,12020,Regular
4JN18CS022,18CSL37,38,59,97,P,10,12020,Regular
4JN18CS022,18CSL38,36,55,91,P,10,12020,Regular
4JN18CS022,18KAK39,94,0,94,P,10,12020,Regular
4JN18CS023,18MAT31,26,32,58,P,6,12020,Regular
4JN18CS023,18CS32,26,32,58,P,6,12020,Regular
4JN18CS023,18CS33,32,23,55,P,6,12020,Regular
4JN18CS023,18CS34,24,26,50,P,6,12020,Regular
4JN18CS023,18CS35,32,30,62,P,7,12020,Regular
4JN18CS023,18CS36,30,30,60,P,7,12020,Regular
4JN18CS023,18CSL37,34,14,48,F,0,12020,Regular
4JN18CS023,18CSL38,29,57,86,P,9,12020,Regular
4JN18CS023,18KAK39,94,0,94,P,10,12020,Regular
4JN18CS024,18MAT31,24,25,49,P,6,12020,Regular
4JN18CS024,18CS32,33,23,56,P,6,12020,Regular
4JN18CS024,18CS33,31,23,54,P,6,12020,Regular
4JN18CS024,18CS34,24,11,35,F,0,Jan-20,
4JN18CS024,18CS35,31,21,52,P,6,12020,Regular
4JN18CS024,18CS36,27,24,51,P,6,12020,Regular
4JN18CS024,18CSL37,36,59,95,P,10,12020,Regular
4JN18CS024,18CSL38,38,36,74,P,8,12020,Regular
4JN18CS024,18KAK39,95,0,95,P,10,12020,Regular
4JN18CS024,18ELN24,28,21,49,P,6,12020,Backlog
4JN18CS025,18MAT31,27,39,66,P,7,12020,Regular
4JN18CS025,18CS32,24,33,57,P,6,12020,Regular
4JN18CS025,18CS33,31,21,52,P,6,12020,Regular
4JN18CS025,18CS34,21,21,42,P,4,12020,Regular
4JN18CS025,18CS35,24,21,45,P,6,12020,Regular
4JN18CS025,18CS36,24,30,54,P,6,12020,Regular
4JN18CS025,18CSL37,36,48,84,P,9,12020,Regular
4JN18CS025,18CSL38,39,48,87,P,9,12020,Regular
4JN18CS025,18KVK39,74,0,74,P,8,12020,Regular
4JN18CS029,18MAT31,27,23,50,P,6,Jan-20,
4JN18CS029,18CS32,22,21,43,P,4,12020,Regular
4JN18CS029,18CS33,22,21,43,P,4,12020,Regular
4JN18CS029,18CS34,19,15,34,F,0,12020,Regular
4JN18CS029,18CS35,23,9,32,F,0,12020,Regular
4JN18CS029,18CS36,23,23,46,P,6,12020,Regular
4JN18CS029,18CSL37,34,27,61,P,7,12020,Regular
4JN18CS029,18CSL38,28,14,42,F,0,12020,Regular
4JN18CS029,18KAK39,93,0,93,P,10,12020,Regular
4JN18CS032,18MAT31,38,59,97,P,10,12020,Regular
4JN18CS032,18CS32,38,51,89,P,9,12020,Regular
4JN18CS032,18CS33,37,29,66,P,7,12020,Regular
4JN18CS032,18CS34,36,35,71,P,8,12020,Regular
4JN18CS032,18CS35,39,29,68,P,7,12020,Regular
4JN18CS032,18CS36,36,37,73,P,8,12020,Regular
4JN18CS032,18CSL37,40,44,84,P,9,12020,Regular
4JN18CS032,18CSL38,36,60,96,P,10,12020,Regular
4JN18CS032,18KAK39,94,0,94,P,10,12020,Regular
4JN18CS033,18MAT31,22,28,50,P,6,12020,Regular
4JN18CS033,18CS32,29,24,53,P,6,12020,Regular
4JN18CS033,18CS33,33,29,62,P,7,12020,Regular
4JN18CS033,18CS34,24,23,47,P,6,12020,Regular
4JN18CS033,18CS35,29,24,53,P,6,12020,Regular
4JN18CS033,18CS36,34,25,59,P,6,12020,Regular
4JN18CS033,18CSL37,40,47,87,P,9,12020,Regular
4JN18CS033,18CSL38,30,50,80,P,9,12020,Regular
4JN18CS033,18KAK39,93,0,93,P,10,12020,Regular
4JN18CS036,18MAT31,35,47,82,P,9,12020,Regular
4JN18CS036,18CS32,34,33,67,P,7,Jan-20,
4JN18CS036,18CS33,35,24,59,P,6,12020,Regular
4JN18CS036,18CS34,27,44,71,P,8,12020,Regular
4JN18CS036,18CS35,37,26,63,P,7,12020,Regular
4JN18CS036,18CS36,36,39,75,P,8,Jan-20,
4JN18CS036,18CSL37,36,59,95,P,10,12020,Regular
4JN18CS036,18CSL38,40,59,99,P,10,12020,Regular
4JN18CS036,18KAK39,96,0,96,P,10,12020,Regular
4JN18CS037,18MAT31,34,39,73,P,8,12020,Regular
4JN18CS037,18CS32,37,40,77,P,8,12020,Regular
4JN18CS037,18CS33,38,35,73,P,8,12020,Regular
4JN18CS037,18CS34,34,39,73,P,8,12020,Regular
4JN18CS037,18CS35,39,29,68,P,7,12020,Regular
4JN18CS037,18CS36,38,45,83,P,9,12020,Regular
4JN18CS037,18CSL37,40,59,99,P,10,12020,Regular
4JN18CS037,18CSL38,38,58,96,P,10,12020,Regular
4JN18CS037,18KAK39,93,0,93,P,10,12020,Regular
4JN18CS038,18MAT31,20,32,52,P,6,12020,Regular
4JN18CS038,18CS32,30,30,60,P,7,Jan-20,
4JN18CS038,18CS33,34,23,57,P,6,Jan-20,
4JN18CS038,18CS34,25,28,53,P,6,Jan-20,
4JN18CS038,18CS35,34,27,61,P,7,Jan-20,
4JN18CS038,18CS36,30,29,59,P,6,12020,Regular
4JN18CS038,18CSL37,36,38,74,P,8,12020,Regular
4JN18CS038,18CSL38,29,51,80,P,9,12020,Regular
4JN18CS038,18KAK39,94,0,94,P,10,12020,Regular
4JN18CS038,18ELN24,27,21,48,P,6,12020,Backlog
4JN18CS042,18MAT31,36,51,87,P,9,12020,Regular
4JN18CS042,18CS32,37,33,70,P,8,12020,Regular
4JN18CS042,18CS33,37,27,64,P,7,12020,Regular
4JN18CS042,18CS34,31,22,53,P,6,12020,Regular
4JN18CS042,18CS35,39,38,77,P,8,12020,Regular
4JN18CS042,18CS36,37,25,62,P,7,12020,Regular
4JN18CS042,18CSL37,40,50,90,P,10,12020,Regular
4JN18CS042,18CSL38,40,54,94,P,10,12020,Regular
4JN18CS042,18KAK39,94,0,94,P,10,12020,Regular
4JN18CS043,18MAT31,26,34,60,P,7,12020,Regular
4JN18CS043,18CS32,31,32,63,P,7,12020,Regular
4JN18CS043,18CS33,33,29,62,P,7,12020,Regular
4JN18CS043,18CS34,28,30,58,P,6,12020,Regular
4JN18CS043,18CS35,33,36,69,P,7,12020,Regular
4JN18CS043,18CS36,33,36,69,P,7,12020,Regular
4JN18CS043,18CSL37,36,59,95,P,10,12020,Regular
4JN18CS043,18CSL38,32,59,91,P,10,12020,Regular
4JN18CS043,18KVK39,90,0,90,P,10,12020,Regular
4JN18CS045,18MAT31,25,35,60,P,7,12020,Regular
4JN18CS045,18CS32,23,21,44,P,4,12020,Regular
4JN18CS045,18CS33,22,15,37,F,0,12020,Regular
4JN18CS045,18CS34,19,9,28,F,0,12020,Regular
4JN18CS045,18CS35,21,12,33,F,0,12020,Regular
4JN18CS045,18CS36,28,22,50,P,6,12020,Regular
4JN18CS045,18CSL37,36,26,62,P,7,12020,Regular
4JN18CS045,18CSL38,28,8,36,F,0,12020,Regular
4JN18CS045,18KAK39,83,0,83,P,9,12020,Regular
4JN18CS045,18CPS23,18,11,29,F,0,12020,Backlog
4JN18CS045,18ELN24,20,2,22,F,0,12020,Backlog
4JN18CS048,18MAT31,28,32,60,P,7,12020,Regular
4JN18CS048,18CS32,37,45,82,P,9,12020,Regular
4JN18CS048,18CS33,33,24,57,P,6,Jan-20,
4JN18CS048,18CS34,28,21,49,P,6,12020,Regular
4JN18CS048,18CS35,36,21,57,P,6,12020,Regular
4JN18CS048,18CS36,33,30,63,P,7,12020,Regular
4JN18CS048,18CSL37,40,59,99,P,10,12020,Regular
4JN18CS048,18CSL38,36,60,96,P,10,12020,Regular
4JN18CS048,18KVK39,85,0,85,P,9,12020,Regular
4JN18CS049,18MAT31,32,45,77,P,8,12020,Regular
4JN18CS049,18CS32,37,33,70,P,8,12020,Regular
4JN18CS049,18CS33,32,26,58,P,6,12020,Regular
4JN18CS049,18CS34,25,26,51,P,6,12020,Regular
4JN18CS049,18CS35,30,28,58,P,6,12020,Regular
4JN18CS049,18CS36,34,36,70,P,8,12020,Regular
4JN18CS049,18CSL37,37,59,96,P,10,12020,Regular
4JN18CS049,18CSL38,36,48,84,P,9,12020,Regular
4JN18CS049,18KAK39,98,0,98,P,10,12020,Regular
4JN18CS050,18MAT31,19,22,41,P,4,12020,Regular
4JN18CS050,18CS32,28,24,52,P,6,12020,Regular
4JN18CS050,18CS33,28,21,49,P,6,12020,Regular
4JN18CS050,18CS34,23,26,49,P,6,12020,Regular
4JN18CS050,18CS35,27,22,49,P,6,12020,Regular
4JN18CS050,18CS36,30,29,59,P,6,12020,Regular
4JN18CS050,18CSL37,36,56,92,P,10,12020,Regular
4JN18CS050,18CSL38,36,27,63,P,7,12020,Regular
4JN18CS050,18KAK39,89,0,89,P,9,12020,Regular
4JN18CS050,18CHE22,25,21,46,P,6,12020,Backlog
4JN18CS050,18ELN24,24,30,54,P,6,12020,Backlog
4JN18CS050,18ELE13,18,22,40,P,4,Jan-20,
4JN18CS051,18MAT31,21,22,43,P,4,12020,Regular
4JN18CS051,18CS32,19,21,40,P,4,12020,Regular
4JN18CS051,18CS33,33,29,62,P,7,12020,Regular
4JN18CS051,18CS34,28,32,60,P,7,12020,Regular
4JN18CS051,18CS35,34,41,75,P,8,12020,Regular
4JN18CS051,18CS36,33,29,62,P,7,12020,Regular
4JN18CS051,18CSL37,36,50,86,P,9,12020,Regular
4JN18CS051,18CSL38,29,51,80,P,9,12020,Regular
4JN18CS051,18KAK39,84,0,84,P,9,12020,Regular
4JN18CS052,18MAT31,37,60,97,P,10,12020,Regular
4JN18CS052,18CS32,40,41,81,P,9,12020,Regular
4JN18CS052,18CS33,40,38,78,P,8,12020,Regular
4JN18CS052,18CS34,38,44,82,P,9,12020,Regular
4JN18CS052,18CS35,38,38,76,P,8,12020,Regular
4JN18CS052,18CS36,40,44,84,P,9,Jan-20,
4JN18CS052,18CSL37,40,59,99,P,10,12020,Regular
4JN18CS052,18CSL38,40,60,100,P,10,12020,Regular
4JN18CS052,18KAK39,92,0,92,P,10,12020,Regular
4JN18CS053,18MAT31,25,39,64,P,7,12020,Regular
4JN18CS053,18CS32,30,38,68,P,7,12020,Regular
4JN18CS053,18CS33,31,21,52,P,6,12020,Regular
4JN18CS053,18CS34,22,22,44,P,4,12020,Regular
4JN18CS053,18CS35,28,21,49,P,6,12020,Regular
4JN18CS053,18CS36,34,28,62,P,7,12020,Regular
4JN18CS053,18CSL37,40,59,99,P,10,12020,Regular
4JN18CS053,18CSL38,34,56,90,P,10,12020,Regular
4JN18CS053,18KAK39,89,0,89,P,9,12020,Regular
4JN18CS054,18MAT31,31,29,60,P,7,Jan-20,
4JN18CS054,18CS32,39,38,77,P,8,Jan-20,
4JN18CS054,18CS33,33,21,54,P,6,Jan-20,
4JN18CS054,18CS34,30,28,58,P,6,12020,Regular
4JN18CS054,18CS35,37,21,58,P,6,Jan-20,
4JN18CS054,18CS36,36,24,60,P,7,Jan-20,
4JN18CS054,18CSL37,36,51,87,P,9,12020,Regular
4JN18CS054,18CSL38,40,59,99,P,10,12020,Regular
4JN18CS054,18KAK39,94,0,94,P,10,12020,Regular
4JN18CS055,18MAT31,23,38,61,P,7,12020,Regular
4JN18CS055,18CS32,21,21,42,P,4,12020,Regular
4JN18CS055,18CS33,23,14,37,F,0,Jan-20,
4JN18CS055,18CS34,19,15,34,F,0,Jan-20,
4JN18CS055,18CS35,22,26,48,P,6,12020,Regular
4JN18CS055,18CS36,24,24,48,P,6,12020,Regular
4JN18CS055,18CSL37,38,26,64,P,7,12020,Regular
4JN18CS055,18CSL38,30,9,39,F,0,12020,Regular
4JN18CS055,18KVK39,70,0,70,P,8,12020,Regular
4JN18CS056,18MAT31,39,56,95,P,10,12020,Regular
4JN18CS056,18CS32,40,47,87,P,9,12020,Regular
4JN18CS056,18CS33,40,38,78,P,8,12020,Regular
4JN18CS056,18CS34,36,41,77,P,8,12020,Regular
4JN18CS056,18CS35,40,38,78,P,8,12020,Regular
4JN18CS056,18CS36,39,35,74,P,8,12020,Regular
4JN18CS056,18CSL37,40,58,98,P,10,12020,Regular
4JN18CS056,18CSL38,39,60,99,P,10,12020,Regular
4JN18CS056,18KAK39,94,0,94,P,10,12020,Regular
4JN18CS057,18MAT31,33,40,73,P,8,12020,Regular
4JN18CS057,18CS32,27,32,59,P,6,12020,Regular
4JN18CS057,18CS33,33,28,61,P,7,12020,Regular
4JN18CS057,18CS34,27,21,48,P,6,12020,Regular
4JN18CS057,18CS35,29,22,51,P,6,12020,Regular
4JN18CS057,18CS36,34,26,60,P,7,12020,Regular
4JN18CS057,18CSL37,36,59,95,P,10,12020,Regular
4JN18CS057,18CSL38,32,42,74,P,8,12020,Regular
4JN18CS057,18KAK39,94,0,94,P,10,12020,Regular
4JN18CS057,18ELN24,24,31,55,P,6,12020,Backlog
4JN18CS058,18MAT31,33,44,77,P,8,12020,Regular
4JN18CS058,18CS32,33,36,69,P,7,12020,Regular
4JN18CS058,18CS33,36,23,59,P,6,12020,Regular
4JN18CS058,18CS34,31,38,69,P,7,12020,Regular
4JN18CS058,18CS35,33,32,65,P,7,12020,Regular
4JN18CS058,18CS36,37,36,73,P,8,12020,Regular
4JN18CS058,18CSL37,40,48,88,P,9,12020,Regular
4JN18CS058,18CSL38,32,38,70,P,8,12020,Regular
4JN18CS058,18KAK39,92,0,92,P,10,12020,Regular
4JN18CS059,18MAT31,28,35,63,P,7,12020,Regular
4JN18CS059,18CS32,29,30,59,P,6,12020,Regular
4JN18CS059,18CS33,27,21,48,P,6,12020,Regular
4JN18CS059,18CS34,25,23,48,P,6,12020,Regular
4JN18CS059,18CS35,32,33,65,P,7,12020,Regular
4JN18CS059,18CS36,30,32,62,P,7,12020,Regular
4JN18CS059,18CSL37,36,57,93,P,10,12020,Regular
4JN18CS059,18CSL38,32,51,83,P,9,12020,Regular
4JN18CS059,18KAK39,92,0,92,P,10,12020,Regular
4JN18CS060,18MAT31,37,55,92,P,10,12020,Regular
4JN18CS060,18CS32,36,51,87,P,9,12020,Regular
4JN18CS060,18CS33,36,23,59,P,6,12020,Regular
4JN18CS060,18CS34,32,35,67,P,7,12020,Regular
4JN18CS060,18CS35,38,41,79,P,8,12020,Regular
4JN18CS060,18CS36,39,26,65,P,7,12020,Regular
4JN18CS060,18CSL37,40,59,99,P,10,12020,Regular
4JN18CS060,18CSL38,36,53,89,P,9,12020,Regular
4JN18CS060,18KAK39,94,0,94,P,10,12020,Regular
4JN18CS061,18MAT31,36,44,80,P,9,12020,Regular
4JN18CS061,18CS32,36,46,82,P,9,12020,Regular
4JN18CS061,18CS33,39,29,68,P,7,12020,Regular
4JN18CS061,18CS34,32,21,53,P,6,12020,Regular
4JN18CS061,18CS35,38,25,63,P,7,12020,Regular
4JN18CS061,18CS36,33,28,61,P,7,12020,Regular
4JN18CS061,18CSL37,40,57,97,P,10,12020,Regular
4JN18CS061,18CSL38,32,48,80,P,9,12020,Regular
4JN18CS061,18KAK39,94,0,94,P,10,12020,Regular
4JN18CS062,18MAT31,23,27,50,P,6,12020,Regular
4JN18CS062,18CS32,29,26,55,P,6,12020,Regular
4JN18CS062,18CS33,32,29,61,P,7,12020,Regular
4JN18CS062,18CS34,24,26,50,P,6,12020,Regular
4JN18CS062,18CS35,31,30,61,P,7,12020,Regular
4JN18CS062,18CS36,32,27,59,P,6,12020,Regular
4JN18CS062,18CSL37,40,56,96,P,10,12020,Regular
4JN18CS062,18CSL38,30,11,41,F,0,12020,Regular
4JN18CS062,18KAK39,90,0,90,P,10,12020,Regular
4JN18CS063,18MAT31,19,26,45,P,6,12020,Regular
4JN18CS063,18CS32,27,35,62,P,7,12020,Regular
4JN18CS063,18CS33,30,24,54,P,6,12020,Regular
4JN18CS063,18CS34,27,24,51,P,6,12020,Regular
4JN18CS063,18CS35,32,36,68,P,7,12020,Regular
4JN18CS063,18CS36,29,24,53,P,6,12020,Regular
4JN18CS063,18CSL37,35,27,62,P,7,12020,Regular
4JN18CS063,18CSL38,28,36,64,P,7,12020,Regular
4JN18CS063,18KAK39,89,0,89,P,9,12020,Regular
4JN18CS064,18MAT31,32,35,67,P,7,12020,Regular
4JN18CS064,18CS32,25,45,70,P,8,12020,Regular
4JN18CS064,18CS33,32,26,58,P,6,12020,Regular
4JN18CS064,18CS34,21,30,51,P,6,12020,Regular
4JN18CS064,18CS35,37,24,61,P,7,12020,Regular
4JN18CS064,18CS36,33,29,62,P,7,12020,Regular
4JN18CS064,18CSL37,38,48,86,P,9,12020,Regular
4JN18CS064,18CSL38,28,27,55,P,6,12020,Regular
4JN18CS064,18KAK39,88,0,88,P,9,12020,Regular
4JN18CS065,18MAT31,31,35,66,P,7,12020,Regular
4JN18CS065,18CS32,30,45,75,P,8,12020,Regular
4JN18CS065,18CS33,31,30,61,P,7,12020,Regular
4JN18CS065,18CS34,23,24,47,P,6,12020,Regular
4JN18CS065,18CS35,29,21,50,P,6,12020,Regular
4JN18CS065,18CS36,35,30,65,P,7,12020,Regular
4JN18CS065,18CSL37,40,27,67,P,7,12020,Regular
4JN18CS065,18CSL38,28,30,58,P,6,12020,Regular
4JN18CS065,18KAK39,93,0,93,P,10,12020,Regular
4JN18CS066,18MAT31,30,32,62,P,7,12020,Regular
4JN18CS066,18CS32,36,35,71,P,8,12020,Regular
4JN18CS066,18CS33,34,33,67,P,7,12020,Regular
4JN18CS066,18CS34,31,30,61,P,7,12020,Regular
4JN18CS066,18CS35,35,29,64,P,7,12020,Regular
4JN18CS066,18CS36,39,38,77,P,8,12020,Regular
4JN18CS066,18CSL37,40,56,96,P,10,12020,Regular
4JN18CS066,18CSL38,32,27,59,P,6,12020,Regular
4JN18CS066,18KAK39,96,0,96,P,10,12020,Regular
4JN18CS069,18MAT31,22,27,49,P,6,12020,Regular
4JN18CS069,18CS32,27,35,62,P,7,12020,Regular
4JN18CS069,18CS33,25,21,46,P,6,12020,Regular
4JN18CS069,18CS34,19,22,41,P,4,12020,Regular
4JN18CS069,18CS35,23,11,34,F,0,12020,Regular
4JN18CS069,18CS36,27,23,50,P,6,Jan-20,
4JN18CS069,18CSL37,36,48,84,P,9,12020,Regular
4JN18CS069,18CSL38,30,8,38,F,0,12020,Regular
4JN18CS069,18KAK39,91,0,91,P,10,12020,Regular
4JN18CS069,18PHY12,25,21,46,P,6,Jan-20,
4JN18CS069,18ELE13,26,24,50,P,6,12020,Backlog
4JN18CS070,18MAT31,40,53,93,P,10,12020,Regular
4JN18CS070,18CS32,33,41,74,P,8,12020,Regular
4JN18CS070,18CS33,36,46,82,P,9,12020,Regular
4JN18CS070,18CS34,35,41,76,P,8,12020,Regular
4JN18CS070,18CS35,35,42,77,P,8,12020,Regular
4JN18CS070,18CS36,39,51,90,P,10,12020,Regular
4JN18CS070,18CSL37,40,45,85,P,9,12020,Regular
4JN18CS070,18CSL38,36,50,86,P,9,12020,Regular
4JN18CS070,18KAK39,94,0,94,P,10,12020,Regular
4JN18CS073,18MAT31,40,53,93,P,10,12020,Regular
4JN18CS073,18CS32,34,38,72,P,8,12020,Regular
4JN18CS073,18CS33,31,31,62,P,7,12020,Regular
4JN18CS073,18CS34,28,33,61,P,7,12020,Regular
4JN18CS073,18CS35,37,40,77,P,8,12020,Regular
4JN18CS073,18CS36,32,23,55,P,6,12020,Regular
4JN18CS073,18CSL37,40,57,97,P,10,12020,Regular
4JN18CS073,18CSL38,30,44,74,P,8,12020,Regular
4JN18CS073,18KAK39,88,0,88,P,9,12020,Regular
4JN18CS074,18MAT31,39,50,89,P,9,12020,Regular
4JN18CS074,18CS32,34,37,71,P,8,12020,Regular
4JN18CS074,18CS33,39,35,74,P,8,12020,Regular
4JN18CS074,18CS34,34,37,71,P,8,12020,Regular
4JN18CS074,18CS35,40,25,65,P,7,12020,Regular
4JN18CS074,18CS36,37,36,73,P,8,12020,Regular
4JN18CS074,18CSL37,40,59,99,P,10,12020,Regular
4JN18CS074,18CSL38,36,48,84,P,9,12020,Regular
4JN18CS074,18KAK39,93,0,93,P,10,12020,Regular
4JN18CS075,18MAT31,34,36,70,P,8,12020,Regular
4JN18CS075,18CS32,35,38,73,P,8,12020,Regular
4JN18CS075,18CS33,33,24,57,P,6,12020,Regular
4JN18CS075,18CS34,27,26,53,P,6,12020,Regular
4JN18CS075,18CS35,31,23,54,P,6,Jan-20,
4JN18CS075,18CS36,29,38,67,P,7,12020,Regular
4JN18CS075,18CSL37,38,39,77,P,8,12020,Regular
4JN18CS075,18CSL38,32,44,76,P,8,12020,Regular
4JN18CS075,18KAK39,84,0,84,P,9,12020,Regular
4JN18CS076,18MAT31,40,51,91,P,10,12020,Regular
4JN18CS076,18CS32,39,48,87,P,9,12020,Regular
4JN18CS076,18CS33,39,29,68,P,7,12020,Regular
4JN18CS076,18CS34,32,44,76,P,8,12020,Regular
4JN18CS076,18CS35,39,39,78,P,8,12020,Regular
4JN18CS076,18CS36,39,41,80,P,9,12020,Regular
4JN18CS076,18CSL37,40,59,99,P,10,12020,Regular
4JN18CS076,18CSL38,32,57,89,P,9,12020,Regular
4JN18CS076,18KAK39,96,0,96,P,10,12020,Regular
4JN18CS077,18MAT31,30,51,81,P,9,12020,Regular
4JN18CS077,18CS32,37,48,85,P,9,12020,Regular
4JN18CS077,18CS33,31,23,54,P,6,12020,Regular
4JN18CS077,18CS34,28,25,53,P,6,12020,Regular
4JN18CS077,18CS35,33,24,57,P,6,12020,Regular
4JN18CS077,18CS36,34,48,82,P,9,12020,Regular
4JN18CS077,18CSL37,40,48,88,P,9,12020,Regular
4JN18CS077,18CSL38,37,35,72,P,8,12020,Regular
4JN18CS077,18KAK39,87,0,87,P,9,12020,Regular
4JN18CS077,18ELN24,22,36,58,P,6,12020,Backlog
4JN18CS080,18MAT31,30,39,69,P,7,12020,Regular
4JN18CS080,18CS32,32,36,68,P,7,12020,Regular
4JN18CS080,18CS33,33,23,56,P,6,12020,Regular
4JN18CS080,18CS34,24,33,57,P,6,12020,Regular
4JN18CS080,18CS35,31,30,61,P,7,12020,Regular
4JN18CS080,18CS36,31,31,62,P,7,12020,Regular
4JN18CS080,18CSL37,38,57,95,P,10,12020,Regular
4JN18CS080,18CSL38,34,9,43,F,0,12020,Regular
4JN18CS080,18KAK39,89,0,89,P,9,12020,Regular
4JN18CS082,18MAT31,19,27,46,P,6,12020,Regular
4JN18CS082,18CS32,25,25,50,P,6,12020,Regular
4JN18CS082,18CS33,24,18,42,F,0,Jan-20,
4JN18CS082,18CS34,19,21,40,P,4,12020,Regular
4JN18CS082,18CS35,24,21,45,P,6,12020,Regular
4JN18CS082,18CS36,25,17,42,F,0,Jan-20,
4JN18CS082,18CSL37,36,39,75,P,8,12020,Regular
4JN18CS082,18CSL38,28,8,36,F,0,12020,Regular
4JN18CS082,18KAK39,97,0,97,P,10,12020,Regular
4JN18CS082,18CHE22,22,21,43,P,4,Jan-20,
4JN18CS082,18ELN24,19,24,43,P,4,12020,Backlog
4JN18CS083,18MAT31,37,53,90,P,10,12020,Regular
4JN18CS083,18CS32,40,47,87,P,9,12020,Regular
4JN18CS083,18CS33,40,32,72,P,8,12020,Regular
4JN18CS083,18CS34,36,38,74,P,8,12020,Regular
4JN18CS083,18CS35,40,35,75,P,8,12020,Regular
4JN18CS083,18CS36,38,44,82,P,9,12020,Regular
4JN18CS083,18CSL37,40,56,96,P,10,12020,Regular
4JN18CS083,18CSL38,36,27,63,P,7,12020,Regular
4JN18CS083,18KAK39,94,0,94,P,10,12020,Regular
4JN18CS084,18MAT31,39,54,93,P,10,12020,Regular
4JN18CS084,18CS32,40,47,87,P,9,12020,Regular
4JN18CS084,18CS33,39,27,66,P,7,12020,Regular
4JN18CS084,18CS34,39,45,84,P,9,12020,Regular
4JN18CS084,18CS35,39,38,77,P,8,12020,Regular
4JN18CS084,18CS36,40,55,95,P,10,12020,Regular
4JN18CS084,18CSL37,40,57,97,P,10,12020,Regular
4JN18CS084,18CSL38,38,58,96,P,10,12020,Regular
4JN18CS084,18KAK39,90,0,90,P,10,12020,Regular
4JN18CS085,18MAT31,25,26,51,P,6,12020,Regular
4JN18CS085,18CS32,35,29,64,P,7,12020,Regular
4JN18CS085,18CS33,32,21,53,P,6,Jan-20,
4JN18CS085,18CS34,27,23,50,P,6,12020,Regular
4JN18CS085,18CS35,35,31,66,P,7,12020,Regular
4JN18CS085,18CS36,31,29,60,P,7,12020,Regular
4JN18CS085,18CSL37,38,45,83,P,9,12020,Regular
4JN18CS085,18CSL38,35,11,46,F,0,12020,Regular
4JN18CS085,18KAK39,95,0,95,P,10,12020,Regular
4JN18CS086,18MAT31,37,54,91,P,10,12020,Regular
4JN18CS086,18CS32,38,36,74,P,8,12020,Regular
4JN18CS086,18CS33,37,29,66,P,7,12020,Regular
4JN18CS086,18CS34,27,33,60,P,7,12020,Regular
4JN18CS086,18CS35,36,30,66,P,7,12020,Regular
4JN18CS086,18CS36,38,51,89,P,9,12020,Regular
4JN18CS086,18CSL37,40,57,97,P,10,12020,Regular
4JN18CS086,18CSL38,32,12,44,F,0,12020,Regular
4JN18CS086,18KAK39,84,0,84,P,9,12020,Regular
4JN18CS088,18MAT31,38,51,89,P,9,12020,Regular
4JN18CS088,18CS32,37,44,81,P,9,12020,Regular
4JN18CS088,18CS33,30,30,60,P,7,12020,Regular
4JN18CS088,18CS34,24,31,55,P,6,12020,Regular
4JN18CS088,18CS35,37,25,62,P,7,12020,Regular
4JN18CS088,18CS36,33,41,74,P,8,12020,Regular
4JN18CS088,18CSL37,38,57,95,P,10,12020,Regular
4JN18CS088,18CSL38,40,57,97,P,10,12020,Regular
4JN18CS088,18KAK39,84,0,84,P,9,12020,Regular
4JN18CS092,18MAT31,39,59,98,P,10,12020,Regular
4JN18CS092,18CS32,40,32,72,P,8,Jan-20,
4JN18CS092,18CS33,40,41,81,P,9,Jan-20,
4JN18CS092,18CS34,40,46,86,P,9,12020,Regular
4JN18CS092,18CS35,40,35,75,P,8,12020,Regular
4JN18CS092,18CS36,40,51,91,P,10,Jan-20,
4JN18CS092,18CSL37,40,60,100,P,10,12020,Regular
4JN18CS092,18CSL38,40,29,69,P,7,12020,Regular
4JN18CS092,18KAK39,96,0,96,P,10,12020,Regular
4JN18CS093,18MAT31,20,21,41,P,4,12020,Regular
4JN18CS093,18CS32,27,23,50,P,6,12020,Regular
4JN18CS093,18CS33,31,21,52,P,6,Jan-20,
4JN18CS093,18CS34,25,21,46,P,6,12020,Regular
4JN18CS093,18CS35,33,21,54,P,6,12020,Regular
4JN18CS093,18CS36,25,32,57,P,6,12020,Regular
4JN18CS093,18CSL37,36,48,84,P,9,12020,Regular
4JN18CS093,18CSL38,30,28,58,P,6,12020,Regular
4JN18CS093,18KAK39,90,0,90,P,10,12020,Regular
4JN18CS094,18MAT31,28,35,63,P,7,12020,Regular
4JN18CS094,18CS32,36,36,72,P,8,12020,Regular
4JN18CS094,18CS33,33,24,57,P,6,12020,Regular
4JN18CS094,18CS34,29,24,53,P,6,12020,Regular
4JN18CS094,18CS35,28,29,57,P,6,12020,Regular
4JN18CS094,18CS36,35,24,59,P,6,12020,Regular
4JN18CS094,18CSL37,36,42,78,P,8,12020,Regular
4JN18CS094,18CSL38,34,47,81,P,9,12020,Regular
4JN18CS094,18KAK39,92,0,92,P,10,12020,Regular
4JN18CS095,18MAT31,38,52,90,P,10,12020,Regular
4JN18CS095,18CS32,37,38,75,P,8,12020,Regular
4JN18CS095,18CS33,34,41,75,P,8,12020,Regular
4JN18CS095,18CS34,33,36,69,P,7,12020,Regular
4JN18CS095,18CS35,34,35,69,P,7,12020,Regular
4JN18CS095,18CS36,37,46,83,P,9,12020,Regular
4JN18CS095,18CSL37,40,56,96,P,10,12020,Regular
4JN18CS095,18CSL38,38,39,77,P,8,12020,Regular
4JN18CS095,18KAK39,93,0,93,P,10,12020,Regular
4JN18CS097,18MAT31,27,26,53,P,6,12020,Regular
4JN18CS097,18CS32,31,29,60,P,7,12020,Regular
4JN18CS097,18CS33,32,32,64,P,7,12020,Regular
4JN18CS097,18CS34,33,26,59,P,6,12020,Regular
4JN18CS097,18CS35,33,25,58,P,6,12020,Regular
4JN18CS097,18CS36,36,33,69,P,7,12020,Regular
4JN18CS097,18CSL37,38,51,89,P,9,12020,Regular
4JN18CS097,18CSL38,30,0,30,F,0,12020,Regular
4JN18CS097,18KAK39,94,0,94,P,10,12020,Regular
4JN18CS098,18MAT31,39,49,88,P,9,12020,Regular
4JN18CS098,18CS32,30,42,72,P,8,12020,Regular
4JN18CS098,18CS33,31,21,52,P,6,12020,Regular
4JN18CS098,18CS34,29,29,58,P,6,12020,Regular
4JN18CS098,18CS35,33,24,57,P,6,12020,Regular
4JN18CS098,18CS36,33,39,72,P,8,12020,Regular
4JN18CS098,18CSL37,40,59,99,P,10,12020,Regular
4JN18CS098,18CSL38,29,29,58,P,6,12020,Regular
4JN18CS098,18KAK39,91,0,91,P,10,12020,Regular
4JN18CS099,18MAT31,24,22,46,P,6,12020,Regular
4JN18CS099,18CS32,36,31,67,P,7,12020,Regular
4JN18CS099,18CS33,33,21,54,P,6,12020,Regular
4JN18CS099,18CS34,27,21,48,P,6,12020,Regular
4JN18CS099,18CS35,35,38,73,P,8,12020,Regular
4JN18CS099,18CS36,31,21,52,P,6,12020,Regular
4JN18CS099,18CSL37,36,50,86,P,9,12020,Regular
4JN18CS099,18CSL38,32,27,59,P,6,12020,Regular
4JN18CS099,18KAK39,85,0,85,P,9,12020,Regular
4JN18CS100,18MAT31,33,53,86,P,9,12020,Regular
4JN18CS100,18CS32,33,48,81,P,9,12020,Regular
4JN18CS100,18CS33,34,27,61,P,7,12020,Regular
4JN18CS100,18CS34,33,30,63,P,7,12020,Regular
4JN18CS100,18CS35,35,30,65,P,7,12020,Regular
4JN18CS100,18CS36,36,49,85,P,9,12020,Regular
4JN18CS100,18CSL37,40,56,96,P,10,12020,Regular
4JN18CS100,18CSL38,37,27,64,P,7,12020,Regular
4JN18CS100,18KAK39,93,0,93,P,10,12020,Regular
4JN18CS103,18MAT31,29,42,71,P,8,12020,Regular
4JN18CS103,18CS32,29,37,66,P,7,12020,Regular
4JN18CS103,18CS33,35,33,68,P,7,12020,Regular
4JN18CS103,18CS34,30,40,70,P,8,12020,Regular
4JN18CS103,18CS35,35,27,62,P,7,12020,Regular
4JN18CS103,18CS36,33,39,72,P,8,12020,Regular
4JN18CS103,18CSL37,40,51,91,P,10,12020,Regular
4JN18CS103,18CSL38,40,36,76,P,8,12020,Regular
4JN18CS103,18KAK39,88,0,88,P,9,12020,Regular
4JN18CS104,18MAT31,37,53,90,P,10,12020,Regular
4JN18CS104,18CS32,37,43,80,P,9,12020,Regular
4JN18CS104,18CS33,39,36,75,P,8,12020,Regular
4JN18CS104,18CS34,32,29,61,P,7,12020,Regular
4JN18CS104,18CS35,37,23,60,P,7,12020,Regular
4JN18CS104,18CS36,39,45,84,P,9,12020,Regular
4JN18CS104,18CSL37,40,56,96,P,10,12020,Regular
4JN18CS104,18CSL38,37,53,90,P,10,12020,Regular
4JN18CS104,18KAK39,98,0,98,P,10,12020,Regular
4JN18CS126,18MAT31,23,27,50,P,6,12020,Regular
4JN18CS126,18CS32,29,25,54,P,6,12020,Regular
4JN18CS126,18CS33,21,16,37,F,0,Jan-20,
4JN18CS126,18CS34,19,21,40,P,4,12020,Regular
4JN18CS126,18CS35,20,14,34,F,0,12020,Regular
4JN18CS126,18CS36,25,21,46,P,6,Jan-20,
4JN18CS126,18CSL37,36,36,72,P,8,12020,Regular
4JN18CS126,18CSL38,28,27,55,P,6,12020,Regular
4JN18CS126,18KAK39,77,0,77,P,8,12020,Regular
4JN18CS128,18MAT31,38,53,91,P,10,12020,Regular
4JN18CS128,18CS32,40,44,84,P,9,12020,Regular
4JN18CS128,18CS33,40,37,77,P,8,12020,Regular
4JN18CS128,18CS34,37,27,64,P,7,12020,Regular
4JN18CS128,18CS35,40,31,71,P,8,12020,Regular
4JN18CS128,18CS36,40,48,88,P,9,12020,Regular
4JN18CS128,18CSL37,40,60,100,P,10,12020,Regular
4JN18CS128,18CSL38,40,59,99,P,10,12020,Regular
4JN18CS128,18KAK39,96,0,96,P,10,12020,Regular
4JN18CS132,18MAT31,38,54,92,P,10,12020,Regular
4JN18CS132,18CS32,36,41,77,P,8,12020,Regular
4JN18CS132,18CS33,38,35,73,P,8,12020,Regular
4JN18CS132,18CS34,35,25,60,P,7,12020,Regular
4JN18CS132,18CS35,39,39,78,P,8,12020,Regular
4JN18CS132,18CS36,39,41,80,P,9,12020,Regular
4JN18CS132,18CSL37,40,56,96,P,10,12020,Regular
4JN18CS132,18CSL38,32,34,66,P,7,12020,Regular
4JN18CS132,18KAK39,90,0,90,P,10,12020,Regular
4JN19CS402,18MATDIP31,25,14,39,F,0,12020,Regular
4JN19CS402,18MAT31,28,26,54,P,6,12020,Regular
4JN19CS402,18CS32,38,36,74,P,8,12020,Regular
4JN19CS402,18CS33,36,21,57,P,6,12020,Regular
4JN19CS402,18CS34,30,27,57,P,6,12020,Regular
4JN19CS402,18CS35,32,21,53,P,6,12020,Regular
4JN19CS402,18CS36,30,24,54,P,6,12020,Regular
4JN19CS402,18CSL37,38,36,74,P,8,12020,Regular
4JN19CS402,18CSL38,30,29,59,P,6,12020,Regular
4JN19CS402,18KAK39,88,0,88,P,9,12020,Regular
4JN19CS403,18MATDIP31,22,21,43,P,4,12020,Regular
4JN19CS403,18MAT31,23,21,44,P,4,12020,Regular
4JN19CS403,18CS32,28,24,52,P,6,12020,Regular
4JN19CS403,18CS33,30,24,54,P,6,12020,Regular
4JN19CS403,18CS34,28,24,52,P,6,12020,Regular
4JN19CS403,18CS35,31,22,53,P,6,12020,Regular
4JN19CS403,18CS36,31,21,52,P,6,12020,Regular
4JN19CS403,18CSL37,38,50,88,P,9,12020,Regular
4JN19CS403,18CSL38,38,8,46,F,0,12020,Regular
4JN19CS403,18KAK39,91,0,91,P,10,12020,Regular
4JN19CS405,18MATDIP31,20,8,28,F,0,12020,Regular
4JN19CS405,18MAT31,19,8,27,F,0,12020,Regular
4JN19CS405,18CS32,22,15,37,F,0,Jan-20,
4JN19CS405,18CS33,30,10,40,F,0,12020,Regular
4JN19CS405,18CS34,24,16,40,F,0,Jan-20,
4JN19CS405,18CS35,28,16,44,F,0,Jan-20,
4JN19CS405,18CS36,28,14,42,F,0,Jan-20,
4JN19CS405,18CSL37,38,36,74,P,8,12020,Regular
4JN19CS405,18CSL38,33,11,44,F,0,12020,Regular
4JN19CS405,18KAK39,81,0,81,P,9,12020,Regular
4JN19CS406,18MATDIP31,25,30,55,P,6,12020,Regular
4JN19CS406,18MAT31,27,22,49,P,6,Jan-20,
4JN19CS406,18CS32,37,44,81,P,9,12020,Regular
4JN19CS406,18CS33,34,18,52,F,0,Jan-20,
4JN19CS406,18CS34,30,35,65,P,7,12020,Regular
4JN19CS406,18CS35,37,26,63,P,7,12020,Regular
4JN19CS406,18CS36,32,15,47,F,0,Jan-20,
4JN19CS406,18CSL37,40,50,90,P,10,12020,Regular
4JN19CS406,18CSL38,30,24,54,P,6,12020,Regular
4JN19CS406,18KVK39,95,0,95,P,10,12020,Regular
4JN19CS408,18MATDIP31,21,14,35,F,0,Jan-20,
4JN19CS408,18MAT31,20,21,41,P,4,12020,Regular
4JN19CS408,18CS32,33,30,63,P,7,12020,Regular
4JN19CS408,18CS33,33,21,54,P,6,12020,Regular
4JN19CS408,18CS34,26,26,52,P,6,12020,Regular
4JN19CS408,18CS35,28,21,49,P,6,12020,Regular
4JN19CS408,18CS36,29,13,42,F,0,12020,Regular
4JN19CS408,18CSL37,38,47,85,P,9,12020,Regular
4JN19CS408,18CSL38,30,24,54,P,6,12020,Regular
4JN19CS408,18KAK39,90,0,90,P,10,12020,Regular
4JN19CS412,18MATDIP31,21,6,27,F,0,Jan-20,
4JN19CS412,18MAT31,20,17,37,F,0,Jan-20,
4JN19CS412,18CS32,33,21,54,P,6,12020,Regular
4JN19CS412,18CS33,29,22,51,P,6,12020,Regular
4JN19CS412,18CS34,25,21,46,P,6,12020,Regular
4JN19CS412,18CS35,31,28,59,P,6,12020,Regular
4JN19CS412,18CS36,30,11,41,F,0,Jan-20,
4JN19CS412,18CSL37,40,30,70,P,8,12020,Regular
4JN19CS412,18CSL38,30,15,45,F,0,12020,Regular
4JN19CS412,18KAK39,84,0,84,P,9,12020,Regular
4JN16CS002,17CS51,32,41,73,P,8,12020,Regular
4JN16CS002,17CS52,35,33,68,P,7,12020,Regular
4JN16CS002,17CS553,30,48,78,P,8,12020,Regular
4JN16CS002,17CS53,33,32,65,P,7,12020,Regular
4JN16CS002,17CS564,36,28,64,P,7,12020,Regular
4JN16CS002,17CS54,27,21,48,P,6,Jan-20,
4JN16CS002,17CSL57,35,31,66,P,7,12020,Regular
4JN16CS002,17CSL58,34,42,76,P,8,12020,Regular
4JN16CS076,17CS51,34,38,72,P,8,12020,Regular
4JN16CS076,17CS562,21,15,36,F,0,Jan-20,
4JN16CS076,17CS552,24,9,33,F,0,12020,Regular
4JN16CS076,17CS52,28,24,52,P,6,Jan-20,
4JN16CS076,17CS53,23,21,44,P,4,12020,Regular
4JN16CS076,17CS54,22,0,22,A,0,12020,Regular
4JN16CS076,17CSL57,35,24,59,P,6,12020,Regular
4JN16CS076,17CSL58,36,42,78,P,8,12020,Regular
4JN16CS076,17CS45,26,27,53,P,6,12020,Backlog
4JN16CS076,17CS46,20,21,41,P,4,12020,Backlog
4JN17CS007,17CS51,33,30,63,P,7,12020,Regular
4JN17CS007,17CS52,22,21,43,P,4,Jan-20,
4JN17CS007,17CS553,29,36,65,P,7,12020,Regular
4JN17CS007,17CS53,34,24,58,P,6,12020,Regular
4JN17CS007,17CS564,31,22,53,P,6,12020,Regular
4JN17CS007,17CS54,26,14,40,F,0,Jan-20,
4JN17CS007,17CSL57,33,27,60,P,7,12020,Regular
4JN17CS007,17CSL58,40,48,88,P,9,12020,Regular
4JN17CS008,17CS51,38,42,80,P,9,12020,Regular
4JN17CS008,17CS562,39,44,83,P,9,12020,Regular
4JN17CS008,17CS52,39,41,80,P,9,12020,Regular
4JN17CS008,17CS553,39,47,86,P,9,12020,Regular
4JN17CS008,17CS53,40,30,70,P,8,12020,Regular
4JN17CS008,17CS54,40,32,72,P,8,12020,Regular
4JN17CS008,17CSL57,38,51,89,P,9,12020,Regular
4JN17CS008,17CSL58,40,59,99,P,10,12020,Regular
4JN17CS009,17CS51,38,43,81,P,9,12020,Regular
4JN17CS009,17CS562,40,29,69,P,7,12020,Regular
4JN17CS009,17CS52,39,40,79,P,8,12020,Regular
4JN17CS009,17CS553,40,40,80,P,9,12020,Regular
4JN17CS009,17CS53,40,38,78,P,8,12020,Regular
4JN17CS009,17CS54,39,46,85,P,9,12020,Regular
4JN17CS009,17CSL57,40,56,96,P,10,12020,Regular
4JN17CS009,17CSL58,40,59,99,P,10,12020,Regular
4JN17CS011,17CS51,34,36,70,P,8,12020,Regular
4JN17CS011,17CS562,34,29,63,P,7,12020,Regular
4JN17CS011,17CS52,32,35,67,P,7,Jan-20,
4JN17CS011,17CS553,30,42,72,P,8,12020,Regular
4JN17CS011,17CS53,33,30,63,P,7,12020,Regular
4JN17CS011,17CS54,32,21,53,P,6,12020,Regular
4JN17CS011,17CSL57,34,51,85,P,9,12020,Regular
4JN17CS011,17CSL58,37,45,82,P,9,12020,Regular
4JN17CS015,17CS51,36,41,77,P,8,12020,Regular
4JN17CS015,17CS52,34,35,69,P,7,12020,Regular
4JN17CS015,17CS553,29,33,62,P,7,12020,Regular
4JN17CS015,17CS53,37,27,64,P,7,12020,Regular
4JN17CS015,17CS564,19,30,49,P,6,12020,Regular
4JN17CS015,17CS54,30,30,60,P,7,12020,Regular
4JN17CS015,17CSL57,36,34,70,P,8,12020,Regular
4JN17CS015,17CSL58,40,45,85,P,9,12020,Regular
4JN17CS020,17CS51,39,44,83,P,9,12020,Regular
4JN17CS020,17CS52,34,35,69,P,7,12020,Regular
4JN17CS020,17CS553,29,32,61,P,7,12020,Regular
4JN17CS020,17CS53,38,22,60,P,7,12020,Regular
4JN17CS020,17CS564,19,21,40,P,4,12020,Regular
4JN17CS020,17CS54,23,21,44,P,4,12020,Regular
4JN17CS020,17CSL57,36,33,69,P,7,12020,Regular
4JN17CS020,17CSL58,38,57,95,P,10,12020,Regular
4JN17CS021,17CS51,34,36,70,P,8,12020,Regular
4JN17CS021,17CS562,38,29,67,P,7,12020,Regular
4JN17CS021,17CS52,33,21,54,P,6,12020,Regular
4JN17CS021,17CS553,31,41,72,P,8,12020,Regular
4JN17CS021,17CS53,30,22,52,P,6,12020,Regular
4JN17CS021,17CS54,31,21,52,P,6,12020,Regular
4JN17CS021,17CSL57,35,29,64,P,7,12020,Regular
4JN17CS021,17CSL58,38,57,95,P,10,12020,Regular
4JN17CS021,17MAT11,19,21,40,P,4,12020,Backlog
4JN17CS022,17CS51,31,25,56,P,6,12020,Regular
4JN17CS022,17CS52,38,24,62,P,7,12020,Regular
4JN17CS022,17CS553,31,23,54,P,6,12020,Regular
4JN17CS022,17CS53,32,23,55,P,6,12020,Regular
4JN17CS022,17CS564,35,28,63,P,7,12020,Regular
4JN17CS022,17CS54,31,15,46,F,0,Jan-20,
4JN17CS022,17CSL57,38,42,80,P,9,12020,Regular
4JN17CS022,17CSL58,40,57,97,P,10,12020,Regular
4JN17CS027,17CS51,39,42,81,P,9,12020,Regular
4JN17CS027,17CS562,40,32,72,P,8,12020,Regular
4JN17CS027,17CS52,38,41,79,P,8,12020,Regular
4JN17CS027,17CS553,40,44,84,P,9,12020,Regular
4JN17CS027,17CS53,39,34,73,P,8,12020,Regular
4JN17CS027,17CS54,38,42,80,P,9,12020,Regular
4JN17CS027,17CSL57,39,57,96,P,10,12020,Regular
4JN17CS027,17CSL58,40,59,99,P,10,12020,Regular
4JN17CS028,17CS51,35,37,72,P,8,12020,Regular
4JN17CS028,17CS52,40,38,78,P,8,12020,Regular
4JN17CS028,17CS553,40,42,82,P,9,12020,Regular
4JN17CS028,17CS53,40,33,73,P,8,12020,Regular
4JN17CS028,17CS564,40,46,86,P,9,12020,Regular
4JN17CS028,17CS54,40,38,78,P,8,12020,Regular
4JN17CS028,17CSL57,40,60,100,P,10,12020,Regular
4JN17CS028,17CSL58,40,59,99,P,10,12020,Regular
4JN17CS029,17CS51,21,36,57,P,6,12020,Regular
4JN17CS029,17CS552,22,21,43,P,4,12020,Regular
4JN17CS029,17CS52,20,21,41,P,4,12020,Regular
4JN17CS029,17CS53,23,23,46,P,6,12020,Regular
4JN17CS029,17CS564,21,21,42,P,4,12020,Regular
4JN17CS029,17CS54,21,21,42,P,4,12020,Regular
4JN17CS029,17CSL57,32,35,67,P,7,12020,Regular
4JN17CS029,17CSL58,35,51,86,P,9,12020,Regular
4JN17CS029,17CS46,15,25,40,P,4,12020,Backlog
4JN17CS029,17CS33,21,0,21,A,0,12020,Backlog
4JN17CS029,17CS36,20,21,41,P,4,12020,Backlog
4JN17CS033,17CS51,35,35,70,P,8,12020,Regular
4JN17CS033,17CS52,34,37,71,P,8,12020,Regular
4JN17CS033,17CS553,34,39,73,P,8,12020,Regular
4JN17CS033,17CS53,33,25,58,P,6,12020,Regular
4JN17CS033,17CS564,26,25,51,P,6,12020,Regular
4JN17CS033,17CS54,30,25,55,P,6,12020,Regular
4JN17CS033,17CSL57,34,38,72,P,8,12020,Regular
4JN17CS033,17CSL58,40,57,97,P,10,12020,Regular
4JN17CS034,17CS51,30,36,66,P,7,12020,Regular
4JN17CS034,17CS52,24,32,56,P,6,12020,Regular
4JN17CS034,17CS553,26,30,56,P,6,12020,Regular
4JN17CS034,17CS53,33,24,57,P,6,12020,Regular
4JN17CS034,17CS564,19,32,51,P,6,12020,Regular
4JN17CS034,17CS54,22,21,43,P,4,12020,Regular
4JN17CS034,17CSL57,32,14,46,F,0,12020,Regular
4JN17CS034,17CSL58,34,54,88,P,9,12020,Regular
4JN17CS034,17CSL48,30,45,75,P,8,12020,Backlog
4JN17CS034,17CPH49,13,12,25,P,0,12020,Backlog
4JN17CS036,17CS51,31,36,67,P,7,12020,Regular
4JN17CS036,17CS52,34,33,67,P,7,12020,Regular
4JN17CS036,17CS553,30,37,67,P,7,12020,Regular
4JN17CS036,17CS53,37,28,65,P,7,12020,Regular
4JN17CS036,17CS54,33,27,60,P,7,12020,Regular
4JN17CS036,17CS564,35,35,70,P,8,12020,Regular
4JN17CS036,17CSL57,36,39,75,P,8,12020,Regular
4JN17CS036,17CSL58,38,38,76,P,8,12020,Regular
4JN17CS040,17CS51,37,27,64,P,7,12020,Regular
4JN17CS040,17CS52,30,29,59,P,6,12020,Regular
4JN17CS040,17CS553,22,30,52,P,6,12020,Regular
4JN17CS040,17CS53,37,24,61,P,7,12020,Regular
4JN17CS040,17CS54,29,39,68,P,7,12020,Regular
4JN17CS040,17CS564,22,27,49,P,6,12020,Regular
4JN17CS040,17CSL57,32,27,59,P,6,12020,Regular
4JN17CS040,17CSL58,39,38,77,P,8,12020,Regular
4JN17CS040,17MAT21,19,21,40,P,4,12020,Backlog
4JN17CS042,17CS51,31,37,68,P,7,12020,Regular
4JN17CS042,17CS52,37,42,79,P,8,12020,Regular
4JN17CS042,17CS553,38,42,80,P,9,12020,Regular
4JN17CS042,17CS53,35,34,69,P,7,12020,Regular
4JN17CS042,17CS564,32,24,56,P,6,12020,Regular
4JN17CS042,17CS54,33,22,55,P,6,12020,Regular
4JN17CS042,17CSL57,37,51,88,P,9,12020,Regular
4JN17CS042,17CSL58,38,54,92,P,10,12020,Regular
4JN17CS043,17CS51,38,42,80,P,9,12020,Regular
4JN17CS043,17CS52,38,45,83,P,9,12020,Regular
4JN17CS043,17CS553,38,45,83,P,9,12020,Regular
4JN17CS043,17CS53,37,38,75,P,8,12020,Regular
4JN17CS043,17CS564,37,38,75,P,8,12020,Regular
4JN17CS043,17CS54,35,31,66,P,7,12020,Regular
4JN17CS043,17CSL57,40,59,99,P,10,12020,Regular
4JN17CS043,17CSL58,40,56,96,P,10,12020,Regular
4JN17CS046,17CS51,36,35,71,P,8,12020,Regular
4JN17CS046,17CS562,27,24,51,P,6,12020,Regular
4JN17CS046,17CS52,27,21,48,P,6,Jan-20,
4JN17CS046,17CS553,20,30,50,P,6,12020,Regular
4JN17CS046,17CS53,25,38,63,P,7,12020,Regular
4JN17CS046,17CS54,20,8,28,F,0,12020,Regular
4JN17CS046,17CSL57,33,26,59,P,6,12020,Regular
4JN17CS046,17CSL58,36,47,83,P,9,12020,Regular
4JN17CS046,17CS44,21,8,29,F,0,12020,Backlog
4JN17CS046,17CS46,21,7,28,F,0,12020,Backlog
4JN17CS046,17CSL48,40,45,85,P,9,12020,Backlog
4JN17CS049,17CS51,22,21,43,P,4,12020,Regular
4JN17CS049,17CS562,24,17,41,F,0,Jan-20,
4JN17CS049,17CS52,29,21,50,P,6,12020,Regular
4JN17CS049,17CS553,23,21,44,P,4,12020,Regular
4JN17CS049,17CS53,31,22,53,P,6,12020,Regular
4JN17CS049,17CS54,29,16,45,F,0,Jan-20,
4JN17CS049,17CSL57,32,24,56,P,6,12020,Regular
4JN17CS049,17CSL58,36,36,72,P,8,12020,Regular
4JN17CS049,17CSL48,30,27,57,P,6,12020,Backlog
4JN17CS051,17CS51,39,39,78,P,8,12020,Regular
4JN17CS051,17CS562,40,33,73,P,8,12020,Regular
4JN17CS051,17CS52,39,32,71,P,8,12020,Regular
4JN17CS051,17CS553,36,34,70,P,8,12020,Regular
4JN17CS051,17CS53,38,31,69,P,7,12020,Regular
4JN17CS051,17CS54,32,24,56,P,6,12020,Regular
4JN17CS051,17CSL57,35,24,59,P,6,12020,Regular
4JN17CS051,17CSL58,39,42,81,P,9,12020,Regular
4JN17CS052,17CS51,37,41,78,P,8,12020,Regular
4JN17CS052,17CS52,33,28,61,P,7,12020,Regular
4JN17CS052,17CS553,29,34,63,P,7,12020,Regular
4JN17CS052,17CS53,37,32,69,P,7,12020,Regular
4JN17CS052,17CS564,25,30,55,P,6,12020,Regular
4JN17CS052,17CS54,32,21,53,P,6,12020,Regular
4JN17CS052,17CSL57,34,25,59,P,6,12020,Regular
4JN17CS052,17CSL58,39,38,77,P,8,12020,Regular
4JN17CS053,17CS51,30,26,56,P,6,12020,Regular
4JN17CS053,17CS562,27,27,54,P,6,12020,Regular
4JN17CS053,17CS52,23,24,47,P,6,12020,Regular
4JN17CS053,17CS553,21,29,50,P,6,12020,Regular
4JN17CS053,17CS53,31,30,61,P,7,12020,Regular
4JN17CS053,17CS54,27,6,33,F,0,12020,Regular
4JN17CS053,17CSL57,34,25,59,P,6,12020,Regular
4JN17CS053,17CSL58,38,40,78,P,8,12020,Regular
4JN17CS053,17CS33,20,3,23,F,0,12020,Backlog
4JN17CS053,17CS35,21,21,42,P,4,12020,Backlog
4JN17CS055,17CS51,36,30,66,P,7,12020,Regular
4JN17CS055,17CS52,31,35,66,P,7,12020,Regular
4JN17CS055,17CS553,28,32,60,P,7,12020,Regular
4JN17CS055,17CS53,37,21,58,P,6,12020,Regular
4JN17CS055,17CS54,26,25,51,P,6,12020,Regular
4JN17CS055,17CS564,30,31,61,P,7,12020,Regular
4JN17CS055,17CSL57,35,45,80,P,9,12020,Regular
4JN17CS055,17CSL58,40,48,88,P,9,12020,Regular
4JN17CS056,17CS51,40,38,78,P,8,12020,Regular
4JN17CS056,17CS562,39,43,82,P,9,12020,Regular
4JN17CS056,17CS52,40,42,82,P,9,12020,Regular
4JN17CS056,17CS553,40,39,79,P,8,12020,Regular
4JN17CS056,17CS53,39,39,78,P,8,12020,Regular
4JN17CS056,17CS54,38,38,76,P,8,12020,Regular
4JN17CS056,17CSL57,40,58,98,P,10,12020,Regular
4JN17CS056,17CSL58,39,59,98,P,10,12020,Regular
4JN17CS059,17CS51,30,32,62,P,7,12020,Regular
4JN17CS059,17CS52,31,21,52,P,6,12020,Regular
4JN17CS059,17CS553,40,33,73,P,8,12020,Regular
4JN17CS059,17CS53,38,26,64,P,7,12020,Regular
4JN17CS059,17CS564,39,31,70,P,8,12020,Regular
4JN17CS059,17CS54,37,23,60,P,7,12020,Regular
4JN17CS059,17CSL57,34,38,72,P,8,12020,Regular
4JN17CS059,17CSL58,40,60,100,P,10,12020,Regular
4JN17CS060,17CS51,33,30,63,P,7,12020,Regular
4JN17CS060,17CS562,32,21,53,P,6,Jan-20,
4JN17CS060,17CS52,27,32,59,P,6,12020,Regular
4JN17CS060,17CS553,26,26,52,P,6,12020,Regular
4JN17CS060,17CS53,30,22,52,P,6,12020,Regular
4JN17CS060,17CS54,37,14,51,F,0,Jan-20,
4JN17CS060,17CSL57,32,14,46,F,0,12020,Regular
4JN17CS060,17CSL58,38,57,95,P,10,12020,Regular
4JN17CS060,17CS44,31,21,52,P,6,12020,Backlog
4JN17CS060,17CSL47,38,48,86,P,9,12020,Backlog
4JN17CS061,17CS51,35,39,74,P,8,12020,Regular
4JN17CS061,17CS562,35,42,77,P,8,12020,Regular
4JN17CS061,17CS52,32,26,58,P,6,12020,Regular
4JN17CS061,17CS553,29,36,65,P,7,12020,Regular
4JN17CS061,17CS53,36,27,63,P,7,12020,Regular
4JN17CS061,17CS54,34,28,62,P,7,12020,Regular
4JN17CS061,17CSL57,32,27,59,P,6,12020,Regular
4JN17CS061,17CSL58,38,53,91,P,10,12020,Regular
4JN17CS062,17CS51,40,36,76,P,8,12020,Regular
4JN17CS062,17CS562,39,30,69,P,7,12020,Regular
4JN17CS062,17CS52,40,41,81,P,9,12020,Regular
4JN17CS062,17CS553,40,44,84,P,9,12020,Regular
4JN17CS062,17CS53,38,37,75,P,8,12020,Regular
4JN17CS062,17CS54,39,36,75,P,8,12020,Regular
4JN17CS062,17CSL57,40,59,99,P,10,12020,Regular
4JN17CS062,17CSL58,40,59,99,P,10,12020,Regular
4JN17CS067,17CS51,26,30,56,P,6,12020,Regular
4JN17CS067,17CS52,26,33,59,P,6,12020,Regular
4JN17CS067,17CS553,30,30,60,P,7,12020,Regular
4JN17CS067,17CS53,27,29,56,P,6,12020,Regular
4JN17CS067,17CS564,37,31,68,P,7,12020,Regular
4JN17CS067,17CS54,28,21,49,P,6,12020,Regular
4JN17CS067,17CSL57,37,51,88,P,9,12020,Regular
4JN17CS067,17CSL58,40,57,97,P,10,12020,Regular
4JN17CS069,17CS51,40,35,75,P,8,12020,Regular
4JN17CS069,17CS562,40,30,70,P,8,12020,Regular
4JN17CS069,17CS52,39,53,92,P,10,12020,Regular
4JN17CS069,17CS553,40,46,86,P,9,12020,Regular
4JN17CS069,17CS53,40,42,82,P,9,12020,Regular
4JN17CS069,17CS54,40,39,79,P,8,12020,Regular
4JN17CS069,17CSL57,40,58,98,P,10,12020,Regular
4JN17CS069,17CSL58,40,59,99,P,10,12020,Regular
4JN17CS070,17CS51,39,47,86,P,9,12020,Regular
4JN17CS070,17CS562,40,44,84,P,9,12020,Regular
4JN17CS070,17CS52,39,35,74,P,8,12020,Regular
4JN17CS070,17CS553,38,44,82,P,9,12020,Regular
4JN17CS070,17CS53,38,41,79,P,8,12020,Regular
4JN17CS070,17CS54,40,37,77,P,8,12020,Regular
4JN17CS070,17CSL57,36,35,71,P,8,12020,Regular
4JN17CS070,17CSL58,40,58,98,P,10,12020,Regular
4JN17CS077,17CS51,36,43,79,P,8,12020,Regular
4JN17CS077,17CS562,40,40,80,P,9,12020,Regular
4JN17CS077,17CS52,38,36,74,P,8,12020,Regular
4JN17CS077,17CS553,32,35,67,P,7,12020,Regular
4JN17CS077,17CS53,39,38,77,P,8,12020,Regular
4JN17CS077,17CS54,36,30,66,P,7,12020,Regular
4JN17CS077,17CSL57,37,38,75,P,8,12020,Regular
4JN17CS077,17CSL58,40,57,97,P,10,12020,Regular
4JN17CS078,17CS51,36,38,74,P,8,12020,Regular
4JN17CS078,17CS562,37,26,63,P,7,12020,Regular
4JN17CS078,17CS52,38,34,72,P,8,12020,Regular
4JN17CS078,17CS553,34,45,79,P,8,12020,Regular
4JN17CS078,17CS53,38,34,72,P,8,12020,Regular
4JN17CS078,17CS54,39,21,60,P,7,12020,Regular
4JN17CS078,17CSL57,35,43,78,P,8,12020,Regular
4JN17CS078,17CSL58,40,52,92,P,10,12020,Regular
4JN17CS079,17CS51,34,38,72,P,8,12020,Regular
4JN17CS079,17CS52,23,27,50,P,6,12020,Regular
4JN17CS079,17CS553,29,27,56,P,6,12020,Regular
4JN17CS079,17CS53,33,21,54,P,6,12020,Regular
4JN17CS079,17CS54,31,17,48,F,0,Jan-20,
4JN17CS079,17CS564,27,33,60,P,7,12020,Regular
4JN17CS079,17CSL57,33,15,48,F,0,12020,Regular
4JN17CS079,17CSL58,38,48,86,P,9,12020,Regular
4JN17CS080,17CS51,40,49,89,P,9,12020,Regular
4JN17CS080,17CS52,36,36,72,P,8,12020,Regular
4JN17CS080,17CS553,28,23,51,P,6,12020,Regular
4JN17CS080,17CS53,39,44,83,P,9,12020,Regular
4JN17CS080,17CS54,34,34,68,P,7,12020,Regular
4JN17CS080,17CS564,28,38,66,P,7,12020,Regular
4JN17CS080,17CSL57,34,26,60,P,7,12020,Regular
4JN17CS080,17CSL58,38,50,88,P,9,12020,Regular
4JN17CS083,17CS51,36,42,78,P,8,12020,Regular
4JN17CS083,17CS562,40,40,80,P,9,12020,Regular
4JN17CS083,17CS52,39,33,72,P,8,12020,Regular
4JN17CS083,17CS553,37,45,82,P,9,12020,Regular
4JN17CS083,17CS53,40,39,79,P,8,12020,Regular
4JN17CS083,17CS54,38,32,70,P,8,12020,Regular
4JN17CS083,17CSL57,40,58,98,P,10,12020,Regular
4JN17CS083,17CSL58,40,59,99,P,10,12020,Regular
4JN17CS087,17CS51,40,42,82,P,9,12020,Regular
4JN17CS087,17CS562,40,45,85,P,9,12020,Regular
4JN17CS087,17CS52,40,41,81,P,9,12020,Regular
4JN17CS087,17CS553,40,50,90,P,10,12020,Regular
4JN17CS087,17CS53,38,38,76,P,8,12020,Regular
4JN17CS087,17CS54,40,35,75,P,8,12020,Regular
4JN17CS087,17CSL57,40,60,100,P,10,12020,Regular
4JN17CS087,17CSL58,40,59,99,P,10,12020,Regular
4JN17CS088,17CS51,25,34,59,P,6,12020,Regular
4JN17CS088,17CS52,25,27,52,P,6,12020,Regular
4JN17CS088,17CS553,26,23,49,P,6,12020,Regular
4JN17CS088,17CS53,30,15,45,F,0,Jan-20,
4JN17CS088,17CS564,20,24,44,P,4,12020,Regular
4JN17CS088,17CS54,32,14,46,F,0,Jan-20,
4JN17CS088,17CSL57,33,33,66,P,7,12020,Regular
4JN17CS088,17CSL58,38,53,91,P,10,12020,Regular
4JN17CS088,17CS44,21,23,44,P,4,12020,Backlog
4JN17CS088,17CS45,24,26,50,P,6,12020,Backlog
4JN17CS088,17CS46,19,8,27,F,0,12020,Backlog
4JN17CS090,17CS51,24,38,62,P,7,12020,Regular
4JN17CS090,17CS552,23,29,52,P,6,12020,Regular
4JN17CS090,17CS52,20,21,41,P,4,12020,Regular
4JN17CS090,17CS53,24,33,57,P,6,12020,Regular
4JN17CS090,17CS564,19,22,41,P,4,12020,Regular
4JN17CS090,17CS54,22,28,50,P,6,12020,Regular
4JN17CS090,17CSL57,33,27,60,P,7,12020,Regular
4JN17CS090,17CSL58,35,53,88,P,9,12020,Regular
4JN17CS091,17CS51,25,34,59,P,6,12020,Regular
4JN17CS091,17CS552,21,21,42,P,4,12020,Regular
4JN17CS091,17CS52,26,23,49,P,6,12020,Regular
4JN17CS091,17CS53,26,29,55,P,6,12020,Regular
4JN17CS091,17CS564,21,32,53,P,6,12020,Regular
4JN17CS091,17CS54,20,32,52,P,6,12020,Regular
4JN17CS091,17CSL57,34,27,61,P,7,12020,Regular
4JN17CS091,17CSL58,35,45,80,P,9,12020,Regular
4JN17CS091,17CS44,20,24,44,P,4,12020,Backlog
4JN17CS091,17CPH49,13,0,13,A,0,12020,Backlog
4JN17CS092,17CS51,37,36,73,P,8,12020,Regular
4JN17CS092,17CS562,34,38,72,P,8,12020,Regular
4JN17CS092,17CS52,37,36,73,P,8,12020,Regular
4JN17CS092,17CS553,34,38,72,P,8,12020,Regular
4JN17CS092,17CS53,39,32,71,P,8,12020,Regular
4JN17CS092,17CS54,40,31,71,P,8,12020,Regular
4JN17CS092,17CSL57,39,56,95,P,10,12020,Regular
4JN17CS092,17CSL58,39,58,97,P,10,12020,Regular
4JN17CS097,17CS51,31,32,63,P,7,12020,Regular
4JN17CS097,17CS562,40,21,61,P,7,12020,Regular
4JN17CS097,17CS52,35,24,59,P,6,12020,Regular
4JN17CS097,17CS553,21,22,43,P,4,Jan-20,
4JN17CS097,17CS53,35,21,56,P,6,Jan-20,
4JN17CS097,17CS54,30,35,65,P,7,12020,Regular
4JN17CS097,17CSL57,30,9,39,F,0,12020,Regular
4JN17CS097,17CSL58,38,42,80,P,9,12020,Regular
4JN17CS097,17CS44,28,28,56,P,6,12020,Backlog
4JN17CS097,17CSL47,38,24,62,P,7,12020,Backlog
4JN17CS098,17CS51,38,42,80,P,9,12020,Regular
4JN17CS098,17CS52,39,35,74,P,8,12020,Regular
4JN17CS098,17CS562,40,44,84,P,9,12020,Regular
4JN17CS098,17CS553,34,42,76,P,8,12020,Regular
4JN17CS098,17CS53,39,26,65,P,7,12020,Regular
4JN17CS098,17CS54,36,36,72,P,8,12020,Regular
4JN17CS098,17CSL57,35,38,73,P,8,12020,Regular
4JN17CS098,17CSL58,39,59,98,P,10,12020,Regular
4JN17CS103,17CS51,30,32,62,P,7,12020,Regular
4JN17CS103,17CS562,40,31,71,P,8,12020,Regular
4JN17CS103,17CS52,32,18,50,F,0,Jan-20,
4JN17CS103,17CS553,28,32,60,P,7,12020,Regular
4JN17CS103,17CS53,38,33,71,P,8,12020,Regular
4JN17CS103,17CS54,33,15,48,F,0,Jan-20,
4JN17CS103,17CSL57,32,15,47,F,0,12020,Regular
4JN17CS103,17CSL58,40,45,85,P,9,12020,Regular
4JN17CS103,17MAT41,20,14,34,F,0,Jan-20,
4JN17CS108,17CS51,39,39,78,P,8,12020,Regular
4JN17CS108,17CS52,40,45,85,P,9,12020,Regular
4JN17CS108,17CS562,40,41,81,P,9,12020,Regular
4JN17CS108,17CS553,38,44,82,P,9,12020,Regular
4JN17CS108,17CS53,38,42,80,P,9,12020,Regular
4JN17CS108,17CS54,39,36,75,P,8,12020,Regular
4JN17CS108,17CSL57,40,57,97,P,10,12020,Regular
4JN17CS108,17CSL58,40,57,97,P,10,12020,Regular
4JN17CS109,17CS51,34,35,69,P,7,12020,Regular
4JN17CS109,17CS52,27,38,65,P,7,12020,Regular
4JN17CS109,17CS562,34,41,75,P,8,12020,Regular
4JN17CS109,17CS553,32,38,70,P,8,12020,Regular
4JN17CS109,17CS53,39,40,79,P,8,12020,Regular
4JN17CS109,17CS54,30,21,51,P,6,12020,Regular
4JN17CS109,17CSL57,32,24,56,P,6,12020,Regular
4JN17CS109,17CSL58,40,48,88,P,9,12020,Regular
4JN17CS109,17CS43,36,39,75,P,8,12020,Backlog
4JN17CS109,17CPH49,15,0,15,A,0,12020,Backlog
4JN17CS110,17CS51,36,39,75,P,8,12020,Regular
4JN17CS110,17CS562,36,25,61,P,7,12020,Regular
4JN17CS110,17CS52,34,36,70,P,8,12020,Regular
4JN17CS110,17CS553,26,25,51,P,6,12020,Regular
4JN17CS110,17CS53,36,29,65,P,7,12020,Regular
4JN17CS110,17CS54,31,24,55,P,6,12020,Regular
4JN17CS110,17CSL57,36,57,93,P,10,12020,Regular
4JN17CS110,17CSL58,40,51,91,P,10,12020,Regular
4JN17CS114,17CS51,34,33,67,P,7,12020,Regular
4JN17CS114,17CS52,30,32,62,P,7,12020,Regular
4JN17CS114,17CS553,27,21,48,P,6,Jan-20,
4JN17CS114,17CS53,28,21,49,P,6,12020,Regular
4JN17CS114,17CS564,27,33,60,P,7,12020,Regular
4JN17CS114,17CS54,27,23,50,P,6,12020,Regular
4JN17CS114,17CSL57,33,25,58,P,6,12020,Regular
4JN17CS114,17CSL58,34,0,34,F,0,12020,Regular
4JN17CS115,17CS51,33,38,71,P,8,12020,Regular
4JN17CS115,17CS52,36,40,76,P,8,12020,Regular
4JN17CS115,17CS553,33,54,87,P,9,12020,Regular
4JN17CS115,17CS53,40,27,67,P,7,12020,Regular
4JN17CS115,17CS54,37,39,76,P,8,12020,Regular
4JN17CS115,17CS564,39,26,65,P,7,12020,Regular
4JN17CS115,17CSL57,40,57,97,P,10,12020,Regular
4JN17CS115,17CSL58,39,53,92,P,10,12020,Regular
4JN17CS122,17CS51,36,42,78,P,8,12020,Regular
4JN17CS122,17CS52,32,29,61,P,7,12020,Regular
4JN17CS122,17CS553,33,43,76,P,8,12020,Regular
4JN17CS122,17CS53,33,26,59,P,6,12020,Regular
4JN17CS122,17CS564,34,33,67,P,7,12020,Regular
4JN17CS122,17CS54,34,30,64,P,7,12020,Regular
4JN17CS122,17CSL57,36,29,65,P,7,12020,Regular
4JN17CS122,17CSL58,37,53,90,P,10,12020,Regular
4JN17CS123,17CS51,32,37,69,P,7,12020,Regular
4JN17CS123,17CS52,30,41,71,P,8,12020,Regular
4JN17CS123,17CS553,25,28,53,P,6,12020,Regular
4JN17CS123,17CS53,33,24,57,P,6,12020,Regular
4JN17CS123,17CS564,28,27,55,P,6,12020,Regular
4JN17CS123,17CS54,30,23,53,P,6,12020,Regular
4JN17CS123,17CSL57,34,45,79,P,8,12020,Regular
4JN17CS123,17CSL58,35,47,82,P,9,12020,Regular
4JN17CS124,17CS51,34,27,61,P,7,12020,Regular
4JN17CS124,17CS562,28,24,52,P,6,12020,Regular
4JN17CS124,17CS52,22,30,52,P,6,12020,Regular
4JN17CS124,17CS553,27,26,53,P,6,12020,Regular
4JN17CS124,17CS53,27,27,54,P,6,12020,Regular
4JN17CS124,17CS54,31,23,54,P,6,12020,Regular
4JN17CS124,17CSL57,33,24,57,P,6,12020,Regular
4JN17CS124,17CSL58,37,48,85,P,9,12020,Regular
4JN17CS127,17CS51,28,32,60,P,7,12020,Regular
4JN17CS127,17CS52,28,24,52,P,6,12020,Regular
4JN17CS127,17CS553,27,41,68,P,7,12020,Regular
4JN17CS127,17CS53,33,34,67,P,7,12020,Regular
4JN17CS127,17CS564,23,24,47,P,6,12020,Regular
4JN17CS127,17CS54,28,30,58,P,6,12020,Regular
4JN17CS127,17CSL57,33,26,59,P,6,12020,Regular
4JN17CS127,17CSL58,39,57,96,P,10,12020,Regular
4JN17CS128,17CS51,31,33,64,P,7,12020,Regular
4JN17CS128,17CS52,27,29,56,P,6,12020,Regular
4JN17CS128,17CS553,30,27,57,P,6,12020,Regular
4JN17CS128,17CS53,27,24,51,P,6,12020,Regular
4JN17CS128,17CS564,28,26,54,P,6,12020,Regular
4JN17CS128,17CS54,26,27,53,P,6,12020,Regular
4JN17CS128,17CSL57,33,26,59,P,6,12020,Regular
4JN17CS128,17CSL58,37,45,82,P,9,12020,Regular
4JN17CS129,17CS51,26,31,57,P,6,12020,Regular
4JN17CS129,17CS52,22,30,52,P,6,12020,Regular
4JN17CS129,17CS553,25,30,55,P,6,12020,Regular
4JN17CS129,17CS53,32,21,53,P,6,12020,Regular
4JN17CS129,17CS564,25,38,63,P,7,12020,Regular
4JN17CS129,17CS54,25,30,55,P,6,12020,Regular
4JN17CS129,17CSL57,34,29,63,P,7,12020,Regular
4JN17CS129,17CSL58,37,51,88,P,9,12020,Regular
4JN17CS130,17CS51,27,39,66,P,7,12020,Regular
4JN17CS130,17CS52,27,40,67,P,7,12020,Regular
4JN17CS130,17CS553,21,37,58,P,6,12020,Regular
4JN17CS130,17CS53,31,24,55,P,6,12020,Regular
4JN17CS130,17CS564,24,23,47,P,6,12020,Regular
4JN17CS130,17CS54,25,22,47,P,6,12020,Regular
4JN17CS130,17CSL57,34,32,66,P,7,12020,Regular
4JN17CS130,17CSL58,36,50,86,P,9,12020,Regular
4JN18CS400,17CS51,26,40,66,P,7,12020,Regular
4JN18CS400,17CS52,21,35,56,P,6,12020,Regular
4JN18CS400,17CS553,21,32,53,P,6,12020,Regular
4JN18CS400,17CS53,24,12,36,F,0,12020,Regular
4JN18CS400,17CS564,19,29,48,P,6,12020,Regular
4JN18CS400,17CS54,25,21,46,P,6,12020,Regular
4JN18CS400,17CSL57,32,24,56,P,6,12020,Regular
4JN18CS400,17CSL58,34,50,84,P,9,12020,Regular
4JN18CS400,17MAT41,21,14,35,F,0,12020,Backlog
4JN18CS400,17CPH49,14,8,22,F,0,12020,Backlog
4JN18CS400,17MATDIP31,0,0,0,A,0,12020,Backlog
4JN18CS400,17CS36,20,0,20,A,0,12020,Backlog
4JN18CS400,17CIV28,18,15,33,P,0,12020,Backlog
4JN18CS401,17CS51,28,36,64,P,7,12020,Regular
4JN18CS401,17CS52,31,29,60,P,7,12020,Regular
4JN18CS401,17CS553,25,44,69,P,7,12020,Regular
4JN18CS401,17CS53,33,44,77,P,8,12020,Regular
4JN18CS401,17CS564,19,32,51,P,6,12020,Regular
4JN18CS401,17CS54,24,34,58,P,6,12020,Regular
4JN18CS401,17CSL57,35,35,70,P,8,12020,Regular
4JN18CS401,17CSL58,36,36,72,P,8,12020,Regular
4JN18CS401,17MAT41,20,25,45,P,6,12020,Backlog
4JN18CS401,17CS43,30,24,54,P,6,12020,Backlog
4JN18CS401,17CPH49,12,8,20,F,0,12020,Backlog
4JN18CS401,17MATDIP31,0,0,0,A,0,12020,Backlog
4JN18CS401,17CIV28,19,12,31,P,0,12020,Backlog
4JN18CS404,17CS51,32,32,64,P,7,12020,Regular
4JN18CS404,17CS52,21,29,50,P,6,12020,Regular
4JN18CS404,17CS553,22,39,61,P,7,12020,Regular
4JN18CS404,17CS53,27,22,49,P,6,12020,Regular
4JN18CS404,17CS564,20,22,42,P,4,12020,Regular
4JN18CS404,17CS54,22,21,43,P,4,12020,Regular
4JN18CS404,17CSL57,34,32,66,P,7,12020,Regular
4JN18CS404,17CSL58,37,50,87,P,9,12020,Regular
4JN18CS404,17CPH49,12,12,24,P,0,12020,Backlog
4JN18CS404,17CIV28,18,18,36,P,0,12020,Backlog
4JN18CS409,17CS51,33,42,75,P,8,12020,Regular
4JN18CS409,17CS552,31,27,58,P,6,12020,Regular
4JN18CS409,17CS52,32,44,76,P,8,12020,Regular
4JN18CS409,17CS53,34,26,60,P,7,12020,Regular
4JN18CS409,17CS564,21,31,52,P,6,12020,Regular
4JN18CS409,17CS54,23,21,44,P,4,Jan-20,
4JN18CS409,17CSL57,34,34,68,P,7,12020,Regular
4JN18CS409,17CSL58,36,51,87,P,9,12020,Regular
4JN18CS409,17MATDIP31,0,0,0,A,0,12020,Backlog
4JN18CS409,17CS32,33,28,61,P,7,12020,Backlog
4JN18CS409,17CIV28,18,24,42,P,4,12020,Backlog
4JN18CS411,17CS51,28,41,69,P,7,12020,Regular
4JN18CS411,17CS552,31,30,61,P,7,12020,Regular
4JN18CS411,17CS52,31,32,63,P,7,12020,Regular
4JN18CS411,17CS53,33,30,63,P,7,12020,Regular
4JN18CS411,17CS564,27,21,48,P,6,12020,Regular
4JN18CS411,17CS54,24,25,49,P,6,12020,Regular
4JN18CS411,17CSL57,33,26,59,P,6,12020,Regular
4JN18CS411,17CSL58,36,42,78,P,8,12020,Regular
4JN18CS411,17CS43,31,27,58,P,6,12020,Backlog
4JN18CS411,17CSL47,34,30,64,P,7,12020,Backlog
4JN18CS411,17MAT31,19,6,25,F,0,12020,Backlog
4JN18CS411,17CIV28,17,20,37,P,0,12020,Backlog
4JN18CS412,17CS51,31,26,57,P,6,12020,Regular
4JN18CS412,17CS52,30,35,65,P,7,12020,Regular
4JN18CS412,17CS553,28,31,59,P,6,12020,Regular
4JN18CS412,17CS53,29,36,65,P,7,12020,Regular
4JN18CS412,17CS564,25,41,66,P,7,12020,Regular
4JN18CS412,17CS54,24,21,45,P,6,Jan-20,
4JN18CS412,17CSL57,34,38,72,P,8,12020,Regular
4JN18CS412,17CSL58,40,53,93,P,10,12020,Regular
4JN18CS412,17MATDIP41,0,12,12,F,0,12020,Backlog
4JN18CS412,17CSL47,40,24,64,P,7,12020,Backlog
4JN18CS412,17CIV28,18,18,36,P,0,12020,Backlog
4JN18CS413,17CS51,31,38,69,P,7,12020,Regular
4JN18CS413,17CS552,34,37,71,P,8,12020,Regular
4JN18CS413,17CS52,37,37,74,P,8,12020,Regular
4JN18CS413,17CS53,35,32,67,P,7,12020,Regular
4JN18CS413,17CS54,29,30,59,P,6,12020,Regular
4JN18CS413,17CS564,24,21,45,P,6,12020,Regular
4JN18CS413,17CSL57,34,35,69,P,7,12020,Regular
4JN18CS413,17CSL58,36,51,87,P,9,12020,Regular
4JN18CS413,17MATDIP31,0,0,0,A,0,12020,Backlog
4JN18CS413,17CIV28,19,22,41,P,4,12020,Backlog
4JN18CS416,17CS51,35,42,77,P,8,12020,Regular
4JN18CS416,17CS52,27,32,59,P,6,12020,Regular
4JN18CS416,17CS553,30,39,69,P,7,12020,Regular
4JN18CS416,17CS53,37,29,66,P,7,12020,Regular
4JN18CS416,17CS564,22,34,56,P,6,12020,Regular
4JN18CS416,17CS54,24,30,54,P,6,12020,Regular
4JN18CS416,17CSL57,32,26,58,P,6,12020,Regular
4JN18CS416,17CSL58,40,44,84,P,9,12020,Regular
4JN18CS416,17CIV28,18,16,34,P,0,12020,Backlog
4JN18CS422,17CS51,40,39,79,P,8,12020,Regular
4JN18CS422,17CS552,36,24,60,P,7,12020,Regular
4JN18CS422,17CS52,38,40,78,P,8,12020,Regular
4JN18CS422,17CS53,32,21,53,P,6,12020,Regular
4JN18CS422,17CS564,27,33,60,P,7,12020,Regular
4JN18CS422,17CS54,28,22,50,P,6,12020,Regular
4JN18CS422,17CSL57,36,29,65,P,7,12020,Regular
4JN18CS422,17CSL58,36,44,80,P,9,12020,Regular
4JN18CS422,17MATDIP31,0,0,0,A,0,12020,Backlog
4JN18CS422,17CIV28,17,23,40,P,4,12020,Backlog
4JN18CS423,17CS51,32,41,73,P,8,12020,Regular
4JN18CS423,17CS552,30,28,58,P,6,12020,Regular
4JN18CS423,17CS52,31,36,67,P,7,12020,Regular
4JN18CS423,17CS53,29,23,52,P,6,12020,Regular
4JN18CS423,17CS564,25,29,54,P,6,12020,Regular
4JN18CS423,17CS54,29,21,50,P,6,12020,Regular
4JN18CS423,17CSL57,33,27,60,P,7,12020,Regular
4JN18CS423,17CSL58,36,54,90,P,10,12020,Regular
4JN18CS423,17MATDIP31,0,0,0,A,0,12020,Backlog
4JN18CS423,17CIV28,18,19,37,P,0,12020,Backlog
4JN15CS096,15CS51,15,28,43,P,4,12020,Regular
4JN15CS096,15CS52,13,28,41,P,4,12020,Regular
4JN15CS096,15CS553,13,28,41,P,4,12020,Regular
4JN15CS096,15CS53,12,8,20,F,0,12020,Regular
4JN15CS096,15CS54,13,1,14,F,0,12020,Regular
4JN15CS096,15CS564,13,4,17,F,0,12020,Regular
4JN15CS096,15CSL57,18,35,53,P,6,12020,Regular
4JN15CS096,15CSL58,17,54,71,P,8,12020,Regular
4JN15CS096,15MAT41,6,9,15,F,0,12020,Backlog
4JN15CS096,15CS42,12,28,40,P,4,12020,Backlog
4JN15CS096,15CS46,12,29,41,P,4,12020,Backlog
4JN15CS106,15CS51,19,33,52,P,6,Jan-20,
4JN15CS106,15CS552,14,36,50,P,6,12020,Regular
4JN15CS106,15CS52,12,34,46,P,5,12020,Regular
4JN15CS106,15CS53,12,52,64,P,7,12020,Regular
4JN15CS106,15CS564,14,14,28,F,0,12020,Regular
4JN15CS106,15CS54,13,9,22,F,0,12020,Regular
4JN15CS106,15CSL57,18,32,50,P,6,12020,Regular
4JN15CS106,15CSL58,18,59,77,P,8,12020,Regular
4JN15CS106,15CS33,12,37,49,P,5,12020,Backlog
4JN15CS118,15CS51,15,44,59,P,6,12020,Regular
4JN15CS118,15CS552,12,31,43,P,4,12020,Regular
4JN15CS118,15CS52,14,42,56,P,6,12020,Regular
4JN15CS118,15CS53,14,35,49,P,5,12020,Regular
4JN15CS118,15CS564,14,19,33,F,0,Jan-20,
4JN15CS118,15CS54,14,7,21,F,0,12020,Regular
4JN15CS118,15CSL57,18,15,33,F,0,12020,Regular
4JN15CS118,15CSL58,18,55,73,P,8,12020,Regular
4JN15CS118,15MAT41,19,9,28,F,0,12020,Backlog
4JN15CS118,15CS44,16,0,16,A,0,12020,Backlog
4JN15CS118,15CS46,12,29,41,P,4,12020,Backlog
4JN15CS118,15CS32,15,28,43,P,4,12020,Backlog
4JN16CS133,15CS51,17,37,54,P,6,12020,Regular
4JN16CS133,15CS562,15,28,43,P,4,12020,Regular
4JN16CS133,15CS52,12,28,40,P,4,12020,Regular
4JN16CS133,15CS553,13,31,44,P,4,12020,Regular
4JN16CS133,15CS53,15,28,43,P,4,12020,Regular
4JN16CS133,15CS54,12,28,40,P,4,12020,Regular
4JN16CS133,15CSL57,18,32,50,P,6,12020,Regular
4JN16CS133,15CSL58,19,55,74,P,8,12020,Regular
4JN16CS133,15MAT31,12,28,40,P,4,12020,Backlog
4JN16CS004,17CS51,35,31,66,P,7,12020,Regular
4JN16CS004,17CS552,33,25,58,P,6,12020,Regular
4JN16CS004,17CS52,30,24,54,P,6,12020,Regular
4JN16CS004,17CS53,37,17,54,F,0,Jan-20,
4JN16CS004,17CS564,35,18,53,F,0,Jan-20,
4JN16CS004,17CS54,31,27,58,P,6,12020,Regular
4JN16CS004,17CSL57,32,32,64,P,7,12020,Regular
4JN16CS004,17CSL58,36,20,56,F,0,12020,Regular
4JN16CS068,17CS51,32,37,69,P,7,12020,Regular
4JN16CS068,17CS52,24,24,48,P,6,12020,Regular
4JN16CS068,17CS553,28,29,57,P,6,12020,Regular
4JN16CS068,17CS53,32,24,56,P,6,12020,Regular
4JN16CS068,17CS564,29,23,52,P,6,12020,Regular
4JN16CS068,17CS54,37,24,61,P,7,12020,Regular
4JN16CS068,17CSL57,35,52,87,P,9,12020,Regular
4JN16CS068,17CSL58,40,52,92,P,10,12020,Regular
4JN16CS068,17CS45,9,24,33,F,0,Jan-20,
4JN16CS068,17CS46,10,25,35,F,0,Jan-20,
4JN16CS068,17CSL47,28,57,85,P,9,12020,Backlog
4JN17CS002,17CS51,27,30,57,P,6,12020,Regular
4JN17CS002,17CS52,23,25,48,P,6,12020,Regular
4JN17CS002,17CS553,23,27,50,P,6,12020,Regular
4JN17CS002,17CS53,36,21,57,P,6,12020,Regular
4JN17CS002,17CS54,26,23,49,P,6,12020,Regular
4JN17CS002,17CS564,24,24,48,P,6,12020,Regular
4JN17CS002,17CSL57,35,44,79,P,8,12020,Regular
4JN17CS002,17CSL58,37,40,77,P,8,12020,Regular
4JN17CS002,17CS42,19,21,40,P,4,12020,Backlog
4JN17CS004,17CS51,39,38,77,P,8,12020,Regular
4JN17CS004,17CS52,36,50,86,P,9,12020,Regular
4JN17CS004,17CS553,38,47,85,P,9,12020,Regular
4JN17CS004,17CS53,40,35,75,P,8,12020,Regular
4JN17CS004,17CS54,39,38,77,P,8,12020,Regular
4JN17CS004,17CS564,37,41,78,P,8,12020,Regular
4JN17CS004,17CSL57,35,51,86,P,9,12020,Regular
4JN17CS004,17CSL58,36,56,92,P,10,12020,Regular
4JN17CS010,17CS51,37,40,77,P,8,12020,Regular
4JN17CS010,17CS552,31,36,67,P,7,12020,Regular
4JN17CS010,17CS52,28,37,65,P,7,12020,Regular
4JN17CS010,17CS53,33,27,60,P,7,12020,Regular
4JN17CS010,17CS564,33,33,66,P,7,12020,Regular
4JN17CS010,17CS54,31,23,54,P,6,12020,Regular
4JN17CS010,17CSL57,33,35,68,P,7,12020,Regular
4JN17CS010,17CSL58,38,47,85,P,9,12020,Regular
4JN17CS012,17CS51,39,32,71,P,8,12020,Regular
4JN17CS012,17CS52,30,33,63,P,7,12020,Regular
4JN17CS012,17CS553,35,39,74,P,8,12020,Regular
4JN17CS012,17CS53,37,29,66,P,7,12020,Regular
4JN17CS012,17CS564,34,34,68,P,7,12020,Regular
4JN17CS012,17CS54,38,25,63,P,7,12020,Regular
4JN17CS012,17CSL57,36,56,92,P,10,12020,Regular
4JN17CS012,17CSL58,38,51,89,P,9,12020,Regular
4JN17CS013,17CS51,25,33,58,P,6,12020,Regular
4JN17CS013,17CS52,24,22,46,P,6,12020,Regular
4JN17CS013,17CS553,19,36,55,P,6,12020,Regular
4JN17CS013,17CS53,33,29,62,P,7,12020,Regular
4JN17CS013,17CS564,27,31,58,P,6,12020,Regular
4JN17CS013,17CS54,32,34,66,P,7,12020,Regular
4JN17CS013,17CSL57,37,41,78,P,8,12020,Regular
4JN17CS013,17CSL58,37,42,79,P,8,12020,Regular
4JN17CS014,17CS51,37,48,85,P,9,12020,Regular
4JN17CS014,17CS562,38,29,67,P,7,12020,Regular
4JN17CS014,17CS52,33,43,76,P,8,Jan-20,
4JN17CS014,17CS553,39,58,97,P,10,12020,Regular
4JN17CS014,17CS53,35,33,68,P,7,12020,Regular
4JN17CS014,17CS54,37,30,67,P,7,12020,Regular
4JN17CS014,17CSL57,39,54,93,P,10,12020,Regular
4JN17CS014,17CSL58,38,59,97,P,10,12020,Regular
4JN17CS016,17CS51,40,45,85,P,9,12020,Regular
4JN17CS016,17CS52,37,46,83,P,9,12020,Regular
4JN17CS016,17CS553,38,45,83,P,9,12020,Regular
4JN17CS016,17CS53,39,32,71,P,8,12020,Regular
4JN17CS016,17CS564,38,45,83,P,9,12020,Regular
4JN17CS016,17CS54,40,40,80,P,9,12020,Regular
4JN17CS016,17CSL57,38,57,95,P,10,12020,Regular
4JN17CS016,17CSL58,40,59,99,P,10,12020,Regular
4JN17CS019,17CS51,35,36,71,P,8,12020,Regular
4JN17CS019,17CS52,36,38,74,P,8,12020,Regular
4JN17CS019,17CS562,37,41,78,P,8,12020,Regular
4JN17CS019,17CS553,39,45,84,P,9,12020,Regular
4JN17CS019,17CS53,39,38,77,P,8,12020,Regular
4JN17CS019,17CS54,33,41,74,P,8,12020,Regular
4JN17CS019,17CSL57,39,53,92,P,10,12020,Regular
4JN17CS019,17CSL58,40,60,100,P,10,12020,Regular
4JN17CS025,17CS51,33,36,69,P,7,12020,Regular
4JN17CS025,17CS52,31,32,63,P,7,12020,Regular
4JN17CS025,17CS553,31,41,72,P,8,12020,Regular
4JN17CS025,17CS53,34,29,63,P,7,12020,Regular
4JN17CS025,17CS54,34,33,67,P,7,12020,Regular
4JN17CS025,17CS564,37,23,60,P,7,12020,Regular
4JN17CS025,17CSL57,38,56,94,P,10,12020,Regular
4JN17CS025,17CSL58,38,54,92,P,10,12020,Regular
4JN17CS026,17CS51,38,37,75,P,8,12020,Regular
4JN17CS026,17CS52,28,34,62,P,7,12020,Regular
4JN17CS026,17CS553,36,32,68,P,7,12020,Regular
4JN17CS026,17CS53,36,41,77,P,8,12020,Regular
4JN17CS026,17CS54,34,29,63,P,7,12020,Regular
4JN17CS026,17CS564,36,35,71,P,8,12020,Regular
4JN17CS026,17CSL57,35,45,80,P,9,12020,Regular
4JN17CS026,17CSL58,37,57,94,P,10,12020,Regular
4JN17CS030,17CS51,25,24,49,P,6,12020,Regular
4JN17CS030,17CS52,20,27,47,P,6,Jan-20,
4JN17CS030,17CS553,21,21,42,P,4,Jan-20,
4JN17CS030,17CS53,34,32,66,P,7,12020,Regular
4JN17CS030,17CS564,28,21,49,P,6,12020,Regular
4JN17CS030,17CS54,26,31,57,P,6,12020,Regular
4JN17CS030,17CSL57,36,38,74,P,8,12020,Regular
4JN17CS030,17CSL58,37,42,79,P,8,12020,Regular
4JN17CS031,17CS51,38,36,74,P,8,12020,Regular
4JN17CS031,17CS52,34,46,80,P,9,12020,Regular
4JN17CS031,17CS562,40,42,82,P,9,12020,Regular
4JN17CS031,17CS553,36,48,84,P,9,12020,Regular
4JN17CS031,17CS53,37,36,73,P,8,12020,Regular
4JN17CS031,17CS54,33,35,68,P,7,12020,Regular
4JN17CS031,17CSL57,36,53,89,P,9,12020,Regular
4JN17CS031,17CSL58,39,56,95,P,10,12020,Regular
4JN17CS032,17CS51,32,41,73,P,8,12020,Regular
4JN17CS032,17CS52,20,30,50,P,6,12020,Regular
4JN17CS032,17CS553,24,30,54,P,6,12020,Regular
4JN17CS032,17CS53,31,30,61,P,7,12020,Regular
4JN17CS032,17CS564,27,30,57,P,6,12020,Regular
4JN17CS032,17CS54,25,24,49,P,6,12020,Regular
4JN17CS032,17CSL57,34,37,71,P,8,12020,Regular
4JN17CS032,17CSL58,38,40,78,P,8,12020,Regular
4JN17CS032,17CPH49,13,0,13,A,0,12020,Backlog
4JN17CS035,17CS51,32,27,59,P,6,12020,Regular
4JN17CS035,17CS562,34,23,57,P,6,12020,Regular
4JN17CS035,17CS52,27,33,60,P,7,12020,Regular
4JN17CS035,17CS553,27,38,65,P,7,12020,Regular
4JN17CS035,17CS53,28,22,50,P,6,12020,Regular
4JN17CS035,17CS54,32,21,53,P,6,12020,Regular
4JN17CS035,17CSL57,33,54,87,P,9,12020,Regular
4JN17CS035,17CSL58,34,48,82,P,9,12020,Regular
4JN17CS038,17CS51,35,44,79,P,8,12020,Regular
4JN17CS038,17CS52,36,47,83,P,9,12020,Regular
4JN17CS038,17CS553,39,41,80,P,9,12020,Regular
4JN17CS038,17CS53,36,27,63,P,7,12020,Regular
4JN17CS038,17CS54,39,41,80,P,9,12020,Regular
4JN17CS038,17CS564,40,32,72,P,8,12020,Regular
4JN17CS038,17CSL57,39,53,92,P,10,12020,Regular
4JN17CS038,17CSL58,37,59,96,P,10,12020,Regular
4JN17CS039,17CS51,40,43,83,P,9,12020,Regular
4JN17CS039,17CS52,37,48,85,P,9,12020,Regular
4JN17CS039,17CS553,38,43,81,P,9,12020,Regular
4JN17CS039,17CS53,39,42,81,P,9,12020,Regular
4JN17CS039,17CS564,40,48,88,P,9,12020,Regular
4JN17CS039,17CS54,40,36,76,P,8,12020,Regular
4JN17CS039,17CSL57,37,56,93,P,10,12020,Regular
4JN17CS039,17CSL58,37,59,96,P,10,12020,Regular
4JN17CS044,17CS51,36,44,80,P,9,12020,Regular
4JN17CS044,17CS552,38,27,65,P,7,12020,Regular
4JN17CS044,17CS52,29,30,59,P,6,12020,Regular
4JN17CS044,17CS53,39,28,67,P,7,12020,Regular
4JN17CS044,17CS564,34,44,78,P,8,12020,Regular
4JN17CS044,17CS54,38,33,71,P,8,12020,Regular
4JN17CS044,17CSL57,32,30,62,P,7,12020,Regular
4JN17CS044,17CSL58,36,24,60,P,7,12020,Regular
4JN17CS045,17CS51,40,42,82,P,9,12020,Regular
4JN17CS045,17CS552,40,30,70,P,8,12020,Regular
4JN17CS045,17CS52,29,43,72,P,8,12020,Regular
4JN17CS045,17CS53,39,21,60,P,7,12020,Regular
4JN17CS045,17CS564,37,30,67,P,7,12020,Regular
4JN17CS045,17CS54,38,32,70,P,8,12020,Regular
4JN17CS045,17CSL57,34,50,84,P,9,12020,Regular
4JN17CS045,17CSL58,36,38,74,P,8,12020,Regular
4JN17CS047,17CS51,35,24,59,P,6,12020,Regular
4JN17CS047,17CS52,27,24,51,P,6,12020,Regular
4JN17CS047,17CS553,34,31,65,P,7,12020,Regular
4JN17CS047,17CS53,37,21,58,P,6,12020,Regular
4JN17CS047,17CS564,32,24,56,P,6,12020,Regular
4JN17CS047,17CS54,31,30,61,P,7,12020,Regular
4JN17CS047,17CSL57,33,40,73,P,8,12020,Regular
4JN17CS047,17CSL58,36,42,78,P,8,12020,Regular
4JN17CS048,17CS51,36,43,79,P,8,Jan-20,
4JN17CS048,17CS52,27,38,65,P,7,Jan-20,
4JN17CS048,17CS553,34,37,71,P,8,12020,Regular
4JN17CS048,17CS53,36,21,57,P,6,12020,Regular
4JN17CS048,17CS564,31,33,64,P,7,12020,Regular
4JN17CS048,17CS54,26,27,53,P,6,12020,Regular
4JN17CS048,17CSL57,33,38,71,P,8,12020,Regular
4JN17CS048,17CSL58,34,35,69,P,7,12020,Regular
4JN17CS057,17CS51,36,32,68,P,7,12020,Regular
4JN17CS057,17CS52,24,42,66,P,7,12020,Regular
4JN17CS057,17CS553,27,32,59,P,6,12020,Regular
4JN17CS057,17CS53,23,21,44,P,4,12020,Regular
4JN17CS057,17CS54,32,31,63,P,7,12020,Regular
4JN17CS057,17CS564,33,31,64,P,7,12020,Regular
4JN17CS057,17CSL57,35,41,76,P,8,12020,Regular
4JN17CS057,17CSL58,37,39,76,P,8,12020,Regular
4JN17CS063,17CS51,34,32,66,P,7,12020,Regular
4JN17CS063,17CS562,34,31,65,P,7,12020,Regular
4JN17CS063,17CS52,26,35,61,P,7,12020,Regular
4JN17CS063,17CS553,27,32,59,P,6,12020,Regular
4JN17CS063,17CS53,30,26,56,P,6,12020,Regular
4JN17CS063,17CS54,29,21,50,P,6,12020,Regular
4JN17CS063,17CSL57,34,42,76,P,8,12020,Regular
4JN17CS063,17CSL58,36,51,87,P,9,12020,Regular
4JN17CS063,17CPH49,14,15,29,P,0,12020,Backlog
4JN17CS066,17CS51,36,41,77,P,8,12020,Regular
4JN17CS066,17CS52,32,42,74,P,8,12020,Regular
4JN17CS066,17CS553,34,47,81,P,9,12020,Regular
4JN17CS066,17CS53,39,24,63,P,7,12020,Regular
4JN17CS066,17CS564,36,30,66,P,7,12020,Regular
4JN17CS066,17CS54,33,32,65,P,7,12020,Regular
4JN17CS066,17CSL57,34,38,72,P,8,12020,Regular
4JN17CS066,17CSL58,37,45,82,P,9,12020,Regular
4JN17CS068,17CS51,28,38,66,P,7,12020,Regular
4JN17CS068,17CS52,23,41,64,P,7,12020,Regular
4JN17CS068,17CS553,29,36,65,P,7,12020,Regular
4JN17CS068,17CS53,35,27,62,P,7,12020,Regular
4JN17CS068,17CS564,30,42,72,P,8,12020,Regular
4JN17CS068,17CS54,31,32,63,P,7,12020,Regular
4JN17CS068,17CSL57,36,35,71,P,8,12020,Regular
4JN17CS068,17CSL58,37,43,80,P,9,12020,Regular
4JN17CS071,17CS51,27,42,69,P,7,12020,Regular
4JN17CS071,17CS52,25,32,57,P,6,12020,Regular
4JN17CS071,17CS562,37,27,64,P,7,12020,Regular
4JN17CS071,17CS553,34,29,63,P,7,12020,Regular
4JN17CS071,17CS53,36,21,57,P,6,12020,Regular
4JN17CS071,17CS54,26,26,52,P,6,12020,Regular
4JN17CS071,17CSL57,32,15,47,F,0,12020,Regular
4JN17CS071,17CSL58,35,54,89,P,9,12020,Regular
4JN17CS073,17CS51,35,34,69,P,7,12020,Regular
4JN17CS073,17CS552,37,33,70,P,8,12020,Regular
4JN17CS073,17CS52,31,32,63,P,7,12020,Regular
4JN17CS073,17CS53,34,25,59,P,6,12020,Regular
4JN17CS073,17CS564,34,26,60,P,7,12020,Regular
4JN17CS073,17CS54,30,30,60,P,7,12020,Regular
4JN17CS073,17CSL57,33,32,65,P,7,12020,Regular
4JN17CS073,17CSL58,36,24,60,P,7,12020,Regular
4JN17CS074,17CS51,37,36,73,P,8,12020,Regular
4JN17CS074,17CS52,28,31,59,P,6,12020,Regular
4JN17CS074,17CS553,33,41,74,P,8,12020,Regular
4JN17CS074,17CS53,39,34,73,P,8,12020,Regular
4JN17CS074,17CS564,33,28,61,P,7,12020,Regular
4JN17CS074,17CS54,39,39,78,P,8,12020,Regular
4JN17CS074,17CSL57,36,41,77,P,8,12020,Regular
4JN17CS074,17CSL58,37,52,89,P,9,12020,Regular
4JN17CS076,17CS51,38,39,77,P,8,12020,Regular
4JN17CS076,17CS52,25,44,69,P,7,12020,Regular
4JN17CS076,17CS553,30,42,72,P,8,12020,Regular
4JN17CS076,17CS53,37,37,74,P,8,12020,Regular
4JN17CS076,17CS564,32,26,58,P,6,12020,Regular
4JN17CS076,17CS54,34,38,72,P,8,12020,Regular
4JN17CS076,17CSL57,36,36,72,P,8,12020,Regular
4JN17CS076,17CSL58,37,48,85,P,9,12020,Regular
4JN17CS081,17CS51,30,21,51,P,6,Jan-20,
4JN17CS081,17CS562,37,25,62,P,7,12020,Regular
4JN17CS081,17CS52,26,38,64,P,7,12020,Regular
4JN17CS081,17CS553,30,27,57,P,6,12020,Regular
4JN17CS081,17CS53,29,18,47,F,0,Jan-20,
4JN17CS081,17CS54,22,24,46,P,6,12020,Regular
4JN17CS081,17CSL57,32,17,49,F,0,12020,Regular
4JN17CS081,17CSL58,35,54,89,P,9,12020,Regular
4JN17CS084,17CS51,33,29,62,P,7,12020,Regular
4JN17CS084,17CS52,28,30,58,P,6,12020,Regular
4JN17CS084,17CS553,28,27,55,P,6,12020,Regular
4JN17CS084,17CS53,38,21,59,P,6,12020,Regular
4JN17CS084,17CS564,30,32,62,P,7,12020,Regular
4JN17CS084,17CS54,32,21,53,P,6,12020,Regular
4JN17CS084,17CSL57,35,47,82,P,9,12020,Regular
4JN17CS084,17CSL58,36,53,89,P,9,12020,Regular
4JN17CS086,17CS51,29,27,56,P,6,12020,Regular
4JN17CS086,17CS562,30,12,42,F,0,12020,Regular
4JN17CS086,17CS52,22,29,51,P,6,12020,Regular
4JN17CS086,17CS553,24,12,36,F,0,12020,Regular
4JN17CS086,17CS53,29,32,61,P,7,12020,Regular
4JN17CS086,17CS54,27,30,57,P,6,12020,Regular
4JN17CS086,17CSL57,33,16,49,F,0,12020,Regular
4JN17CS086,17CSL58,34,36,70,P,8,12020,Regular
4JN17CS086,17CS42,19,11,30,F,0,12020,Backlog
4JN17CS086,17CS44,21,21,42,P,4,12020,Backlog
4JN17CS086,17CS46,22,21,43,P,4,12020,Backlog
4JN17CS086,17CS34,20,21,41,P,4,12020,Backlog
4JN17CS089,17CS51,39,42,81,P,9,12020,Regular
4JN17CS089,17CS562,40,35,75,P,8,12020,Regular
4JN17CS089,17CS52,35,46,81,P,9,12020,Regular
4JN17CS089,17CS553,40,42,82,P,9,12020,Regular
4JN17CS089,17CS53,40,26,66,P,7,12020,Regular
4JN17CS089,17CS54,40,32,72,P,8,12020,Regular
4JN17CS089,17CSL57,39,56,95,P,10,12020,Regular
4JN17CS089,17CSL58,40,59,99,P,10,12020,Regular
4JN17CS093,17CS51,35,32,67,P,7,12020,Regular
4JN17CS093,17CS562,37,46,83,P,9,12020,Regular
4JN17CS093,17CS52,36,46,82,P,9,12020,Regular
4JN17CS093,17CS553,34,41,75,P,8,12020,Regular
4JN17CS093,17CS53,39,32,71,P,8,12020,Regular
4JN17CS093,17CS54,35,39,74,P,8,12020,Regular
4JN17CS093,17CSL57,39,54,93,P,10,12020,Regular
4JN17CS093,17CSL58,38,57,95,P,10,12020,Regular
4JN17CS095,17CS51,38,37,75,P,8,12020,Regular
4JN17CS095,17CS52,34,32,66,P,7,12020,Regular
4JN17CS095,17CS553,40,41,81,P,9,12020,Regular
4JN17CS095,17CS53,37,39,76,P,8,12020,Regular
4JN17CS095,17CS564,40,39,79,P,8,12020,Regular
4JN17CS095,17CS54,38,39,77,P,8,12020,Regular
4JN17CS095,17CSL57,39,53,92,P,10,12020,Regular
4JN17CS095,17CSL58,37,58,95,P,10,12020,Regular
4JN17CS096,17CS51,35,47,82,P,9,12020,Regular
4JN17CS096,17CS562,32,36,68,P,7,12020,Regular
4JN17CS096,17CS52,35,48,83,P,9,12020,Regular
4JN17CS096,17CS553,38,45,83,P,9,12020,Regular
4JN17CS096,17CS53,40,35,75,P,8,12020,Regular
4JN17CS096,17CS54,36,32,68,P,7,12020,Regular
4JN17CS096,17CSL57,36,52,88,P,9,12020,Regular
4JN17CS096,17CSL58,38,57,95,P,10,12020,Regular
4JN17CS099,17CS51,40,41,81,P,9,12020,Regular
4JN17CS099,17CS52,30,35,65,P,7,12020,Regular
4JN17CS099,17CS553,38,38,76,P,8,12020,Regular
4JN17CS099,17CS53,35,32,67,P,7,12020,Regular
4JN17CS099,17CS564,40,41,81,P,9,12020,Regular
4JN17CS099,17CS54,39,45,84,P,9,12020,Regular
4JN17CS099,17CSL57,39,54,93,P,10,12020,Regular
4JN17CS099,17CSL58,40,52,92,P,10,12020,Regular
4JN17CS100,17CS51,40,36,76,P,8,12020,Regular
4JN17CS100,17CS52,35,42,77,P,8,12020,Regular
4JN17CS100,17CS562,40,45,85,P,9,12020,Regular
4JN17CS100,17CS553,40,51,91,P,10,12020,Regular
4JN17CS100,17CS53,39,32,71,P,8,12020,Regular
4JN17CS100,17CS54,39,39,78,P,8,12020,Regular
4JN17CS100,17CSL57,34,39,73,P,8,12020,Regular
4JN17CS100,17CSL58,37,56,93,P,10,12020,Regular
4JN17CS101,17CS51,33,36,69,P,7,Jan-20,
4JN17CS101,17CS562,39,25,64,P,7,12020,Regular
4JN17CS101,17CS52,27,39,66,P,7,12020,Regular
4JN17CS101,17CS553,32,27,59,P,6,Jan-20,
4JN17CS101,17CS53,35,21,56,P,6,12020,Regular
4JN17CS101,17CS54,28,25,53,P,6,12020,Regular
4JN17CS101,17CSL57,34,45,79,P,8,12020,Regular
4JN17CS101,17CSL58,36,48,84,P,9,12020,Regular
4JN17CS101,17CS42,23,21,44,P,4,12020,Backlog
4JN17CS101,17CS43,26,36,62,P,7,12020,Backlog
4JN17CS101,17CPH49,15,15,30,P,0,12020,Backlog
4JN17CS102,17CS51,33,32,65,P,7,12020,Regular
4JN17CS102,17CS562,36,33,69,P,7,12020,Regular
4JN17CS102,17CS52,28,47,75,P,8,12020,Regular
4JN17CS102,17CS553,31,38,69,P,7,12020,Regular
4JN17CS102,17CS53,37,38,75,P,8,12020,Regular
4JN17CS102,17CS54,32,26,58,P,6,12020,Regular
4JN17CS102,17CSL57,28,44,72,P,8,12020,Regular
4JN17CS102,17CSL58,36,57,93,P,10,12020,Regular
4JN17CS105,17CS51,39,33,72,P,8,12020,Regular
4JN17CS105,17CS52,29,39,68,P,7,12020,Regular
4JN17CS105,17CS553,36,40,76,P,8,12020,Regular
4JN17CS105,17CS53,36,28,64,P,7,12020,Regular
4JN17CS105,17CS564,36,29,65,P,7,12020,Regular
4JN17CS105,17CS54,37,33,70,P,8,12020,Regular
4JN17CS105,17CSL57,33,44,77,P,8,12020,Regular
4JN17CS105,17CSL58,36,48,84,P,9,12020,Regular
4JN17CS106,17CS51,37,45,82,P,9,12020,Regular
4JN17CS106,17CS562,36,28,64,P,7,12020,Regular
4JN17CS106,17CS52,31,37,68,P,7,12020,Regular
4JN17CS106,17CS553,33,40,73,P,8,12020,Regular
4JN17CS106,17CS53,31,26,57,P,6,12020,Regular
4JN17CS106,17CS54,31,34,65,P,7,12020,Regular
4JN17CS106,17CSL57,38,48,86,P,9,12020,Regular
4JN17CS106,17CSL58,37,47,84,P,9,12020,Regular
4JN17CS107,17CS51,40,42,82,P,9,12020,Regular
4JN17CS107,17CS562,39,32,71,P,8,12020,Regular
4JN17CS107,17CS52,38,42,80,P,9,12020,Regular
4JN17CS107,17CS553,38,37,75,P,8,12020,Regular
4JN17CS107,17CS53,39,32,71,P,8,12020,Regular
4JN17CS107,17CS54,39,33,72,P,8,12020,Regular
4JN17CS107,17CSL57,36,47,83,P,9,12020,Regular
4JN17CS107,17CSL58,37,60,97,P,10,12020,Regular
4JN17CS111,17CS51,35,47,82,P,9,12020,Regular
4JN17CS111,17CS562,38,31,69,P,7,12020,Regular
4JN17CS111,17CS52,31,24,55,P,6,12020,Regular
4JN17CS111,17CS553,33,39,72,P,8,12020,Regular
4JN17CS111,17CS53,37,39,76,P,8,12020,Regular
4JN17CS111,17CS54,34,42,76,P,8,12020,Regular
4JN17CS111,17CSL57,35,41,76,P,8,12020,Regular
4JN17CS111,17CSL58,37,60,97,P,10,12020,Regular
4JN17CS112,17CS51,40,45,85,P,9,12020,Regular
4JN17CS112,17CS552,37,41,78,P,8,12020,Regular
4JN17CS112,17CS52,30,36,66,P,7,12020,Regular
4JN17CS112,17CS53,35,26,61,P,7,12020,Regular
4JN17CS112,17CS564,34,39,73,P,8,12020,Regular
4JN17CS112,17CS54,34,31,65,P,7,12020,Regular
4JN17CS112,17CSL57,35,56,91,P,10,12020,Regular
4JN17CS112,17CSL58,36,48,84,P,9,12020,Regular
4JN17CS113,17CS51,38,44,82,P,9,12020,Regular
4JN17CS113,17CS562,36,29,65,P,7,12020,Regular
4JN17CS113,17CS52,33,45,78,P,8,12020,Regular
4JN17CS113,17CS553,31,42,73,P,8,12020,Regular
4JN17CS113,17CS53,38,27,65,P,7,12020,Regular
4JN17CS113,17CS54,35,33,68,P,7,12020,Regular
4JN17CS113,17CSL57,35,39,74,P,8,12020,Regular
4JN17CS113,17CSL58,37,40,77,P,8,12020,Regular
4JN17CS116,17CS51,38,35,73,P,8,12020,Regular
4JN17CS116,17CS562,40,33,73,P,8,12020,Regular
4JN17CS116,17CS52,33,24,57,P,6,12020,Regular
4JN17CS116,17CS553,36,27,63,P,7,12020,Regular
4JN17CS116,17CS53,38,33,71,P,8,12020,Regular
4JN17CS116,17CS54,34,25,59,P,6,12020,Regular
4JN17CS116,17CSL57,36,50,86,P,9,12020,Regular
4JN17CS116,17CSL58,37,54,91,P,10,12020,Regular
4JN17CS117,17CS51,38,36,74,P,8,12020,Regular
4JN17CS117,17CS52,31,38,69,P,7,12020,Regular
4JN17CS117,17CS553,37,41,78,P,8,12020,Regular
4JN17CS117,17CS53,36,38,74,P,8,12020,Regular
4JN17CS117,17CS564,38,27,65,P,7,12020,Regular
4JN17CS117,17CS54,36,29,65,P,7,12020,Regular
4JN17CS117,17CSL57,36,29,65,P,7,12020,Regular
4JN17CS117,17CSL58,37,46,83,P,9,12020,Regular
4JN17CS118,17CS51,38,40,78,P,8,12020,Regular
4JN17CS118,17CS52,34,44,78,P,8,12020,Regular
4JN17CS118,17CS553,35,35,70,P,8,12020,Regular
4JN17CS118,17CS53,36,30,66,P,7,12020,Regular
4JN17CS118,17CS564,37,39,76,P,8,12020,Regular
4JN17CS118,17CS54,40,35,75,P,8,12020,Regular
4JN17CS118,17CSL57,36,38,74,P,8,12020,Regular
4JN17CS118,17CSL58,36,58,94,P,10,12020,Regular
4JN17CS119,17CS51,39,32,71,P,8,12020,Regular
4JN17CS119,17CS52,28,33,61,P,7,12020,Regular
4JN17CS119,17CS553,34,27,61,P,7,12020,Regular
4JN17CS119,17CS53,35,26,61,P,7,12020,Regular
4JN17CS119,17CS564,32,22,54,P,6,12020,Regular
4JN17CS119,17CS54,35,23,58,P,6,12020,Regular
4JN17CS119,17CSL57,37,55,92,P,10,12020,Regular
4JN17CS119,17CSL58,36,56,92,P,10,12020,Regular
4JN17CS120,17CS51,34,48,82,P,9,12020,Regular
4JN17CS120,17CS552,38,32,70,P,8,12020,Regular
4JN17CS120,17CS52,34,40,74,P,8,12020,Regular
4JN17CS120,17CS53,35,26,61,P,7,12020,Regular
4JN17CS120,17CS564,35,23,58,P,6,12020,Regular
4JN17CS120,17CS54,34,35,69,P,7,12020,Regular
4JN17CS120,17CSL57,35,53,88,P,9,12020,Regular
4JN17CS120,17CSL58,37,42,79,P,8,12020,Regular
4JN17CS121,17CS51,38,32,70,P,8,12020,Regular
4JN17CS121,17CS52,20,23,43,P,4,12020,Regular
4JN17CS121,17CS553,26,34,60,P,7,12020,Regular
4JN17CS121,17CS53,36,27,63,P,7,12020,Regular
4JN17CS121,17CS564,28,27,55,P,6,12020,Regular
4JN17CS121,17CS54,32,21,53,P,6,12020,Regular
4JN17CS121,17CSL57,36,47,83,P,9,12020,Regular
4JN17CS121,17CSL58,37,45,82,P,9,12020,Regular
4JN17CS121,17CS45,25,21,46,P,6,12020,Backlog
4JN17CS121,17CS33,26,21,47,P,6,12020,Backlog
4JN17CS125,17CS51,35,44,79,P,8,12020,Regular
4JN17CS125,17CS52,27,26,53,P,6,12020,Regular
4JN17CS125,17CS553,32,44,76,P,8,12020,Regular
4JN17CS125,17CS53,36,21,57,P,6,12020,Regular
4JN17CS125,17CS564,37,40,77,P,8,12020,Regular
4JN17CS125,17CS54,35,35,70,P,8,12020,Regular
4JN17CS125,17CSL57,38,27,65,P,7,12020,Regular
4JN17CS125,17CSL58,37,47,84,P,9,12020,Regular
4JN17CS125,17CS43,34,36,70,P,8,12020,Backlog
4JN17CS126,17CS51,36,40,76,P,8,Jan-20,
4JN17CS126,17CS52,30,30,60,P,7,12020,Regular
4JN17CS126,17CS562,38,31,69,P,7,Jan-20,
4JN17CS126,17CS553,35,35,70,P,8,12020,Regular
4JN17CS126,17CS53,37,38,75,P,8,12020,Regular
4JN17CS126,17CS54,29,26,55,P,6,12020,Regular
4JN17CS126,17CSL57,37,44,81,P,9,12020,Regular
4JN17CS126,17CSL58,36,18,54,F,0,12020,Regular
4JN18CS402,17CS51,32,32,64,P,7,12020,Regular
4JN18CS402,17CS562,39,26,65,P,7,12020,Regular
4JN18CS402,17CS52,25,24,49,P,6,12020,Regular
4JN18CS402,17CS553,34,21,55,P,6,12020,Regular
4JN18CS402,17CS53,36,41,77,P,8,12020,Regular
4JN18CS402,17CS54,26,23,49,P,6,12020,Regular
4JN18CS402,17CSL57,34,30,64,P,7,12020,Regular
4JN18CS402,17CSL58,36,36,72,P,8,12020,Regular
4JN18CS402,17CPH49,13,10,23,P,0,12020,Backlog
4JN18CS402,17MATDIP31,0,5,5,F,0,12020,Backlog
4JN18CS402,17CIV28,18,15,33,P,0,12020,Backlog
4JN18CS403,17CS51,37,30,67,P,7,12020,Regular
4JN18CS403,17CS562,36,31,67,P,7,12020,Regular
4JN18CS403,17CS552,37,36,73,P,8,12020,Regular
4JN18CS403,17CS52,30,36,66,P,7,12020,Regular
4JN18CS403,17CS53,38,21,59,P,6,12020,Regular
4JN18CS403,17CS54,33,28,61,P,7,12020,Regular
4JN18CS403,17CSL57,37,32,69,P,7,12020,Regular
4JN18CS403,17CSL58,36,30,66,P,7,12020,Regular
4JN18CS403,17MATDIP41,0,25,25,P,0,12020,Backlog
4JN18CS403,17MATDIP31,0,9,9,F,0,12020,Backlog
4JN18CS403,17CIV28,17,13,30,P,0,12020,Backlog
4JN18CS405,17CS51,34,32,66,P,7,12020,Regular
4JN18CS405,17CS562,34,24,58,P,6,12020,Regular
4JN18CS405,17CS552,29,36,65,P,7,12020,Regular
4JN18CS405,17CS52,27,39,66,P,7,12020,Regular
4JN18CS405,17CS53,38,36,74,P,8,12020,Regular
4JN18CS405,17CS54,29,26,55,P,6,Jan-20,
4JN18CS405,17CSL57,34,40,74,P,8,12020,Regular
4JN18CS405,17CSL58,36,51,87,P,9,12020,Regular
4JN18CS405,17MATDIP41,0,21,21,P,0,12020,Backlog
4JN18CS405,17MATDIP31,0,1,1,F,0,12020,Backlog
4JN18CS405,17CIV28,17,21,38,P,0,12020,Backlog
4JN18CS406,17CS51,33,38,71,P,8,12020,Regular
4JN18CS406,17CS552,23,27,50,P,6,12020,Regular
4JN18CS406,17CS52,20,25,45,P,6,12020,Regular
4JN18CS406,17CS53,27,38,65,P,7,12020,Regular
4JN18CS406,17CS564,24,24,48,P,6,12020,Regular
4JN18CS406,17CS54,24,22,46,P,6,12020,Regular
4JN18CS406,17CSL57,33,53,86,P,9,12020,Regular
4JN18CS406,17CSL58,37,48,85,P,9,12020,Regular
4JN18CS406,17MATDIP31,0,7,7,F,0,12020,Backlog
4JN18CS406,17CIV28,18,12,30,P,0,12020,Backlog
4JN18CS407,17CS51,34,43,77,P,8,12020,Regular
4JN18CS407,17CS562,38,44,82,P,9,12020,Regular
4JN18CS407,17CS552,38,41,79,P,8,12020,Regular
4JN18CS407,17CS52,34,35,69,P,7,12020,Regular
4JN18CS407,17CS53,39,33,72,P,8,12020,Regular
4JN18CS407,17CS54,25,34,59,P,6,12020,Regular
4JN18CS407,17CSL57,33,32,65,P,7,12020,Regular
4JN18CS407,17CSL58,37,33,70,P,8,12020,Regular
4JN18CS407,17MATDIP41,0,21,21,P,0,12020,Backlog
4JN18CS407,17MATDIP31,0,5,5,F,0,12020,Backlog
4JN18CS407,17CIV28,17,19,36,P,0,12020,Backlog
4JN18CS408,17CS51,31,25,56,P,6,12020,Regular
4JN18CS408,17CS562,31,24,55,P,6,12020,Regular
4JN18CS408,17CS552,28,21,49,P,6,12020,Regular
4JN18CS408,17CS52,27,24,51,P,6,Jan-20,
4JN18CS408,17CS53,31,21,52,P,6,12020,Regular
4JN18CS408,17CS54,26,21,47,P,6,Jan-20,
4JN18CS408,17CSL57,33,27,60,P,7,12020,Regular
4JN18CS408,17CSL58,36,45,81,P,9,12020,Regular
4JN18CS408,17CS43,31,15,46,F,0,Jan-20,
4JN18CS408,17CPH49,18,5,23,F,0,12020,Backlog
4JN18CS408,17CS34,23,4,27,F,0,12020,Backlog
4JN18CS408,17CS36,26,10,36,F,0,Jan-20,
4JN18CS408,17CIV28,18,17,35,P,0,12020,Backlog
4JN18CS410,17CS51,29,33,62,P,7,12020,Regular
4JN18CS410,17CS52,25,28,53,P,6,12020,Regular
4JN18CS410,17CS553,32,38,70,P,8,12020,Regular
4JN18CS410,17CS53,37,29,66,P,7,12020,Regular
4JN18CS410,17CS54,31,24,55,P,6,12020,Regular
4JN18CS410,17CS564,33,36,69,P,7,12020,Regular
4JN18CS410,17CSL57,34,35,69,P,7,12020,Regular
4JN18CS410,17CSL58,36,54,90,P,10,12020,Regular
4JN18CS410,17CIV28,18,21,39,P,0,12020,Backlog
4JN18CS415,17CS51,34,23,57,P,6,12020,Regular
4JN18CS415,17CS552,27,24,51,P,6,12020,Regular
4JN18CS415,17CS52,20,25,45,P,6,12020,Regular
4JN18CS415,17CS53,37,33,70,P,8,12020,Regular
4JN18CS415,17CS564,29,24,53,P,6,12020,Regular
4JN18CS415,17CS54,24,21,45,P,6,12020,Regular
4JN18CS415,17CSL57,34,41,75,P,8,12020,Regular
4JN18CS415,17CSL58,37,51,88,P,9,12020,Regular
4JN18CS415,17MATDIP31,0,12,12,F,0,12020,Backlog
4JN18CS415,17CIV28,19,21,40,P,4,12020,Backlog
4JN18CS417,17CS51,33,25,58,P,6,12020,Regular
4JN18CS417,17CS52,28,30,58,P,6,12020,Regular
4JN18CS417,17CS553,33,45,78,P,8,12020,Regular
4JN18CS417,17CS53,34,33,67,P,7,12020,Regular
4JN18CS417,17CS564,31,28,59,P,6,12020,Regular
4JN18CS417,17CS54,30,32,62,P,7,12020,Regular
4JN18CS417,17CSL57,34,47,81,P,9,12020,Regular
4JN18CS417,17CSL58,36,45,81,P,9,12020,Regular
4JN18CS417,17MATDIP31,0,16,16,F,0,12020,Backlog
4JN18CS417,17CIV28,17,11,28,P,0,12020,Backlog
4JN18CS418,17CS51,40,35,75,P,8,12020,Regular
4JN18CS418,17CS562,38,23,61,P,7,12020,Regular
4JN18CS418,17CS52,30,45,75,P,8,12020,Regular
4JN18CS418,17CS553,36,39,75,P,8,12020,Regular
4JN18CS418,17CS53,39,36,75,P,8,12020,Regular
4JN18CS418,17CS54,32,29,61,P,7,12020,Regular
4JN18CS418,17CSL57,36,42,78,P,8,12020,Regular
4JN18CS418,17CSL58,36,42,78,P,8,12020,Regular
4JN18CS418,17MATDIP31,0,21,21,P,0,12020,Backlog
4JN18CS418,17CIV28,18,24,42,P,4,12020,Backlog
4JN18CS419,17CS51,33,33,66,P,7,12020,Regular
4JN18CS419,17CS552,26,21,47,P,6,12020,Regular
4JN18CS419,17CS52,20,28,48,P,6,12020,Regular
4JN18CS419,17CS53,32,35,67,P,7,12020,Regular
4JN18CS419,17CS564,27,23,50,P,6,12020,Regular
4JN18CS419,17CS54,26,15,41,F,0,Jan-20,
4JN18CS419,17CSL57,34,28,62,P,7,12020,Regular
4JN18CS419,17CSL58,36,57,93,P,10,12020,Regular
4JN18CS419,17MATDIP41,0,15,15,F,0,12020,Backlog
4JN18CS419,17CS44,24,21,45,P,6,12020,Backlog
4JN18CS419,17MATDIP31,0,15,15,F,0,12020,Backlog
4JN18CS419,17CIV28,18,19,37,P,0,12020,Backlog
4JN18CS421,17CS51,25,24,49,P,6,12020,Regular
4JN18CS421,17CS552,26,25,51,P,6,12020,Regular
4JN18CS421,17CS52,21,21,42,P,4,12020,Regular
4JN18CS421,17CS53,28,24,52,P,6,12020,Regular
4JN18CS421,17CS564,23,14,37,F,0,Jan-20,
4JN18CS421,17CS54,22,10,32,F,0,Jan-20,
4JN18CS421,17CSL57,33,32,65,P,7,12020,Regular
4JN18CS421,17CSL58,37,48,85,P,9,12020,Regular
4JN18CS421,17CSL47,40,24,64,P,7,12020,Backlog
4JN18CS421,17MATDIP31,0,8,8,F,0,12020,Backlog
4JN18CS421,17MAT31,19,12,31,F,0,12020,Backlog
4JN18CS421,17CS36,27,13,40,F,0,12020,Backlog
4JN18CS421,17CIV28,18,18,36,P,0,12020,Backlog
4JN18CS424,17CS51,37,32,69,P,7,12020,Regular
4JN18CS424,17CS552,31,33,64,P,7,12020,Regular
4JN18CS424,17CS52,27,32,59,P,6,12020,Regular
4JN18CS424,17CS53,35,29,64,P,7,12020,Regular
4JN18CS424,17CS564,31,24,55,P,6,12020,Regular
4JN18CS424,17CS54,33,24,57,P,6,12020,Regular
4JN18CS424,17CSL57,33,34,67,P,7,12020,Regular
4JN18CS424,17CSL58,36,57,93,P,10,12020,Regular
4JN18CS424,17MATDIP41,0,21,21,P,0,12020,Backlog
4JN18CS424,17MATDIP31,0,3,3,F,0,12020,Backlog
4JN18CS424,17CIV28,0,20,20,P,0,12020,Backlog
4JN14CS091,15CS51,14,28,42,P,4,Jan-20,
4JN14CS091,15CS52,13,33,46,P,5,12020,Regular
4JN14CS091,15CS553,14,23,37,F,0,Jan-20,
4JN14CS091,15CS53,15,32,47,P,5,12020,Regular
4JN14CS091,15CS564,15,29,44,P,4,12020,Regular
4JN14CS091,15CS54,14,28,42,P,4,12020,Regular
4JN14CS091,15CSL57,15,32,47,P,5,12020,Regular
4JN14CS091,15CSL58,18,60,78,P,8,12020,Regular
4JN17CS415,15CS51,15,29,44,P,4,12020,Regular
4JN17CS415,15CS52,14,43,57,P,6,12020,Regular
4JN17CS415,15CS553,15,37,52,P,6,12020,Regular
4JN17CS415,15CS53,14,34,48,P,5,12020,Regular
4JN17CS415,15CS54,12,28,40,P,4,12020,Regular
4JN17CS415,15CS564,16,38,54,P,6,12020,Regular
4JN17CS415,15CSL57,14,32,46,P,5,12020,Regular
4JN17CS415,15CSL58,18,59,77,P,8,12020,Regular
4JN17CS415,15MATDIP31,0,21,21,F,0,12020,Backlog
4JN17CS421,15CS51,15,34,49,P,5,12020,Regular
4JN17CS421,15CS52,12,35,47,P,5,12020,Regular
4JN17CS421,15CS553,12,39,51,P,6,12020,Regular
4JN17CS421,15CS53,15,30,45,P,5,12020,Regular
4JN17CS421,15CS564,12,33,45,P,5,12020,Regular
4JN17CS421,15CS54,12,28,40,P,4,12020,Regular
4JN17CS421,15CSL57,15,32,47,P,5,12020,Regular
4JN17CS421,15CSL58,18,58,76,P,8,12020,Regular
4JN17CS421,15MATDIP31,0,1,1,F,0,12020,Backlog
4JN17CS426,15CS51,16,29,45,P,5,12020,Regular
4JN17CS426,15CS52,12,41,53,P,6,12020,Regular
4JN17CS426,15CS553,12,28,40,P,4,12020,Regular
4JN17CS426,15CS53,16,38,54,P,6,12020,Regular
4JN17CS426,15CS564,13,28,41,P,4,12020,Regular
4JN17CS426,15CS54,12,15,27,F,0,12020,Regular
4JN17CS426,15CSL57,16,40,56,P,6,12020,Regular
4JN17CS426,15CSL58,18,57,75,P,8,12020,Regular
4JN17CS426,15MATDIP41,0,0,0,A,0,12020,Backlog
4JN17CS426,15MAT41,12,28,40,P,4,Jan-20,
4JN17CS426,15CS42,12,32,44,P,4,12020,Backlog
4JN17CS426,15MATDIP31,0,0,0,F,0,12020,Backlog
4JN17CS426,15CS36,15,23,38,F,0,12020,Backlog
4JN14CS002,15CS71,16,28,44,P,4,12020,Regular
4JN14CS002,15CS72,15,39,54,P,6,12020,Regular
4JN14CS002,15CS743,12,28,40,P,4,12020,Regular
4JN14CS002,15CS73,16,46,62,P,7,12020,Regular
4JN14CS002,15CS754,16,34,50,P,6,12020,Regular
4JN14CS002,15CSL76,18,40,58,P,6,12020,Regular
4JN14CS002,15CSL77,15,43,58,P,6,12020,Regular
4JN14CS002,15CSP78,92,0,92,P,10,12020,Regular
4JN14CS092,15CS71,15,28,43,P,4,12020,Backlog
4JN14CS092,15CS72,13,34,47,P,5,12020,Regular
4JN14CS092,15CS73,12,29,41,P,4,Jan-20,
4JN14CS092,15CS754,13,33,46,P,5,12020,Regular
4JN14CS092,15CS744,12,34,46,P,5,12020,Backlog
4JN14CS092,15CSL76,4,0,4,X,0,12020,Regular
4JN14CS092,15CSL77,13,64,77,P,8,12020,Regular
4JN14CS092,15CSP78,85,0,85,P,9,12020,Regular
4JN14CS092,15CS63,12,0,12,A,0,12020,Backlog
4JN14CS092,15CS664,12,28,40,P,4,12020,Backlog
4JN14CS092,15CS53,12,35,47,P,5,12020,Backlog
4JN15CS025,15CS71,15,37,52,P,6,12020,Backlog
4JN15CS025,15CS72,14,28,42,P,4,12020,Regular
4JN15CS025,15CS73,12,36,48,P,5,Jan-20,
4JN15CS025,15CS754,12,41,53,P,6,12020,Regular
4JN15CS025,15CS744,16,43,59,P,6,12020,Backlog
4JN15CS025,15CSL76,15,50,65,P,7,12020,Regular
4JN15CS025,15CSL77,18,66,84,P,9,12020,Regular
4JN15CS025,15CSP78,90,0,90,P,10,12020,Regular
4JN15CS025,15CS63,14,35,49,P,5,12020,Backlog
4JN15CS041,15CS71,19,39,58,P,6,12020,Backlog
4JN15CS041,15CS72,15,28,43,P,4,Jan-20,
4JN15CS041,15CS73,17,45,62,P,7,12020,Backlog
4JN15CS041,15CS754,16,37,53,P,6,12020,Regular
4JN15CS041,15CS744,18,0,18,A,0,12020,Backlog
4JN15CS041,15CSL76,19,72,91,P,10,12020,Regular
4JN15CS041,15CSL77,16,63,79,P,8,12020,Regular
4JN15CS041,15CSP78,85,0,85,P,9,12020,Regular
4JN15CS041,15CS53,15,31,46,P,5,12020,Backlog
4JN15CS049,15CS71,16,28,44,P,4,12020,Backlog
4JN15CS049,15CS72,14,15,29,F,0,12020,Regular
4JN15CS049,15CS73,15,28,43,P,4,12020,Backlog
4JN15CS049,15CS754,15,28,43,P,4,12020,Regular
4JN15CS049,15CS744,15,28,43,P,4,12020,Backlog
4JN15CS049,15CSL76,4,0,4,X,0,12020,Regular
4JN15CS049,15CSL77,14,63,77,P,8,12020,Regular
4JN15CS049,15CSP78,86,0,86,P,9,12020,Regular
4JN15CS049,15CS664,12,12,24,F,0,12020,Backlog
4JN15CS067,15CS71,15,44,59,P,6,12020,Regular
4JN15CS067,15CS72,15,41,56,P,6,12020,Regular
4JN15CS067,15CS73,14,35,49,P,5,12020,Regular
4JN15CS067,15CS754,13,47,60,P,7,12020,Regular
4JN15CS067,15CS744,15,45,60,P,7,12020,Regular
4JN15CS067,15CSL76,16,40,56,P,6,12020,Regular
4JN15CS067,15CSL77,18,65,83,P,9,12020,Regular
4JN15CS067,15CSP78,85,0,85,P,9,12020,Regular
4JN16CS003,15CS71,13,42,55,P,6,12020,Regular
4JN16CS003,15CS72,12,41,53,P,6,12020,Regular
4JN16CS003,15CS73,12,52,64,P,7,12020,Regular
4JN16CS003,15CS754,13,33,46,P,5,12020,Regular
4JN16CS003,15CS744,12,59,71,P,8,12020,Regular
4JN16CS003,15CSL76,15,34,49,P,5,12020,Regular
4JN16CS003,15CSL77,14,55,69,P,7,12020,Regular
4JN16CS003,15CSP78,85,0,85,P,9,12020,Regular
4JN16CS008,15CS71,19,42,61,P,7,12020,Regular
4JN16CS008,15CS72,18,32,50,P,6,12020,Regular
4JN16CS008,15CS73,17,48,65,P,7,12020,Regular
4JN16CS008,15CS754,19,58,77,P,8,12020,Regular
4JN16CS008,15CS744,20,57,77,P,8,12020,Regular
4JN16CS008,15CSL76,18,74,92,P,10,12020,Regular
4JN16CS008,15CSL77,20,77,97,P,10,12020,Regular
4JN16CS008,15CSP78,98,0,98,P,10,12020,Regular
4JN16CS010,15CS71,19,51,70,P,8,12020,Regular
4JN16CS010,15CS72,18,28,46,P,5,12020,Regular
4JN16CS010,15CS73,19,54,73,P,8,12020,Regular
4JN16CS010,15CS744,20,56,76,P,8,12020,Regular
4JN16CS010,15CS754,20,44,64,P,7,12020,Regular
4JN16CS010,15CSL76,20,40,60,P,7,12020,Regular
4JN16CS010,15CSL77,19,73,92,P,10,12020,Regular
4JN16CS010,15CSP78,92,0,92,P,10,12020,Regular
4JN16CS011,15CS71,20,74,94,P,10,12020,Regular
4JN16CS011,15CS72,20,40,60,P,7,Jan-20,
4JN16CS011,15CS73,18,69,87,P,9,Jan-20,
4JN16CS011,15CS744,20,60,80,P,9,12020,Regular
4JN16CS011,15CS754,20,58,78,P,8,Jan-20,
4JN16CS011,15CSL76,18,75,93,P,10,12020,Regular
4JN16CS011,15CSL77,20,75,95,P,10,12020,Regular
4JN16CS011,15CSP78,97,0,97,P,10,12020,Regular
4JN16CS012,15CS71,20,53,73,P,8,12020,Regular
4JN16CS012,15CS72,19,47,66,P,7,12020,Regular
4JN16CS012,15CS73,17,50,67,P,7,12020,Regular
4JN16CS012,15CS754,19,49,68,P,7,12020,Regular
4JN16CS012,15CS744,20,51,71,P,8,12020,Regular
4JN16CS012,15CSL76,16,40,56,P,6,12020,Regular
4JN16CS012,15CSL77,19,77,96,P,10,12020,Regular
4JN16CS012,15CSP78,97,0,97,P,10,12020,Regular
4JN16CS013,15CS71,19,57,76,P,8,12020,Regular
4JN16CS013,15CS72,20,45,65,P,7,12020,Regular
4JN16CS013,15CS73,16,54,70,P,8,12020,Regular
4JN16CS013,15CS754,18,47,65,P,7,12020,Regular
4JN16CS013,15CS744,17,44,61,P,7,12020,Regular
4JN16CS013,15CSL76,20,73,93,P,10,12020,Regular
4JN16CS013,15CSL77,20,70,90,P,10,12020,Regular
4JN16CS013,15CSP78,93,0,93,P,10,12020,Regular
4JN16CS014,15CS71,20,59,79,P,8,12020,Regular
4JN16CS014,15CS72,20,46,66,P,7,12020,Regular
4JN16CS014,15CS73,19,50,69,P,7,12020,Regular
4JN16CS014,15CS754,20,69,89,P,9,12020,Regular
4JN16CS014,15CS744,20,64,84,P,9,12020,Regular
4JN16CS014,15CSL76,20,74,94,P,10,12020,Regular
4JN16CS014,15CSL77,20,78,98,P,10,12020,Regular
4JN16CS014,15CSP78,98,0,98,P,10,12020,Regular
4JN16CS015,15CS71,19,28,47,P,5,12020,Regular
4JN16CS015,15CS72,17,34,51,P,6,12020,Regular
4JN16CS015,15CS73,13,36,49,P,5,12020,Regular
4JN16CS015,15CS754,15,33,48,P,5,12020,Regular
4JN16CS015,15CS744,14,38,52,P,6,12020,Regular
4JN16CS015,15CSL76,16,70,86,P,9,12020,Regular
4JN16CS015,15CSL77,20,58,78,P,8,12020,Regular
4JN16CS015,15CSP78,93,0,93,P,10,12020,Regular
4JN16CS016,15CS71,20,51,71,P,8,12020,Regular
4JN16CS016,15CS72,18,50,68,P,7,12020,Regular
4JN16CS016,15CS73,19,53,72,P,8,12020,Regular
4JN16CS016,15CS744,20,44,64,P,7,12020,Regular
4JN16CS016,15CS754,20,40,60,P,7,12020,Regular
4JN16CS016,15CSL76,20,70,90,P,10,12020,Regular
4JN16CS016,15CSL77,20,74,94,P,10,12020,Regular
4JN16CS016,15CSP78,92,0,92,P,10,12020,Regular
4JN16CS019,15CS71,19,61,80,P,9,12020,Regular
4JN16CS019,15CS72,17,39,56,P,6,12020,Regular
4JN16CS019,15CS73,18,45,63,P,7,12020,Regular
4JN16CS019,15CS744,20,44,64,P,7,12020,Regular
4JN16CS019,15CS754,19,47,66,P,7,12020,Regular
4JN16CS019,15CSL76,20,72,92,P,10,12020,Regular
4JN16CS019,15CSL77,19,72,91,P,10,12020,Regular
4JN16CS019,15CSP78,96,0,96,P,10,12020,Regular
4JN16CS020,15CS71,18,52,70,P,8,12020,Regular
4JN16CS020,15CS72,16,40,56,P,6,12020,Regular
4JN16CS020,15CS73,14,28,42,P,4,12020,Regular
4JN16CS020,15CS754,20,58,78,P,8,12020,Regular
4JN16CS020,15CS744,17,41,58,P,6,12020,Regular
4JN16CS020,15CSL76,18,74,92,P,10,12020,Regular
4JN16CS020,15CSL77,19,60,79,P,8,12020,Regular
4JN16CS020,15CSP78,93,0,93,P,10,12020,Regular
4JN16CS021,15CS71,19,56,75,P,8,12020,Regular
4JN16CS021,15CS72,17,45,62,P,7,12020,Regular
4JN16CS021,15CS73,15,62,77,P,8,12020,Regular
4JN16CS021,15CS754,20,45,65,P,7,12020,Regular
4JN16CS021,15CS744,18,67,85,P,9,12020,Regular
4JN16CS021,15CSL76,20,74,94,P,10,12020,Regular
4JN16CS021,15CSL77,19,75,94,P,10,12020,Regular
4JN16CS021,15CSP78,95,0,95,P,10,12020,Regular
4JN16CS022,15CS71,19,45,64,P,7,12020,Regular
4JN16CS022,15CS72,17,48,65,P,7,12020,Regular
4JN16CS022,15CS73,16,31,47,P,5,12020,Regular
4JN16CS022,15CS754,20,44,64,P,7,12020,Regular
4JN16CS022,15CS744,20,34,54,P,6,12020,Regular
4JN16CS022,15CSL76,19,75,94,P,10,12020,Regular
4JN16CS022,15CSL77,20,75,95,P,10,12020,Regular
4JN16CS022,15CSP78,96,0,96,P,10,12020,Regular
4JN16CS023,15CS71,20,70,90,P,10,12020,Regular
4JN16CS023,15CS72,20,31,51,P,6,12020,Regular
4JN16CS023,15CS73,20,52,72,P,8,12020,Regular
4JN16CS023,15CS744,20,53,73,P,8,12020,Regular
4JN16CS023,15CS754,20,53,73,P,8,12020,Regular
4JN16CS023,15CSL76,17,75,92,P,10,12020,Regular
4JN16CS023,15CSL77,20,73,93,P,10,12020,Regular
4JN16CS023,15CSP78,96,0,96,P,10,12020,Regular
4JN16CS024,15CS71,20,44,64,P,7,12020,Regular
4JN16CS024,15CS72,20,46,66,P,7,12020,Regular
4JN16CS024,15CS73,18,47,65,P,7,12020,Regular
4JN16CS024,15CS754,20,43,63,P,7,12020,Regular
4JN16CS024,15CS744,19,52,71,P,8,12020,Regular
4JN16CS024,15CSL76,20,65,85,P,9,12020,Regular
4JN16CS024,15CSL77,19,74,93,P,10,12020,Regular
4JN16CS024,15CSP78,94,0,94,P,10,12020,Regular
4JN16CS027,15CS71,19,51,70,P,8,12020,Regular
4JN16CS027,15CS72,18,45,63,P,7,12020,Regular
4JN16CS027,15CS73,17,45,62,P,7,Jan-20,
4JN16CS027,15CS754,18,42,60,P,7,Jan-20,
4JN16CS027,15CS744,15,56,71,P,8,12020,Regular
4JN16CS027,15CSL76,20,74,94,P,10,12020,Regular
4JN16CS027,15CSL77,18,74,92,P,10,12020,Regular
4JN16CS027,15CSP78,95,0,95,P,10,12020,Regular
4JN16CS028,15CS71,20,59,79,P,8,12020,Regular
4JN16CS028,15CS72,19,34,53,P,6,12020,Regular
4JN16CS028,15CS73,20,60,80,P,9,12020,Regular
4JN16CS028,15CS754,20,51,71,P,8,12020,Regular
4JN16CS028,15CS744,20,46,66,P,7,12020,Regular
4JN16CS028,15CSL76,20,73,93,P,10,12020,Regular
4JN16CS028,15CSL77,20,72,92,P,10,12020,Regular
4JN16CS028,15CSP78,96,0,96,P,10,12020,Regular
4JN16CS029,15CS71,19,58,77,P,8,12020,Regular
4JN16CS029,15CS72,20,42,62,P,7,12020,Regular
4JN16CS029,15CS73,19,44,63,P,7,12020,Regular
4JN16CS029,15CS754,19,50,69,P,7,12020,Regular
4JN16CS029,15CS744,19,41,60,P,7,12020,Regular
4JN16CS029,15CSL76,20,60,80,P,9,12020,Regular
4JN16CS029,15CSL77,19,75,94,P,10,12020,Regular
4JN16CS029,15CSP78,92,0,92,P,10,12020,Regular
4JN16CS030,15CS71,20,47,67,P,7,12020,Regular
4JN16CS030,15CS72,19,44,63,P,7,12020,Regular
4JN16CS030,15CS73,20,59,79,P,8,12020,Regular
4JN16CS030,15CS754,20,45,65,P,7,12020,Regular
4JN16CS030,15CS744,19,62,81,P,9,12020,Regular
4JN16CS030,15CSL76,20,70,90,P,10,12020,Regular
4JN16CS030,15CSL77,20,74,94,P,10,12020,Regular
4JN16CS030,15CSP78,97,0,97,P,10,12020,Regular
4JN16CS032,15CS71,18,58,76,P,8,12020,Regular
4JN16CS032,15CS72,15,28,43,P,4,12020,Regular
4JN16CS032,15CS73,15,46,61,P,7,12020,Regular
4JN16CS032,15CS754,19,50,69,P,7,12020,Regular
4JN16CS032,15CS744,18,46,64,P,7,12020,Regular
4JN16CS032,15CSL76,17,60,77,P,8,12020,Regular
4JN16CS032,15CSL77,19,73,92,P,10,12020,Regular
4JN16CS032,15CSP78,93,0,93,P,10,12020,Regular
4JN16CS034,15CS71,19,45,64,P,7,12020,Regular
4JN16CS034,15CS72,19,28,47,P,5,12020,Regular
4JN16CS034,15CS73,15,34,49,P,5,12020,Regular
4JN16CS034,15CS754,17,48,65,P,7,12020,Regular
4JN16CS034,15CS744,16,46,62,P,7,12020,Regular
4JN16CS034,15CSL76,20,74,94,P,10,12020,Regular
4JN16CS034,15CSL77,20,72,92,P,10,12020,Regular
4JN16CS034,15CSP78,96,0,96,P,10,12020,Regular
4JN16CS036,15CS71,14,38,52,P,6,12020,Regular
4JN16CS036,15CS72,20,36,56,P,6,12020,Regular
4JN16CS036,15CS73,14,37,51,P,6,12020,Regular
4JN16CS036,15CS754,17,54,71,P,8,12020,Regular
4JN16CS036,15CS744,15,51,66,P,7,12020,Regular
4JN16CS036,15CSL76,16,41,57,P,6,12020,Regular
4JN16CS036,15CSL77,19,62,81,P,9,12020,Regular
4JN16CS036,15CSP78,89,0,89,P,9,12020,Regular
4JN16CS037,15CS71,18,47,65,P,7,Jan-20,
4JN16CS037,15CS72,19,36,55,P,6,12020,Regular
4JN16CS037,15CS73,18,39,57,P,6,12020,Regular
4JN16CS037,15CS744,19,52,71,P,8,12020,Regular
4JN16CS037,15CS754,17,56,73,P,8,12020,Regular
4JN16CS037,15CSL76,4,0,4,X,0,12020,Regular
4JN16CS037,15CSL77,20,76,96,P,10,12020,Regular
4JN16CS037,15CSP78,94,0,94,P,10,12020,Regular
4JN16CS041,15CS71,18,41,59,P,6,12020,Regular
4JN16CS041,15CS72,17,43,60,P,7,12020,Regular
4JN16CS041,15CS73,13,39,52,P,6,12020,Regular
4JN16CS041,15CS754,13,0,13,A,0,12020,Regular
4JN16CS041,15CS744,14,41,55,P,6,12020,Regular
4JN16CS041,15CSL76,20,50,70,P,8,12020,Regular
4JN16CS041,15CSL77,17,63,80,P,9,12020,Regular
4JN16CS041,15CSP78,94,0,94,P,10,12020,Regular
4JN16CS044,15CS71,20,46,66,P,7,12020,Regular
4JN16CS044,15CS72,20,53,73,P,8,12020,Regular
4JN16CS044,15CS73,19,40,59,P,6,12020,Regular
4JN16CS044,15CS754,20,44,64,P,7,12020,Regular
4JN16CS044,15CS744,20,49,69,P,7,12020,Regular
4JN16CS044,15CSL76,20,55,75,P,8,12020,Regular
4JN16CS044,15CSL77,20,75,95,P,10,12020,Regular
4JN16CS044,15CSP78,95,0,95,P,10,12020,Regular
4JN16CS046,15CS71,16,37,53,P,6,12020,Regular
4JN16CS046,15CS72,14,38,52,P,6,12020,Regular
4JN16CS046,15CS73,13,45,58,P,6,12020,Regular
4JN16CS046,15CS754,19,62,81,P,9,12020,Regular
4JN16CS046,15CS744,19,45,64,P,7,12020,Regular
4JN16CS046,15CSL76,19,60,79,P,8,12020,Regular
4JN16CS046,15CSL77,19,63,82,P,9,12020,Regular
4JN16CS046,15CSP78,95,0,95,P,10,12020,Regular
4JN16CS051,15CS71,19,58,77,P,8,12020,Regular
4JN16CS051,15CS72,20,56,76,P,8,12020,Regular
4JN16CS051,15CS73,19,55,74,P,8,12020,Regular
4JN16CS051,15CS744,20,68,88,P,9,12020,Regular
4JN16CS051,15CS754,20,53,73,P,8,12020,Regular
4JN16CS051,15CSL76,20,74,94,P,10,12020,Regular
4JN16CS051,15CSL77,20,75,95,P,10,12020,Regular
4JN16CS051,15CSP78,96,0,96,P,10,12020,Regular
4JN16CS053,15CS71,19,58,77,P,8,12020,Regular
4JN16CS053,15CS72,18,38,56,P,6,12020,Regular
4JN16CS053,15CS73,20,64,84,P,9,12020,Regular
4JN16CS053,15CS754,20,44,64,P,7,12020,Regular
4JN16CS053,15CS744,20,58,78,P,8,12020,Regular
4JN16CS053,15CSL76,18,77,95,P,10,12020,Regular
4JN16CS053,15CSL77,20,77,97,P,10,12020,Regular
4JN16CS053,15CSP78,95,0,95,P,10,12020,Regular
4JN16CS054,15CS71,20,42,62,P,7,12020,Regular
4JN16CS054,15CS72,20,51,71,P,8,12020,Regular
4JN16CS054,15CS73,20,43,63,P,7,12020,Regular
4JN16CS054,15CS754,20,47,67,P,7,12020,Regular
4JN16CS054,15CS744,20,45,65,P,7,12020,Regular
4JN16CS054,15CSL76,20,60,80,P,9,12020,Regular
4JN16CS054,15CSL77,20,74,94,P,10,12020,Regular
4JN16CS054,15CSP78,97,0,97,P,10,12020,Regular
4JN16CS055,15CS71,16,29,45,P,5,12020,Regular
4JN16CS055,15CS72,17,45,62,P,7,12020,Regular
4JN16CS055,15CS73,16,47,63,P,7,12020,Regular
4JN16CS055,15CS754,16,47,63,P,7,12020,Regular
4JN16CS055,15CS744,19,49,68,P,7,12020,Regular
4JN16CS055,15CSL76,16,60,76,P,8,12020,Regular
4JN16CS055,15CSL77,16,63,79,P,8,12020,Regular
4JN16CS055,15CSP78,90,0,90,P,10,12020,Regular
4JN16CS057,15CS71,19,31,50,P,6,12020,Regular
4JN16CS057,15CS72,16,28,44,P,4,12020,Regular
4JN16CS057,15CS73,13,46,59,P,6,12020,Regular
4JN16CS057,15CS744,16,44,60,P,7,12020,Regular
4JN16CS057,15CS754,15,63,78,P,8,12020,Regular
4JN16CS057,15CSL76,16,60,76,P,8,12020,Regular
4JN16CS057,15CSL77,19,64,83,P,9,12020,Regular
4JN16CS057,15CSP78,85,0,85,P,9,12020,Regular
4JN16CS058,15CS71,18,41,59,P,6,12020,Regular
4JN16CS058,15CS72,17,33,50,P,6,12020,Regular
4JN16CS058,15CS73,19,43,62,P,7,12020,Regular
4JN16CS058,15CS754,20,39,59,P,6,12020,Regular
4JN16CS058,15CS744,17,40,57,P,6,12020,Regular
4JN16CS058,15CSL76,18,72,90,P,10,12020,Regular
4JN16CS058,15CSL77,19,76,95,P,10,12020,Regular
4JN16CS058,15CSP78,95,0,95,P,10,12020,Regular
4JN16CS059,15CS71,18,50,68,P,7,12020,Regular
4JN16CS059,15CS72,20,34,54,P,6,12020,Regular
4JN16CS059,15CS73,15,54,69,P,7,12020,Regular
4JN16CS059,15CS754,20,61,81,P,9,12020,Regular
4JN16CS059,15CS744,18,55,73,P,8,12020,Regular
4JN16CS059,15CSL76,20,65,85,P,9,12020,Regular
4JN16CS059,15CSL77,20,71,91,P,10,12020,Regular
4JN16CS059,15CSP78,96,0,96,P,10,12020,Regular
4JN16CS062,15CS71,17,34,51,P,6,12020,Regular
4JN16CS062,15CS72,13,28,41,P,4,12020,Regular
4JN16CS062,15CS73,14,28,42,P,4,12020,Regular
4JN16CS062,15CS744,14,28,42,P,4,12020,Regular
4JN16CS062,15CS754,15,28,43,P,4,12020,Regular
4JN16CS062,15CSL76,18,12,30,F,0,12020,Regular
4JN16CS062,15CSL77,19,63,82,P,9,12020,Regular
4JN16CS062,15CSP78,95,0,95,P,10,12020,Regular
4JN16CS064,15CS71,19,41,60,P,7,12020,Regular
4JN16CS064,15CS72,19,29,48,P,5,12020,Regular
4JN16CS064,15CS73,18,57,75,P,8,12020,Regular
4JN16CS064,15CS754,20,42,62,P,7,12020,Regular
4JN16CS064,15CS744,19,44,63,P,7,12020,Regular
4JN16CS064,15CSL76,20,55,75,P,8,12020,Regular
4JN16CS064,15CSL77,18,74,92,P,10,12020,Regular
4JN16CS064,15CSP78,92,0,92,P,10,12020,Regular
4JN16CS074,15CS71,19,58,77,P,8,12020,Regular
4JN16CS074,15CS72,20,35,55,P,6,12020,Regular
4JN16CS074,15CS73,20,49,69,P,7,Jan-20,
4JN16CS074,15CS744,20,50,70,P,8,Jan-20,
4JN16CS074,15CS754,20,49,69,P,7,Jan-20,
4JN16CS074,15CSL76,19,72,91,P,10,12020,Regular
4JN16CS074,15CSL77,19,74,93,P,10,12020,Regular
4JN16CS074,15CSP78,96,0,96,P,10,12020,Regular
4JN16CS075,15CS71,20,64,84,P,9,12020,Regular
4JN16CS075,15CS72,20,46,66,P,7,12020,Regular
4JN16CS075,15CS73,20,53,73,P,8,12020,Regular
4JN16CS075,15CS754,20,57,77,P,8,12020,Regular
4JN16CS075,15CS744,20,57,77,P,8,12020,Regular
4JN16CS075,15CSL76,20,74,94,P,10,12020,Regular
4JN16CS075,15CSL77,20,73,93,P,10,12020,Regular
4JN16CS075,15CSP78,96,0,96,P,10,12020,Regular
4JN16CS078,15CS71,19,54,73,P,8,12020,Regular
4JN16CS078,15CS72,18,32,50,P,6,12020,Regular
4JN16CS078,15CS73,13,46,59,P,6,12020,Regular
4JN16CS078,15CS754,19,55,74,P,8,12020,Regular
4JN16CS078,15CS744,17,45,62,P,7,12020,Regular
4JN16CS078,15CSL76,20,42,62,P,7,12020,Regular
4JN16CS078,15CSL77,16,71,87,P,9,12020,Regular
4JN16CS078,15CSP78,95,0,95,P,10,12020,Regular
4JN16CS079,15CS71,17,45,62,P,7,12020,Regular
4JN16CS079,15CS72,17,37,54,P,6,12020,Regular
4JN16CS079,15CS73,14,59,73,P,8,12020,Regular
4JN16CS079,15CS744,17,55,72,P,8,12020,Regular
4JN16CS079,15CS754,18,35,53,P,6,12020,Regular
4JN16CS079,15CSL76,16,46,62,P,7,12020,Regular
4JN16CS079,15CSL77,19,75,94,P,10,12020,Regular
4JN16CS079,15CSP78,85,0,85,P,9,12020,Regular
4JN16CS082,15CS71,19,39,58,P,6,12020,Regular
4JN16CS082,15CS72,17,54,71,P,8,12020,Regular
4JN16CS082,15CS73,16,51,67,P,7,12020,Regular
4JN16CS082,15CS754,16,50,66,P,7,12020,Regular
4JN16CS082,15CS744,15,52,67,P,7,12020,Regular
4JN16CS082,15CSL76,19,65,84,P,9,12020,Regular
4JN16CS082,15CSL77,19,75,94,P,10,12020,Regular
4JN16CS082,15CSP78,91,0,91,P,10,12020,Regular
4JN16CS084,15CS71,20,53,73,P,8,12020,Regular
4JN16CS084,15CS72,20,44,64,P,7,12020,Regular
4JN16CS084,15CS73,20,68,88,P,9,12020,Regular
4JN17CS425,15CS81,20,59,79,P,8,Jul-20,Regular
4JN17CS425,15CS832,20,66,86,P,9,Jul-20,Regular
4JN17CS425,15CS82,19,43,62,P,7,Jul-20,Regular
4JN17CS425,15CS84,48,47,95,P,10,Jul-20,Regular
4JN17CS425,15CSP85,92,95,187,P,10,Jul-20,Regular
4JN17CS425,15CSS86,90,0,90,P,10,Jul-20,Regular
4JN17CS426,15CS61,48,22,70,P,8,Jul-20,Regular
4JN17CS426,15CS62,50,22,72,P,8,Jul-20,Regular
4JN17CS426,15CS653,50,22,72,P,8,Jul-20,Regular
4JN17CS426,15CS63,40,22,62,P,7,Jul-20,Regular
4JN17CS426,15CS64,45,22,67,P,7,Jul-20,Regular
4JN17CS426,15CS664,45,22,67,P,7,Jul-20,Regular
4JN17CS426,15CSL67,45,22,67,P,7,Jul-20,Regular
4JN17CS426,15CSL68,50,22,72,P,8,Jul-20,Regular
4JN14CS133,15CS81,17,44,61,P,7,Jul-20,Regular
4JN14CS133,15CS832,15,41,56,P,6,Jul-20,Regular
4JN14CS133,15CS82,19,50,69,P,7,Jul-20,Regular
4JN14CS133,15CS84,46,46,92,P,10,Jul-20,Regular
4JN14CS133,15CSP85,90,89,179,P,10,Jul-20,Regular
4JN14CS133,15CSS86,89,0,89,P,9,Jul-20,Regular
4JN14CS133,15CS71,14,36,50,P,6,Jul-20,Backlog
4JN14CS133,15CSL76,14,44,58,P,6,Jul-20,Backlog
4JN17CS423,15CS81,20,42,62,P,7,Jul-20,Regular
4JN17CS423,15CS832,18,54,72,P,8,Jul-20,Regular
4JN17CS423,15CS82,19,54,73,P,8,Jul-20,Regular
4JN17CS423,15CS84,48,47,95,P,10,Jul-20,Regular
4JN17CS423,15CSP85,97,96,193,P,10,Jul-20,Regular
4JN17CS423,15CSS86,96,0,96,P,10,Jul-20,Regular
4JN15CS118,15CS61,48,20,68,P,7,Jul-20,Regular
4JN15CS118,15CS62,48,20,68,P,7,Jul-20,Regular
4JN15CS118,15CS63,43,20,63,P,7,Jul-20,Regular
4JN15CS118,15CS664,43,20,63,P,7,Jul-20,Regular
4JN15CS118,15CS654,43,20,63,P,7,Jul-20,Regular
4JN15CS118,15CS64,45,20,65,P,7,Jul-20,Regular
4JN15CS118,15CSL67,43,20,63,P,7,Jul-20,Regular
4JN15CS118,15CSL68,48,20,68,P,7,Jul-20,Regular
4JN17CS416,15CS81,20,34,54,P,6,Jul-20,Regular
4JN17CS416,15CS832,19,52,71,P,8,Jul-20,Regular
4JN17CS416,15CS82,19,42,61,P,7,Jul-20,Regular
4JN17CS416,15CS84,45,49,94,P,10,Jul-20,Regular
4JN17CS416,15CSP85,92,90,182,P,10,Jul-20,Regular
4JN17CS416,15CSS86,96,0,96,P,10,Jul-20,Regular
4JN17CS416,15CS71,17,28,45,P,5,Jul-20,Backlog
4JN17CS416,15CSL76,18,50,68,P,7,Jul-20,Backlog
4JN15CS096,15CS61,50,15,65,P,7,Jul-20,Regular
4JN15CS096,15CS62,48,15,63,P,7,Jul-20,Regular
4JN15CS096,15CS63,45,15,60,P,7,Jul-20,Regular
4JN15CS096,15CS664,45,15,60,P,7,Jul-20,Regular
4JN15CS096,15CS654,48,15,63,P,7,Jul-20,Regular
4JN15CS096,15CS64,43,15,58,P,6,Jul-20,Regular
4JN15CS096,15CSL67,45,15,60,P,7,Jul-20,Regular
4JN15CS096,15CSL68,48,15,63,P,7,Jul-20,Regular
4JN15CS106,15CS61,48,22,70,P,8,Jul-20,Regular
4JN15CS106,15CS62,48,22,70,P,8,Jul-20,Regular
4JN15CS106,15CS63,50,22,72,P,8,Jul-20,Regular
4JN15CS106,15CS664,45,22,67,P,7,Jul-20,Regular
4JN15CS106,15CS654,50,22,72,P,8,Jul-20,Regular
4JN15CS106,15CS64,45,22,67,P,7,Jul-20,Regular
4JN15CS106,15CSL67,45,22,67,P,7,Jul-20,Regular
4JN15CS106,15CSL68,48,22,70,P,8,Jul-20,Regular
4JN14CS091,15CS61,50,22,72,P,8,Jul-20,Regular
4JN14CS091,15CS62,50,22,72,P,8,Jul-20,Regular
4JN14CS091,15CS653,50,22,72,P,8,Jul-20,Regular
4JN14CS091,15CS63,50,22,72,P,8,Jul-20,Regular
4JN14CS091,15CS664,43,22,65,P,7,Jul-20,Regular
4JN14CS091,15CS64,50,22,72,P,8,Jul-20,Regular
4JN14CS091,15CSL67,45,22,67,P,7,Jul-20,Regular
4JN14CS091,15CSL68,50,22,72,P,8,Jul-20,Regular
4JN17CS415,15CS61,48,24,72,P,8,Jul-20,Regular
4JN17CS415,15CS62,50,24,74,P,8,Jul-20,Regular
4JN17CS415,15CS653,50,24,74,P,8,Jul-20,Regular
4JN17CS415,15CS63,40,24,64,P,7,Jul-20,Regular
4JN17CS415,15CS664,43,24,67,P,7,Jul-20,Regular
4JN17CS415,15CS64,45,24,69,P,7,Jul-20,Regular
4JN17CS415,15CSL67,45,24,69,P,7,Jul-20,Regular
4JN17CS415,15CSL68,50,24,74,P,8,Jul-20,Regular
4JN17CS421,15CS61,48,23,71,P,8,Jul-20,Regular
4JN17CS421,15CS62,50,23,73,P,8,Jul-20,Regular
4JN17CS421,15CS653,48,23,71,P,8,Jul-20,Regular
4JN17CS421,15CS63,35,23,58,P,6,Jul-20,Regular
4JN17CS421,15CS64,45,23,68,P,7,Jul-20,Regular
4JN17CS421,15CS664,45,23,68,P,7,Jul-20,Regular
4JN17CS421,15CSL67,45,23,68,P,7,Jul-20,Regular
4JN17CS421,15CSL68,50,23,73,P,8,Jul-20,Regular
4JN16CS133,15CS61,48,22,70,P,8,Jul-20,Regular
4JN16CS133,15CS62,45,22,67,P,7,Jul-20,Regular
4JN16CS133,15CS63,45,22,67,P,7,Jul-20,Regular
4JN16CS133,15CS664,43,22,65,P,7,Jul-20,Regular
4JN16CS133,15CS654,45,22,67,P,7,Jul-20,Regular
4JN16CS133,15CS64,45,22,67,P,7,Jul-20,Regular
4JN16CS133,15CSL67,45,22,67,P,7,Jul-20,Regular
4JN16CS133,15CSL68,48,22,70,P,8,Jul-20,Regular
4JN16CS116,15CS81,18,30,48,P,5,20-Jul,Regular
4JN16CS116,15CS82,19,41,60,P,7,20-Jul,Regular
4JN16CS116,15CS84,47,45,92,P,10,Jul-20,Regular
4JN16CS116,15CS834,19,28,47,P,5,Jul-20,Regular
4JN16CS116,15CSP85,92,96,188,P,10,Jul-20,Regular
4JN16CS116,15CSS86,99,0,99,P,10,Jul-20,Regular
4JN16CS116,15CS71,13,36,49,P,5,Jul-20,Backlog
4JN16CS116,15CS72,14,28,42,P,4,Jul-20,Backlog
4JN16CS116,15CS73,13,28,41,P,4,Jul-20,Backlog
4JN14CS092,15CS81,20,52,72,P,8,Jul-20,Regular
4JN14CS092,15CS82,19,46,65,P,7,Jul-20,Regular
4JN14CS092,15CS84,46,47,93,P,10,Jul-20,Regular
4JN14CS092,15CS834,16,32,48,P,5,Jul-20,Regular
4JN14CS092,15CSP85,90,93,183,P,10,Jul-20,Regular
4JN14CS092,15CSS86,86,0,86,P,9,Jul-20,Regular
4JN14CS092,15CSL76,14,44,58,P,6,Jul-20,Backlog
4JN15CS049,15CS81,19,51,70,P,8,Jul-20,Regular
4JN15CS049,15CS82,19,48,67,P,7,Jul-20,Regular
4JN15CS049,15CS84,48,48,96,P,10,Jul-20,Regular
4JN15CS049,15CS834,17,28,45,P,5,Jul-20,Regular
4JN15CS049,15CSP85,90,93,183,P,10,Jul-20,Regular
4JN15CS049,15CSS86,88,0,88,P,9,Jul-20,Regular
4JN15CS049,15CS72,14,16,30,F,0,20-Jul,Backlog
4JN15CS049,15CSL76,14,44,58,P,6,Jul-20,Backlog
4JN17CS408,15CS81,19,45,64,P,7,Jul-20,Regular
4JN17CS408,15CS82,19,44,63,P,7,Jul-20,Regular
4JN17CS408,15CS84,48,48,96,P,10,Jul-20,Regular
4JN17CS408,15CS834,17,30,47,P,5,Jul-20,Regular
4JN17CS408,15CSP85,95,93,188,P,10,Jul-20,Regular
4JN17CS408,15CSS86,87,0,87,P,9,Jul-20,Regular
4JN17CS408,15CS72,16,28,44,P,4,Jul-20,Backlog
4JN17CS408,15CS73,15,22,37,F,0,20-Jul,Backlog
4JN17CS414,15CS81,20,48,68,P,7,Jul-20,Regular
4JN17CS414,15CS82,19,28,47,P,5,Jul-20,Regular
4JN17CS414,15CS834,17,34,51,P,6,Jul-20,Regular
4JN17CS414,15CS84,48,49,97,P,10,Jul-20,Regular
4JN17CS414,15CSP85,94,94,188,P,10,Jul-20,Regular
4JN17CS414,15CSS86,92,0,92,P,10,Jul-20,Regular
4JN17CS414,15CS72,16,28,44,P,4,Jul-20,Backlog
4JN17CS414,15CS73,12,28,40,P,4,Jul-20,Backlog
4JN16CS067,15CS81,19,32,51,P,6,Jul-20,Regular
4JN16CS067,15CS82,19,51,70,P,8,Jul-20,Regular
4JN16CS067,15CS84,46,47,93,P,10,Jul-20,Regular
4JN16CS067,15CS834,18,31,49,P,5,Jul-20,Regular
4JN16CS067,15CSP85,91,90,181,P,10,Jul-20,Regular
4JN16CS067,15CSS86,92,0,92,P,10,Jul-20,Regular
4JN16CS067,15CS72,14,28,42,P,4,Jul-20,Backlog
4JN16CS067,15CSL76,14,55,69,P,7,Jul-20,Backlog
4JN16CS071,15CS81,20,36,56,P,6,Jul-20,Regular
4JN16CS071,15CS82,19,48,67,P,7,Jul-20,Regular
4JN16CS071,15CS84,48,48,96,P,10,Jul-20,Regular
4JN16CS071,15CS834,18,37,55,P,6,Jul-20,Regular
4JN16CS071,15CSP85,95,94,189,P,10,Jul-20,Regular
4JN16CS071,15CSS86,97,0,97,P,10,Jul-20,Regular
4JN16CS071,15CS72,14,28,42,P,4,20-Jul,Backlog
4JN16CS121,15CS81,20,35,55,P,6,Jul-20,Regular
4JN16CS121,15CS82,19,32,51,P,6,Jul-20,Regular
4JN16CS121,15CS84,47,46,93,P,10,Jul-20,Regular
4JN16CS121,15CS834,19,19,38,F,0,20-Jul,Regular
4JN16CS121,15CSP85,94,95,189,P,10,Jul-20,Regular
4JN16CS121,15CSS86,91,0,91,P,10,Jul-20,Regular
4JN16CS121,15CS72,15,33,48,P,5,Jul-20,Backlog
4JN17CS411,15CS81,19,43,62,P,7,Jul-20,Regular
4JN17CS411,15CS82,19,42,61,P,7,Jul-20,Regular
4JN17CS411,15CS84,49,49,98,P,10,Jul-20,Regular
4JN17CS411,15CS834,17,39,56,P,6,Jul-20,Regular
4JN17CS411,15CSP85,96,98,194,P,10,Jul-20,Regular
4JN17CS411,15CSS86,97,0,97,P,10,Jul-20,Regular
4JN17CS411,15CS73,15,34,49,P,5,Jul-20,Backlog
4JN15CS041,15CS81,20,50,70,P,8,Jul-20,Regular
4JN15CS041,15CS82,19,32,51,P,6,Jul-20,Regular
4JN15CS041,15CS84,48,48,96,P,10,Jul-20,Regular
4JN15CS041,15CS834,17,38,55,P,6,Jul-20,Regular
4JN15CS041,15CSP85,90,94,184,P,10,Jul-20,Regular
4JN15CS041,15CSS86,93,0,93,P,10,Jul-20,Regular
4JN15CS041,15CS744,18,30,48,P,5,Jul-20,Backlog
4JN16CS041,15CS81,19,52,71,P,8,Jul-20,Regular
4JN16CS041,15CS832,20,60,80,P,9,Jul-20,Regular
4JN16CS041,15CS82,19,45,64,P,7,Jul-20,Regular
4JN16CS041,15CS84,47,48,95,P,10,Jul-20,Regular
4JN16CS041,15CSP85,96,99,195,P,10,Jul-20,Regular
4JN16CS041,15CSS86,98,0,98,P,10,Jul-20,Regular
4JN16CS041,15CS754,13,29,42,P,4,Jul-20,Backlog
4JN16CS005,15CS81,20,44,64,P,7,Jul-20,Regular
4JN16CS005,15CS832,18,62,80,P,9,Jul-20,Regular
4JN16CS005,15CS82,19,44,63,P,7,Jul-20,Regular
4JN16CS005,15CS84,48,47,95,P,10,Jul-20,Regular
4JN16CS005,15CSP85,96,97,193,P,10,Jul-20,Regular
4JN16CS005,15CSS86,96,0,96,P,10,Jul-20,Regular
4JN16CS005,15CSL76,14,55,69,P,7,Jul-20,Backlog
4JN16CS105,15CS81,18,45,63,P,7,Jul-20,Regular
4JN16CS105,15CS832,17,66,83,P,9,Jul-20,Regular
4JN16CS105,15CS82,19,46,65,P,7,Jul-20,Regular
4JN16CS105,15CS84,46,48,94,P,10,Jul-20,Regular
4JN16CS105,15CSP85,93,90,183,P,10,Jul-20,Regular
4JN16CS105,15CSS86,90,0,90,P,10,Jul-20,Regular
4JN16CS105,15CSL76,14,54,68,P,7,Jul-20,Backlog
4JN16CS117,15CS81,19,38,57,P,6,Jul-20,Regular
4JN16CS117,15CS832,17,63,80,P,9,Jul-20,Regular
4JN16CS117,15CS82,19,43,62,P,7,Jul-20,Regular
4JN16CS117,15CS84,47,49,96,P,10,Jul-20,Regular
4JN16CS117,15CSP85,90,96,186,P,10,Jul-20,Regular
4JN16CS117,15CSS86,95,0,95,P,10,Jul-20,Regular
4JN16CS117,15CSL76,15,52,67,P,7,Jul-20,Backlog
4JN17CS401,15CS81,19,42,61,P,7,Jul-20,Regular
4JN17CS401,15CS832,19,56,75,P,8,Jul-20,Regular
4JN17CS401,15CS82,19,54,73,P,8,Jul-20,Regular
4JN17CS401,15CS84,47,47,94,P,10,Jul-20,Regular
4JN17CS401,15CSP85,90,89,179,P,10,Jul-20,Regular
4JN17CS401,15CSS86,93,0,93,P,10,Jul-20,Regular
4JN17CS401,15CSL76,14,51,65,P,7,Jul-20,Backlog
4JN14CS002,15CS81,20,43,63,P,7,Jul-20,Regular
4JN14CS002,15CS832,20,65,85,P,9,Jul-20,Regular
4JN14CS002,15CS82,19,38,57,P,6,Jul-20,Regular
4JN14CS002,15CS84,48,47,95,P,10,Jul-20,Regular
4JN14CS002,15CSP85,92,86,178,P,10,Jul-20,Regular
4JN14CS002,15CSS86,90,0,90,P,10,Jul-20,Regular
4JN16CS036,15CS81,19,51,70,P,8,Jul-20,Regular
4JN16CS036,15CS832,17,64,81,P,9,Jul-20,Regular
4JN16CS036,15CS82,19,42,61,P,7,Jul-20,Regular
4JN16CS036,15CS84,46,49,95,P,10,Jul-20,Regular
4JN16CS036,15CSP85,90,94,184,P,10,Jul-20,Regular
4JN16CS036,15CSS86,97,0,97,P,10,Jul-20,Regular
4JN16CS044,15CS81,20,45,65,P,7,Jul-20,Regular
4JN16CS044,15CS832,20,68,88,P,9,Jul-20,Regular
4JN16CS044,15CS82,19,69,88,P,9,Jul-20,Regular
4JN16CS044,15CS84,46,49,95,P,10,Jul-20,Regular
4JN16CS044,15CSP85,94,93,187,P,10,Jul-20,Regular
4JN16CS044,15CSS86,96,0,96,P,10,Jul-20,Regular
4JN16CS045,15CS81,20,34,54,P,6,Jul-20,Regular
4JN16CS045,15CS832,17,55,72,P,8,Jul-20,Regular
4JN16CS045,15CS82,19,52,71,P,8,Jul-20,Regular
4JN16CS045,15CS84,46,46,92,P,10,Jul-20,Regular
4JN16CS045,15CSP85,92,90,182,P,10,Jul-20,Regular
4JN16CS045,15CSS86,93,0,93,P,10,Jul-20,Regular
4JN16CS047,15CS81,20,35,55,P,6,Jul-20,Regular
4JN16CS047,15CS832,19,62,81,P,9,Jul-20,Regular
4JN16CS047,15CS82,19,45,64,P,7,Jul-20,Regular
4JN16CS047,15CS84,46,47,93,P,10,Jul-20,Regular
4JN16CS047,15CSP85,90,89,179,P,10,Jul-20,Regular
4JN16CS047,15CSS86,93,0,93,P,10,Jul-20,Regular
4JN16CS082,15CS81,19,44,63,P,7,Jul-20,Regular
4JN16CS082,15CS832,17,53,70,P,8,Jul-20,Regular
4JN16CS082,15CS82,19,54,73,P,8,Jul-20,Regular
4JN16CS082,15CS84,46,49,95,P,10,Jul-20,Regular
4JN16CS082,15CSP85,90,96,186,P,10,Jul-20,Regular
4JN16CS082,15CSS86,89,0,89,P,9,Jul-20,Regular
4JN16CS083,15CS81,19,56,75,P,8,Jul-20,Regular
4JN16CS083,15CS832,19,60,79,P,8,Jul-20,Regular
4JN16CS083,15CS82,19,55,74,P,8,Jul-20,Regular
4JN16CS083,15CS84,46,47,93,P,10,Jul-20,Regular
4JN16CS083,15CSP85,92,90,182,P,10,Jul-20,Regular
4JN16CS083,15CSS86,97,0,97,P,10,Jul-20,Regular
4JN16CS087,15CS81,20,44,64,P,7,Jul-20,Regular
4JN16CS087,15CS832,20,66,86,P,9,Jul-20,Regular
4JN16CS087,15CS82,19,39,58,P,6,Jul-20,Regular
4JN16CS087,15CS84,48,49,97,P,10,Jul-20,Regular
4JN16CS087,15CSP85,92,93,185,P,10,Jul-20,Regular
4JN16CS087,15CSS86,96,0,96,P,10,Jul-20,Regular
4JN16CS101,15CS81,19,37,56,P,6,Jul-20,Regular
4JN16CS101,15CS832,19,67,86,P,9,Jul-20,Regular
4JN16CS101,15CS82,19,48,67,P,7,Jul-20,Regular
4JN16CS101,15CS84,47,48,95,P,10,Jul-20,Regular
4JN16CS101,15CSP85,93,92,185,P,10,Jul-20,Regular
4JN16CS101,15CSS86,97,0,97,P,10,Jul-20,Regular
4JN16CS109,15CS81,19,40,59,P,6,Jul-20,Regular
4JN16CS109,15CS832,17,57,74,P,8,Jul-20,Regular
4JN16CS109,15CS82,19,46,65,P,7,Jul-20,Regular
4JN16CS109,15CS84,46,48,94,P,10,Jul-20,Regular
4JN16CS109,15CSP85,91,90,181,P,10,Jul-20,Regular
4JN16CS109,15CSS86,95,0,95,P,10,Jul-20,Regular
4JN16CS118,15CS81,20,60,80,P,9,Jul-20,Regular
4JN16CS118,15CS832,19,65,84,P,9,Jul-20,Regular
4JN16CS118,15CS82,19,60,79,P,8,Jul-20,Regular
4JN16CS118,15CS84,45,49,94,P,10,Jul-20,Regular
4JN16CS118,15CSP85,90,93,183,P,10,Jul-20,Regular
4JN16CS118,15CSS86,94,0,94,P,10,Jul-20,Regular
4JN16CS123,15CS81,20,43,63,P,7,Jul-20,Regular
4JN16CS123,15CS832,20,52,72,P,8,Jul-20,Regular
4JN16CS123,15CS82,19,40,59,P,6,Jul-20,Regular
4JN16CS123,15CS84,48,47,95,P,10,Jul-20,Regular
4JN16CS123,15CSP85,90,93,183,P,10,Jul-20,Regular
4JN16CS123,15CSS86,92,0,92,P,10,Jul-20,Regular
4JN16CS130,15CS81,19,63,82,P,9,Jul-20,Regular
4JN16CS130,15CS832,20,67,87,P,9,Jul-20,Regular
4JN16CS130,15CS82,19,59,78,P,8,Jul-20,Regular
4JN16CS130,15CS84,46,49,95,P,10,Jul-20,Regular
4JN16CS130,15CSP85,90,95,185,P,10,Jul-20,Regular
4JN16CS130,15CSS86,95,0,95,P,10,Jul-20,Regular
4JN17CS402,15CS81,20,43,63,P,7,Jul-20,Regular
4JN17CS402,15CS832,19,71,90,P,10,Jul-20,Regular
4JN17CS402,15CS82,19,45,64,P,7,Jul-20,Regular
4JN17CS402,15CS84,46,46,92,P,10,Jul-20,Regular
4JN17CS402,15CSP85,91,89,180,P,10,Jul-20,Regular
4JN17CS402,15CSS86,91,0,91,P,10,Jul-20,Regular
4JN17CS405,15CS81,20,41,61,P,7,Jul-20,Regular
4JN17CS405,15CS832,19,67,86,P,9,Jul-20,Regular
4JN17CS405,15CS82,19,35,54,P,6,Jul-20,Regular
4JN17CS405,15CS84,48,48,96,P,10,Jul-20,Regular
4JN17CS405,15CSP85,92,95,187,P,10,Jul-20,Regular
4JN17CS405,15CSS86,97,0,97,P,10,Jul-20,Regular
4JN17CS413,15CS81,20,49,69,P,7,Jul-20,Regular
4JN17CS413,15CS832,19,65,84,P,9,Jul-20,Regular
4JN17CS413,15CS82,19,65,84,P,9,Jul-20,Regular
4JN17CS413,15CS84,48,48,96,P,10,Jul-20,Regular
4JN17CS413,15CSP85,92,95,187,P,10,Jul-20,Regular
4JN17CS413,15CSS86,95,0,95,P,10,Jul-20,Regular
4JN17CS418,15CS81,20,54,74,P,8,Jul-20,Regular
4JN17CS418,15CS832,19,63,82,P,9,Jul-20,Regular
4JN17CS418,15CS82,19,38,57,P,6,Jul-20,Regular
4JN17CS418,15CS84,48,47,95,P,10,Jul-20,Regular
4JN17CS418,15CSP85,97,96,193,P,10,Jul-20,Regular
4JN17CS418,15CSS86,96,0,96,P,10,Jul-20,Regular
4JN17CS419,15CS81,20,64,84,P,9,Jul-20,Regular
4JN17CS419,15CS832,20,55,75,P,8,Jul-20,Regular
4JN17CS419,15CS82,19,47,66,P,7,Jul-20,Regular
4JN17CS419,15CS84,48,47,95,P,10,Jul-20,Regular
4JN17CS419,15CSP85,97,97,194,P,10,Jul-20,Regular
4JN17CS419,15CSS86,95,0,95,P,10,Jul-20,Regular
4JN17CS427,15CS81,20,52,72,P,8,Jul-20,Regular
4JN17CS427,15CS832,19,62,81,P,9,Jul-20,Regular
4JN17CS427,15CS82,19,60,79,P,8,Jul-20,Regular
4JN17CS427,15CS84,48,47,95,P,10,Jul-20,Regular
4JN17CS427,15CSP85,92,97,189,P,10,Jul-20,Regular
4JN17CS427,15CSS86,96,0,96,P,10,Jul-20,Regular
4JN17CS422,15CS81,20,56,76,P,8,Jul-20,Regular
4JN17CS422,15CS832,19,67,86,P,9,Jul-20,Regular
4JN17CS422,15CS82,19,67,86,P,9,Jul-20,Regular
4JN17CS422,15CS84,47,47,94,P,10,Jul-20,Regular
4JN17CS422,15CSP85,90,90,180,P,10,Jul-20,Regular
4JN17CS422,15CSS86,96,0,96,P,10,Jul-20,Regular
4JN17CS403,15CS81,19,58,77,P,8,Jul-20,Regular
4JN17CS403,15CS832,17,56,73,P,8,Jul-20,Regular
4JN17CS403,15CS82,19,64,83,P,9,Jul-20,Regular
4JN17CS403,15CS84,46,46,92,P,10,Jul-20,Regular
4JN17CS403,15CSP85,91,89,180,P,10,Jul-20,Regular
4JN17CS403,15CSS86,90,0,90,P,10,Jul-20,Regular
4JN17CS412,15CS81,20,54,74,P,8,Jul-20,Regular
4JN17CS412,15CS832,18,51,69,P,7,Jul-20,Regular
4JN17CS412,15CS82,19,58,77,P,8,Jul-20,Regular
4JN17CS412,15CS84,45,48,93,P,10,Jul-20,Regular
4JN17CS412,15CSP85,90,94,184,P,10,Jul-20,Regular
4JN17CS412,15CSS86,89,0,89,P,9,Jul-20,Regular
4JN17CS417,15CS81,20,50,70,P,8,Jul-20,Regular
4JN17CS417,15CS832,20,63,83,P,9,Jul-20,Regular
4JN17CS417,15CS82,19,58,77,P,8,Jul-20,Regular
4JN17CS417,15CS84,47,47,94,P,10,Jul-20,Regular
4JN17CS417,15CSP85,90,88,178,P,10,Jul-20,Regular
4JN17CS417,15CSS86,91,0,91,P,10,Jul-20,Regular
4JN17CS420,15CS81,20,49,69,P,7,Jul-20,Regular
4JN17CS420,15CS832,20,61,81,P,9,Jul-20,Regular
4JN17CS420,15CS82,19,43,62,P,7,Jul-20,Regular
4JN17CS420,15CS84,47,47,94,P,10,Jul-20,Regular
4JN17CS420,15CSP85,90,93,183,P,10,Jul-20,Regular
4JN17CS420,15CSS86,92,0,92,P,10,Jul-20,Regular
4JN16CS017,15CS81,20,41,61,P,7,Jul-20,Regular
4JN16CS017,15CS82,19,40,59,P,6,Jul-20,Regular
4JN16CS017,15CS84,48,47,95,P,10,Jul-20,Regular
4JN16CS017,15CS834,18,43,61,P,7,Jul-20,Regular
4JN16CS017,15CSP85,95,96,191,P,10,Jul-20,Regular
4JN16CS017,15CSS86,93,0,93,P,10,Jul-20,Regular
4JN16CS017,15CSL76,16,44,60,P,7,Jul-20,Backlog
4JN16CS037,15CS81,20,54,74,P,8,Jul-20,Regular
4JN16CS037,15CS82,19,60,79,P,8,Jul-20,Regular
4JN16CS037,15CS84,48,48,96,P,10,Jul-20,Regular
4JN16CS037,15CS834,17,43,60,P,7,Jul-20,Regular
4JN16CS037,15CSP85,96,93,189,P,10,Jul-20,Regular
4JN16CS037,15CSS86,93,0,93,P,10,Jul-20,Regular
4JN16CS037,15CSL76,14,72,86,P,9,Jul-20,Backlog
4JN16CS062,15CS81,20,40,60,P,7,Jul-20,Regular
4JN16CS062,15CS82,19,49,68,P,7,Jul-20,Regular
4JN16CS062,15CS84,48,48,96,P,10,Jul-20,Regular
4JN16CS062,15CS834,17,41,58,P,6,Jul-20,Regular
4JN16CS062,15CSP85,98,98,196,P,10,Jul-20,Regular
4JN16CS062,15CSS86,95,0,95,P,10,Jul-20,Regular
4JN16CS062,15CSL76,18,80,98,P,10,Jul-20,Backlog
4JN16CS065,15CS81,20,58,78,P,8,Jul-20,Regular
4JN16CS065,15CS82,19,57,76,P,8,Jul-20,Regular
4JN16CS065,15CS84,48,48,96,P,10,Jul-20,Regular
4JN16CS065,15CS834,18,49,67,P,7,Jul-20,Regular
4JN16CS065,15CSP85,96,95,191,P,10,Jul-20,Regular
4JN16CS065,15CSS86,95,0,95,P,10,Jul-20,Regular
4JN16CS065,15CSL76,14,56,70,P,8,Jul-20,Backlog
4JN16CS115,15CS81,17,28,45,P,5,20-Jul,Regular
4JN16CS115,15CS82,19,35,54,P,6,Jul-20,Regular
4JN16CS115,15CS84,46,45,91,P,10,Jul-20,Regular
4JN16CS115,15CS834,18,30,48,P,5,Jul-20,Regular
4JN16CS115,15CSP85,90,92,182,P,10,Jul-20,Regular
4JN16CS115,15CSS86,94,0,94,P,10,Jul-20,Regular
4JN16CS115,15CSL76,14,53,67,P,7,Jul-20,Backlog
4JN15CS025,15CS81,18,36,54,P,6,Jul-20,Regular
4JN15CS025,15CS82,19,39,58,P,6,Jul-20,Regular
4JN15CS025,15CS84,47,47,94,P,10,Jul-20,Regular
4JN15CS025,15CS834,16,43,59,P,6,Jul-20,Regular
4JN15CS025,15CSP85,90,94,184,P,10,Jul-20,Regular
4JN15CS025,15CSS86,88,0,88,P,9,Jul-20,Regular
4JN15CS067,15CS81,19,54,73,P,8,Jul-20,Regular
4JN15CS067,15CS82,19,39,58,P,6,Jul-20,Regular
4JN15CS067,15CS84,47,47,94,P,10,Jul-20,Regular
4JN15CS067,15CS834,16,36,52,P,6,Jul-20,Regular
4JN15CS067,15CSP85,90,90,180,P,10,Jul-20,Regular
4JN15CS067,15CSS86,93,0,93,P,10,Jul-20,Regular
4JN16CS001,15CS81,20,49,69,P,7,Jul-20,Regular
4JN16CS001,15CS82,19,46,65,P,7,Jul-20,Regular
4JN16CS001,15CS84,49,48,97,P,10,Jul-20,Regular
4JN16CS001,15CS834,19,34,53,P,6,Jul-20,Regular
4JN16CS001,15CSP85,98,99,197,P,10,Jul-20,Regular
4JN16CS001,15CSS86,95,0,95,P,10,Jul-20,Regular
4JN16CS003,15CS81,19,37,56,P,6,Jul-20,Regular
4JN16CS003,15CS82,19,49,68,P,7,Jul-20,Regular
4JN16CS003,15CS84,45,46,91,P,10,Jul-20,Regular
4JN16CS003,15CS834,16,56,72,P,8,Jul-20,Regular
4JN16CS003,15CSP85,90,91,181,P,10,Jul-20,Regular
4JN16CS003,15CSS86,90,0,90,P,10,Jul-20,Regular
4JN16CS006,15CS81,19,61,80,P,9,Jul-20,Regular
4JN16CS006,15CS82,19,59,78,P,8,Jul-20,Regular
4JN16CS006,15CS84,48,48,96,P,10,Jul-20,Regular
4JN16CS006,15CS834,18,57,75,P,8,Jul-20,Regular
4JN16CS006,15CSP85,95,95,190,P,10,Jul-20,Regular
4JN16CS006,15CSS86,95,0,95,P,10,Jul-20,Regular
4JN16CS007,15CS81,20,44,64,P,7,Jul-20,Regular
4JN16CS007,15CS82,19,61,80,P,9,Jul-20,Regular
4JN16CS007,15CS84,49,47,96,P,10,Jul-20,Regular
4JN16CS007,15CS834,18,50,68,P,7,Jul-20,Regular
4JN16CS007,15CSP85,98,99,197,P,10,Jul-20,Regular
4JN16CS007,15CSS86,94,0,94,P,10,Jul-20,Regular
4JN16CS008,15CS81,20,47,67,P,7,Jul-20,Regular
4JN16CS008,15CS82,19,52,71,P,8,Jul-20,Regular
4JN16CS008,15CS84,49,48,97,P,10,Jul-20,Regular
4JN16CS008,15CS834,17,42,59,P,6,Jul-20,Regular
4JN16CS008,15CSP85,99,99,198,P,10,Jul-20,Regular
4JN16CS008,15CSS86,94,0,94,P,10,Jul-20,Regular
4JN16CS009,15CS81,20,50,70,P,8,Jul-20,Regular
4JN16CS009,15CS82,19,56,75,P,8,Jul-20,Regular
4JN16CS009,15CS84,46,47,93,P,10,Jul-20,Regular
4JN16CS009,15CS834,18,48,66,P,7,Jul-20,Regular
4JN16CS009,15CSP85,93,95,188,P,10,Jul-20,Regular
4JN16CS009,15CSS86,95,0,95,P,10,Jul-20,Regular
4JN16CS010,15CS81,20,54,74,P,8,Jul-20,Regular
4JN16CS010,15CS82,19,46,65,P,7,Jul-20,Regular
4JN16CS010,15CS84,48,48,96,P,10,Jul-20,Regular
4JN16CS010,15CS834,17,45,62,P,7,Jul-20,Regular
4JN16CS010,15CSP85,94,98,192,P,10,Jul-20,Regular
4JN16CS010,15CSS86,95,0,95,P,10,Jul-20,Regular
4JN16CS011,15CS81,20,60,80,P,9,20-Jul,Regular
4JN16CS011,15CS82,19,79,98,P,10,20-Jul,Regular
4JN16CS011,15CS834,17,52,69,P,7,20-Jul,Regular
4JN16CS011,15CS84,50,50,100,P,10,Jul-20,Regular
4JN16CS011,15CSP85,100,100,200,P,10,Jul-20,Regular
4JN16CS011,15CSS86,100,0,100,P,10,Jul-20,Regular
4JN16CS012,15CS81,20,57,77,P,8,20-Jul,Regular
4JN16CS012,15CS82,19,65,84,P,9,Jul-20,Regular
4JN16CS012,15CS84,48,50,98,P,10,Jul-20,Regular
4JN16CS012,15CS834,16,49,65,P,7,Jul-20,Regular
4JN16CS012,15CSP85,97,95,192,P,10,Jul-20,Regular
4JN16CS012,15CSS86,96,0,96,P,10,Jul-20,Regular
4JN16CS013,15CS81,20,55,75,P,8,Jul-20,Regular
4JN16CS013,15CS82,19,59,78,P,8,Jul-20,Regular
4JN16CS013,15CS84,49,49,98,P,10,Jul-20,Regular
4JN16CS013,15CS834,17,41,58,P,6,Jul-20,Regular
4JN16CS013,15CSP85,97,98,195,P,10,Jul-20,Regular
4JN16CS013,15CSS86,95,0,95,P,10,Jul-20,Regular
4JN16CS014,15CS81,20,65,85,P,9,Jul-20,Regular
4JN16CS014,15CS82,19,66,85,P,9,Jul-20,Regular
4JN16CS014,15CS84,50,50,100,P,10,Jul-20,Regular
4JN16CS014,15CS834,17,69,86,P,9,Jul-20,Regular
4JN16CS014,15CSP85,100,100,200,P,10,Jul-20,Regular
4JN16CS014,15CSS86,100,0,100,P,10,Jul-20,Regular
4JN16CS015,15CS81,19,40,59,P,6,Jul-20,Regular
4JN16CS015,15CS82,19,39,58,P,6,Jul-20,Regular
4JN16CS015,15CS84,48,48,96,P,10,Jul-20,Regular
4JN16CS015,15CS834,16,52,68,P,7,Jul-20,Regular
4JN16CS015,15CSP85,97,98,195,P,10,Jul-20,Regular
4JN16CS015,15CSS86,93,0,93,P,10,Jul-20,Regular
4JN16CS016,15CS81,20,48,68,P,7,Jul-20,Regular
4JN16CS016,15CS82,19,48,67,P,7,Jul-20,Regular
4JN16CS016,15CS84,46,49,95,P,10,Jul-20,Regular
4JN16CS016,15CS834,18,46,64,P,7,Jul-20,Regular
4JN16CS016,15CSP85,95,96,191,P,10,Jul-20,Regular
4JN16CS016,15CSS86,95,0,95,P,10,Jul-20,Regular
4JN16CS018,15CS81,19,43,62,P,7,Jul-20,Regular
4JN16CS018,15CS82,19,45,64,P,7,Jul-20,Regular
4JN16CS018,15CS84,48,48,96,P,10,Jul-20,Regular
4JN16CS018,15CS834,19,40,59,P,6,Jul-20,Regular
4JN16CS018,15CSP85,92,93,185,P,10,Jul-20,Regular
4JN16CS018,15CSS86,94,0,94,P,10,Jul-20,Regular
4JN16CS019,15CS81,20,51,71,P,8,Jul-20,Regular
4JN16CS019,15CS82,19,51,70,P,8,Jul-20,Regular
4JN16CS019,15CS84,48,48,96,P,10,Jul-20,Regular
4JN16CS019,15CS834,17,52,69,P,7,Jul-20,Regular
4JN16CS019,15CSP85,97,99,196,P,10,Jul-20,Regular
4JN16CS019,15CSS86,94,0,94,P,10,Jul-20,Regular
4JN16CS020,15CS81,20,48,68,P,7,Jul-20,Regular
4JN16CS020,15CS82,19,42,61,P,7,Jul-20,Regular
4JN16CS020,15CS84,45,49,94,P,10,Jul-20,Regular
4JN16CS020,15CS834,18,41,59,P,6,Jul-20,Regular
4JN16CS020,15CSP85,95,96,191,P,10,Jul-20,Regular
4JN16CS020,15CSS86,96,0,96,P,10,Jul-20,Regular
4JN16CS021,15CS81,20,64,84,P,9,Jul-20,Regular
4JN16CS021,15CS82,19,68,87,P,9,Jul-20,Regular
4JN16CS021,15CS84,49,48,97,P,10,Jul-20,Regular
4JN16CS021,15CS834,17,58,75,P,8,Jul-20,Regular
4JN16CS021,15CSP85,97,98,195,P,10,Jul-20,Regular
4JN16CS021,15CSS86,95,0,95,P,10,Jul-20,Regular
4JN16CS022,15CS81,20,52,72,P,8,Jul-20,Regular
4JN16CS022,15CS82,19,46,65,P,7,Jul-20,Regular
4JN16CS022,15CS84,48,50,98,P,10,Jul-20,Regular
4JN16CS022,15CS834,17,53,70,P,8,Jul-20,Regular
4JN16CS022,15CSP85,98,99,197,P,10,Jul-20,Regular
4JN16CS022,15CSS86,95,0,95,P,10,Jul-20,Regular
4JN16CS023,15CS81,20,62,82,P,9,Jul-20,Regular
4JN16CS023,15CS82,19,62,81,P,9,Jul-20,Regular
4JN16CS023,15CS84,49,49,98,P,10,Jul-20,Regular
4JN16CS023,15CS834,17,60,77,P,8,Jul-20,Regular
4JN16CS023,15CSP85,96,95,191,P,10,Jul-20,Regular
4JN16CS023,15CSS86,96,0,96,P,10,Jul-20,Regular
4JN16CS024,15CS81,20,52,72,P,8,Jul-20,Regular
4JN16CS024,15CS82,19,50,69,P,7,Jul-20,Regular
4JN16CS024,15CS834,17,62,79,P,8,Jul-20,Regular
4JN16CS024,15CS84,47,48,95,P,10,Jul-20,Regular
4JN16CS024,15CSP85,95,93,188,P,10,Jul-20,Regular
4JN16CS024,15CSS86,93,0,93,P,10,Jul-20,Regular
4JN16CS027,15CS81,20,52,72,P,8,Jul-20,Regular
4JN16CS027,15CS82,19,44,63,P,7,Jul-20,Regular
4JN16CS027,15CS84,49,48,97,P,10,Jul-20,Regular
4JN16CS027,15CS834,17,45,62,P,7,Jul-20,Regular
4JN16CS027,15CSP85,98,96,194,P,10,Jul-20,Regular
4JN16CS027,15CSS86,94,0,94,P,10,Jul-20,Regular
4JN16CS028,15CS81,20,54,74,P,8,Jul-20,Regular
4JN16CS028,15CS82,19,55,74,P,8,Jul-20,Regular
4JN16CS028,15CS84,47,49,96,P,10,Jul-20,Regular
4JN16CS028,15CS834,17,44,61,P,7,Jul-20,Regular
4JN16CS028,15CSP85,98,99,197,P,10,Jul-20,Regular
4JN16CS028,15CSS86,96,0,96,P,10,Jul-20,Regular
4JN16CS029,15CS81,20,59,79,P,8,Jul-20,Regular
4JN16CS029,15CS82,19,49,68,P,7,Jul-20,Regular
4JN16CS029,15CS834,17,40,57,P,6,Jul-20,Regular
4JN16CS029,15CS84,48,49,97,P,10,Jul-20,Regular
4JN16CS029,15CSP85,94,98,192,P,10,Jul-20,Regular
4JN16CS029,15CSS86,94,0,94,P,10,Jul-20,Regular
4JN16CS030,15CS81,20,50,70,P,8,Jul-20,Regular
4JN16CS030,15CS82,19,53,72,P,8,Jul-20,Regular
4JN16CS030,15CS84,48,49,97,P,10,Jul-20,Regular
4JN16CS030,15CS834,17,53,70,P,8,Jul-20,Regular
4JN16CS030,15CSP85,97,98,195,P,10,Jul-20,Regular
4JN16CS030,15CSS86,96,0,96,P,10,Jul-20,Regular
4JN16CS031,15CS81,18,50,68,P,7,Jul-20,Regular
4JN16CS031,15CS82,19,51,70,P,8,Jul-20,Regular
4JN16CS031,15CS84,46,49,95,P,10,Jul-20,Regular
4JN16CS031,15CS834,18,32,50,P,6,Jul-20,Regular
4JN16CS031,15CSP85,94,92,186,P,10,Jul-20,Regular
4JN16CS031,15CSS86,93,0,93,P,10,Jul-20,Regular
4JN16CS032,15CS81,20,47,67,P,7,Jul-20,Regular
4JN16CS032,15CS82,19,50,69,P,7,Jul-20,Regular
4JN16CS032,15CS84,48,48,96,P,10,Jul-20,Regular
4JN16CS032,15CS834,16,45,61,P,7,Jul-20,Regular
4JN16CS032,15CSP85,95,98,193,P,10,Jul-20,Regular
4JN16CS032,15CSS86,96,0,96,P,10,Jul-20,Regular
4JN16CS033,15CS81,20,56,76,P,8,Jul-20,Regular
4JN16CS033,15CS82,19,55,74,P,8,Jul-20,Regular
4JN16CS033,15CS834,20,72,92,P,10,Jul-20,Regular
4JN16CS033,15CS84,49,49,98,P,10,Jul-20,Regular
4JN16CS033,15CSP85,96,94,190,P,10,Jul-20,Regular
4JN16CS033,15CSS86,93,0,93,P,10,Jul-20,Regular
4JN16CS034,15CS81,20,59,79,P,8,Jul-20,Regular
4JN16CS034,15CS82,19,62,81,P,9,Jul-20,Regular
4JN16CS034,15CS84,49,49,98,P,10,Jul-20,Regular
4JN16CS034,15CS834,17,36,53,P,6,Jul-20,Regular
4JN16CS034,15CSP85,97,98,195,P,10,Jul-20,Regular
4JN16CS034,15CSS86,96,0,96,P,10,Jul-20,Regular
4JN16CS035,15CS81,20,47,67,P,7,Jul-20,Regular
4JN16CS035,15CS82,19,58,77,P,8,Jul-20,Regular
4JN16CS035,15CS834,19,50,69,P,7,Jul-20,Regular
4JN16CS035,15CS84,48,48,96,P,10,Jul-20,Regular
4JN16CS035,15CSP85,90,94,184,P,10,Jul-20,Regular
4JN16CS035,15CSS86,94,0,94,P,10,Jul-20,Regular
4JN16CS038,15CS81,19,62,81,P,9,Jul-20,Regular
4JN16CS038,15CS82,19,53,72,P,8,Jul-20,Regular
4JN16CS038,15CS834,20,44,64,P,7,Jul-20,Regular
4JN16CS038,15CS84,48,49,97,P,10,Jul-20,Regular
4JN16CS038,15CSP85,96,98,194,P,10,Jul-20,Regular
4JN16CS038,15CSS86,96,0,96,P,10,Jul-20,Regular
4JN16CS039,15CS81,20,40,60,P,7,Jul-20,Regular
4JN16CS039,15CS82,19,53,72,P,8,Jul-20,Regular
4JN16CS039,15CS84,48,48,96,P,10,Jul-20,Regular
4JN16CS039,15CS834,18,40,58,P,6,Jul-20,Regular
4JN16CS039,15CSP85,96,91,187,P,10,Jul-20,Regular
4JN16CS039,15CSS86,91,0,91,P,10,Jul-20,Regular
4JN16CS042,15CS81,20,55,75,P,8,Jul-20,Regular
4JN16CS042,15CS82,19,43,62,P,7,Jul-20,Regular
4JN16CS042,15CS84,49,47,96,P,10,Jul-20,Regular
4JN16CS042,15CS834,20,36,56,P,6,Jul-20,Regular
4JN16CS042,15CSP85,97,99,196,P,10,Jul-20,Regular
4JN16CS042,15CSS86,98,0,98,P,10,Jul-20,Regular
4JN16CS046,15CS81,20,60,80,P,9,Jul-20,Regular
4JN16CS046,15CS82,19,34,53,P,6,Jul-20,Regular
4JN16CS046,15CS84,49,48,97,P,10,Jul-20,Regular
4JN16CS046,15CS834,17,39,56,P,6,Jul-20,Regular
4JN16CS046,15CSP85,97,98,195,P,10,Jul-20,Regular
4JN16CS046,15CSS86,92,0,92,P,10,Jul-20,Regular
4JN16CS048,15CS81,20,41,61,P,7,Jul-20,Regular
4JN16CS048,15CS82,19,50,69,P,7,Jul-20,Regular
4JN16CS048,15CS84,48,49,97,P,10,Jul-20,Regular
4JN16CS048,15CS834,19,46,65,P,7,Jul-20,Regular
4JN16CS048,15CSP85,96,97,193,P,10,Jul-20,Regular
4JN16CS048,15CSS86,92,0,92,P,10,Jul-20,Regular
4JN16CS049,15CS81,18,32,50,P,6,20-Jul,Regular
4JN16CS049,15CS82,19,37,56,P,6,20-Jul,Regular
4JN16CS049,15CS84,45,42,87,P,9,Jul-20,Regular
4JN16CS049,15CS834,18,34,52,P,6,Jul-20,Regular
4JN16CS049,15CSP85,92,92,184,P,10,Jul-20,Regular
4JN16CS049,15CSS86,94,0,94,P,10,Jul-20,Regular
4JN16CS051,15CS81,20,62,82,P,9,Jul-20,Regular
4JN16CS051,15CS82,19,61,80,P,9,Jul-20,Regular
4JN16CS051,15CS84,50,50,100,P,10,Jul-20,Regular
4JN16CS051,15CS834,17,62,79,P,8,Jul-20,Regular
4JN16CS051,15CSP85,100,100,200,P,10,Jul-20,Regular
4JN16CS051,15CSS86,100,0,100,P,10,Jul-20,Regular
4JN16CS052,15CS81,19,31,50,P,6,Jul-20,Regular
4JN16CS052,15CS82,19,41,60,P,7,Jul-20,Regular
4JN16CS052,15CS84,47,47,94,P,10,Jul-20,Regular
4JN16CS052,15CS834,19,46,65,P,7,Jul-20,Regular
4JN16CS052,15CSP85,92,91,183,P,10,Jul-20,Regular
4JN16CS052,15CSS86,93,0,93,P,10,Jul-20,Regular
4JN16CS053,15CS81,20,53,73,P,8,Jul-20,Regular
4JN16CS053,15CS82,19,56,75,P,8,Jul-20,Regular
4JN16CS053,15CS84,48,49,97,P,10,Jul-20,Regular
4JN16CS053,15CS834,17,50,67,P,7,Jul-20,Regular
4JN16CS053,15CSP85,98,98,196,P,10,Jul-20,Regular
4JN16CS053,15CSS86,97,0,97,P,10,Jul-20,Regular
4JN16CS054,15CS81,20,56,76,P,8,Jul-20,Regular
4JN16CS054,15CS82,19,34,53,P,6,Jul-20,Regular
4JN16CS054,15CS84,48,49,97,P,10,Jul-20,Regular
4JN16CS054,15CS834,17,45,62,P,7,Jul-20,Regular
4JN16CS054,15CSP85,97,98,195,P,10,Jul-20,Regular
4JN16CS054,15CSS86,94,0,94,P,10,Jul-20,Regular
4JN16CS055,15CS81,20,37,57,P,6,Jul-20,Regular
4JN16CS055,15CS82,19,43,62,P,7,Jul-20,Regular
4JN16CS055,15CS84,47,49,96,P,10,Jul-20,Regular
4JN16CS055,15CS834,17,50,67,P,7,Jul-20,Regular
4JN16CS055,15CSP85,90,95,185,P,10,Jul-20,Regular
4JN16CS055,15CSS86,90,0,90,P,10,Jul-20,Regular
4JN16CS056,15CS81,20,50,70,P,8,Jul-20,Regular
4JN16CS056,15CS82,19,57,76,P,8,Jul-20,Regular
4JN16CS056,15CS84,47,48,95,P,10,Jul-20,Regular
4JN16CS056,15CS834,19,36,55,P,6,Jul-20,Regular
4JN16CS056,15CSP85,92,91,183,P,10,Jul-20,Regular
4JN16CS056,15CSS86,93,0,93,P,10,Jul-20,Regular
4JN16CS057,15CS81,20,41,61,P,7,Jul-20,Regular
4JN16CS057,15CS82,19,46,65,P,7,Jul-20,Regular
4JN16CS057,15CS84,48,49,97,P,10,Jul-20,Regular
4JN16CS057,15CS834,17,61,78,P,8,Jul-20,Regular
4JN16CS057,15CSP85,90,95,185,P,10,Jul-20,Regular
4JN16CS057,15CSS86,95,0,95,P,10,Jul-20,Regular
4JN16CS058,15CS81,19,51,70,P,8,Jul-20,Regular
4JN16CS058,15CS82,19,50,69,P,7,Jul-20,Regular
4JN16CS058,15CS84,48,48,96,P,10,Jul-20,Regular
4JN16CS058,15CS834,17,41,58,P,6,Jul-20,Regular
4JN16CS058,15CSP85,98,98,196,P,10,Jul-20,Regular
4JN16CS058,15CSS86,96,0,96,P,10,Jul-20,Regular
4JN16CS059,15CS81,20,59,79,P,8,Jul-20,Regular
4JN16CS059,15CS82,19,59,78,P,8,Jul-20,Regular
4JN16CS059,15CS84,49,49,98,P,10,Jul-20,Regular
4JN16CS059,15CS834,17,53,70,P,8,Jul-20,Regular
4JN16CS059,15CSP85,97,98,195,P,10,Jul-20,Regular
4JN16CS059,15CSS86,95,0,95,P,10,Jul-20,Regular
4JN16CS060,15CS81,19,55,74,P,8,Jul-20,Regular
4JN16CS060,15CS82,19,54,73,P,8,Jul-20,Regular
4JN16CS060,15CS84,48,47,95,P,10,Jul-20,Regular
4JN16CS060,15CS834,19,57,76,P,8,Jul-20,Regular
4JN16CS060,15CSP85,97,97,194,P,10,Jul-20,Regular
4JN16CS060,15CSS86,97,0,97,P,10,Jul-20,Regular
4JN16CS061,15CS81,20,63,83,P,9,Jul-20,Regular
4JN16CS061,15CS82,19,70,89,P,9,Jul-20,Regular
4JN16CS061,15CS84,48,48,96,P,10,Jul-20,Regular
4JN16CS061,15CS834,20,65,85,P,9,Jul-20,Regular
4JN16CS061,15CSP85,98,99,197,P,10,Jul-20,Regular
4JN16CS061,15CSS86,96,0,96,P,10,Jul-20,Regular
4JN16CS063,15CS81,20,29,49,P,5,Jul-20,Regular
4JN16CS063,15CS82,19,59,78,P,8,Jul-20,Regular
4JN16CS063,15CS84,45,48,93,P,10,Jul-20,Regular
4JN16CS063,15CS834,18,33,51,P,6,Jul-20,Regular
4JN16CS063,15CSP85,90,96,186,P,10,Jul-20,Regular
4JN16CS063,15CSS86,93,0,93,P,10,Jul-20,Regular
4JN16CS064,15CS81,20,47,67,P,7,Jul-20,Regular
4JN16CS064,15CS82,19,50,69,P,7,Jul-20,Regular
4JN16CS064,15CS84,48,48,96,P,10,Jul-20,Regular
4JN16CS064,15CS834,17,46,63,P,7,Jul-20,Regular
4JN16CS064,15CSP85,92,95,187,P,10,Jul-20,Regular
4JN16CS064,15CSS86,95,0,95,P,10,Jul-20,Regular
4JN16CS066,15CS81,19,55,74,P,8,Jul-20,Regular
4JN16CS066,15CS82,19,50,69,P,7,Jul-20,Regular
4JN16CS066,15CS84,48,49,97,P,10,Jul-20,Regular
4JN16CS066,15CS834,19,33,52,P,6,Jul-20,Regular
4JN16CS066,15CSP85,94,93,187,P,10,Jul-20,Regular
4JN16CS066,15CSS86,97,0,97,P,10,Jul-20,Regular
4JN16CS070,15CS81,20,50,70,P,8,Jul-20,Regular
4JN16CS070,15CS82,19,53,72,P,8,Jul-20,Regular
4JN16CS070,15CS84,48,47,95,P,10,Jul-20,Regular
4JN16CS070,15CS834,19,43,62,P,7,Jul-20,Regular
4JN16CS070,15CSP85,98,99,197,P,10,Jul-20,Regular
4JN16CS070,15CSS86,93,0,93,P,10,Jul-20,Regular
4JN16CS072,15CS81,20,53,73,P,8,Jul-20,Regular
4JN16CS072,15CS82,19,52,71,P,8,Jul-20,Regular
4JN16CS072,15CS84,49,47,96,P,10,Jul-20,Regular
4JN16CS072,15CS834,18,45,63,P,7,Jul-20,Regular
4JN16CS072,15CSP85,98,99,197,P,10,Jul-20,Regular
4JN16CS072,15CSS86,96,0,96,P,10,Jul-20,Regular
4JN16CS073,15CS81,20,58,78,P,8,Jul-20,Regular
4JN16CS073,15CS82,19,44,63,P,7,Jul-20,Regular
4JN16CS073,15CS84,48,48,96,P,10,Jul-20,Regular
4JN16CS073,15CS834,20,49,69,P,7,Jul-20,Regular
4JN16CS073,15CSP85,90,93,183,P,10,Jul-20,Regular
4JN16CS073,15CSS86,97,0,97,P,10,Jul-20,Regular
4JN16CS074,15CS81,20,51,71,P,8,Jul-20,Regular
4JN16CS074,15CS82,19,52,71,P,8,Jul-20,Regular
4JN16CS074,15CS84,49,49,98,P,10,Jul-20,Regular
4JN16CS074,15CS834,17,46,63,P,7,Jul-20,Regular
4JN16CS074,15CSP85,96,99,195,P,10,Jul-20,Regular
4JN16CS074,15CSS86,97,0,97,P,10,Jul-20,Regular
4JN16CS075,15CS81,20,62,82,P,9,Jul-20,Regular
4JN16CS075,15CS82,19,54,73,P,8,Jul-20,Regular
4JN16CS075,15CS84,50,50,100,P,10,Jul-20,Regular
4JN16CS075,15CS834,17,59,76,P,8,Jul-20,Regular
4JN16CS075,15CSP85,100,99,199,P,10,Jul-20,Regular
4JN16CS075,15CSS86,100,0,100,P,10,Jul-20,Regular
4JN16CS077,15CS81,20,42,62,P,7,Jul-20,Regular
4JN16CS077,15CS82,19,48,67,P,7,Jul-20,Regular
4JN16CS077,15CS84,49,48,97,P,10,Jul-20,Regular
4JN16CS077,15CS834,19,43,62,P,7,Jul-20,Regular
4JN16CS077,15CSP85,98,99,197,P,10,Jul-20,Regular
4JN16CS077,15CSS86,98,0,98,P,10,Jul-20,Regular
4JN16CS078,15CS81,20,57,77,P,8,Jul-20,Regular
4JN16CS078,15CS82,19,65,84,P,9,Jul-20,Regular
4JN16CS078,15CS84,49,48,97,P,10,Jul-20,Regular
4JN16CS078,15CS834,17,50,67,P,7,Jul-20,Regular
4JN16CS078,15CSP85,98,94,192,P,10,Jul-20,Regular
4JN16CS078,15CSS86,95,0,95,P,10,Jul-20,Regular
4JN16CS079,15CS81,20,37,57,P,6,Jul-20,Regular
4JN16CS079,15CS82,19,57,76,P,8,Jul-20,Regular
4JN16CS079,15CS84,47,48,95,P,10,Jul-20,Regular
4JN16CS079,15CS834,16,52,68,P,7,20-Jul,Regular
4JN16CS079,15CSP85,90,94,184,P,10,Jul-20,Regular
4JN16CS079,15CSS86,90,0,90,P,10,Jul-20,Regular
4JN16CS080,15CS81,20,42,62,P,7,Jul-20,Regular
4JN16CS080,15CS82,19,46,65,P,7,Jul-20,Regular
4JN16CS080,15CS84,48,48,96,P,10,Jul-20,Regular
4JN16CS080,15CS834,18,35,53,P,6,Jul-20,Regular
4JN16CS080,15CSP85,90,95,185,P,10,Jul-20,Regular
4JN16CS080,15CSS86,95,0,95,P,10,Jul-20,Regular
4JN16CS084,15CS81,20,60,80,P,9,Jul-20,Regular
4JN16CS084,15CS82,19,55,74,P,8,Jul-20,Regular
4JN16CS084,15CS84,48,49,97,P,10,Jul-20,Regular
4JN16CS084,15CS834,17,60,77,P,8,Jul-20,Regular
4JN16CS084,15CSP85,98,99,197,P,10,Jul-20,Regular
4JN16CS084,15CSS86,95,0,95,P,10,Jul-20,Regular
4JN16CS085,15CS81,20,42,62,P,7,Jul-20,Regular
4JN16CS085,15CS82,19,61,80,P,9,Jul-20,Regular
4JN16CS085,15CS84,48,48,96,P,10,Jul-20,Regular
4JN16CS085,15CS834,18,64,82,P,9,Jul-20,Regular
4JN16CS085,15CSP85,95,92,187,P,10,Jul-20,Regular
4JN16CS085,15CSS86,96,0,96,P,10,Jul-20,Regular
4JN16CS088,15CS81,19,41,60,P,7,Jul-20,Regular
4JN16CS088,15CS82,19,38,57,P,6,Jul-20,Regular
4JN16CS088,15CS84,47,47,94,P,10,Jul-20,Regular
4JN16CS088,15CS834,18,49,67,P,7,Jul-20,Regular
4JN16CS088,15CSP85,96,91,187,P,10,Jul-20,Regular
4JN16CS088,15CSS86,90,0,90,P,10,Jul-20,Regular
4JN16CS089,15CS81,20,56,76,P,8,Jul-20,Regular
4JN16CS089,15CS82,19,63,82,P,9,Jul-20,Regular
4JN16CS089,15CS84,46,45,91,P,10,Jul-20,Regular
4JN16CS089,15CS834,20,53,73,P,8,Jul-20,Regular
4JN16CS089,15CSP85,95,96,191,P,10,Jul-20,Regular
4JN16CS089,15CSS86,97,0,97,P,10,Jul-20,Regular
4JN16CS090,15CS81,20,50,70,P,8,Jul-20,Regular
4JN16CS090,15CS82,19,57,76,P,8,Jul-20,Regular
4JN16CS090,15CS84,48,48,96,P,10,Jul-20,Regular
4JN16CS090,15CS834,18,43,61,P,7,Jul-20,Regular
4JN16CS090,15CSP85,96,95,191,P,10,Jul-20,Regular
4JN16CS090,15CSS86,90,0,90,P,10,Jul-20,Regular
4JN16CS091,15CS81,20,54,74,P,8,Jul-20,Regular
4JN16CS091,15CS82,19,68,87,P,9,Jul-20,Regular
4JN16CS091,15CS84,47,47,94,P,10,Jul-20,Regular
4JN16CS091,15CS834,18,65,83,P,9,Jul-20,Regular
4JN16CS091,15CSP85,96,98,194,P,10,Jul-20,Regular
4JN16CS091,15CSS86,99,0,99,P,10,Jul-20,Regular
4JN16CS093,15CS81,19,42,61,P,7,Jul-20,Regular
4JN16CS093,15CS82,19,29,48,P,5,Jul-20,Regular
4JN16CS093,15CS84,48,47,95,P,10,Jul-20,Regular
4JN16CS093,15CS834,19,35,54,P,6,Jul-20,Regular
4JN16CS093,15CSP85,96,92,188,P,10,Jul-20,Regular
4JN16CS093,15CSS86,94,0,94,P,10,Jul-20,Regular
4JN16CS094,15CS81,20,57,77,P,8,Jul-20,Regular
4JN16CS094,15CS82,19,52,71,P,8,Jul-20,Regular
4JN16CS094,15CS84,47,50,97,P,10,Jul-20,Regular
4JN16CS094,15CS834,19,44,63,P,7,Jul-20,Regular
4JN16CS094,15CSP85,92,91,183,P,10,Jul-20,Regular
4JN16CS094,15CSS86,99,0,99,P,10,Jul-20,Regular
4JN16CS095,15CS81,20,46,66,P,7,Jul-20,Regular
4JN16CS095,15CS82,19,46,65,P,7,Jul-20,Regular
4JN16CS095,15CS84,46,50,96,P,10,Jul-20,Regular
4JN16CS095,15CS834,19,43,62,P,7,Jul-20,Regular
4JN16CS095,15CSP85,93,92,185,P,10,Jul-20,Regular
4JN16CS095,15CSS86,95,0,95,P,10,Jul-20,Regular
4JN16CS096,15CS81,20,53,73,P,8,Jul-20,Regular
4JN16CS096,15CS82,19,58,77,P,8,Jul-20,Regular
4JN16CS096,15CS84,48,50,98,P,10,Jul-20,Regular
4JN16CS096,15CS834,17,48,65,P,7,Jul-20,Regular
4JN16CS096,15CSP85,99,99,198,P,10,Jul-20,Regular
4JN16CS096,15CSS86,94,0,94,P,10,Jul-20,Regular
4JN16CS097,15CS81,20,54,74,P,8,Jul-20,Regular
4JN16CS097,15CS82,19,44,63,P,7,Jul-20,Regular
4JN16CS097,15CS84,49,49,98,P,10,Jul-20,Regular
4JN16CS097,15CS834,18,45,63,P,7,Jul-20,Regular
4JN16CS097,15CSP85,96,95,191,P,10,Jul-20,Regular
4JN16CS097,15CSS86,95,0,95,P,10,Jul-20,Regular
4JN16CS099,15CS81,19,56,75,P,8,Jul-20,Regular
4JN16CS099,15CS82,19,48,67,P,7,Jul-20,Regular
4JN16CS099,15CS84,48,48,96,P,10,Jul-20,Regular
4JN16CS099,15CS834,19,41,60,P,7,Jul-20,Regular
4JN16CS099,15CSP85,93,92,185,P,10,Jul-20,Regular
4JN16CS099,15CSS86,92,0,92,P,10,Jul-20,Regular
4JN16CS100,15CS81,20,46,66,P,7,Jul-20,Regular
4JN16CS100,15CS82,19,42,61,P,7,Jul-20,Regular
4JN16CS100,15CS84,49,48,97,P,10,Jul-20,Regular
4JN16CS100,15CS834,20,50,70,P,8,Jul-20,Regular
4JN16CS100,15CSP85,97,98,195,P,10,Jul-20,Regular
4JN16CS100,15CSS86,96,0,96,P,10,Jul-20,Regular
4JN16CS102,15CS81,19,48,67,P,7,Jul-20,Regular
4JN16CS102,15CS82,19,56,75,P,8,Jul-20,Regular
4JN16CS102,15CS84,49,50,99,P,10,Jul-20,Regular
4JN16CS102,15CS834,19,44,63,P,7,Jul-20,Regular
4JN16CS102,15CSP85,98,99,197,P,10,Jul-20,Regular
4JN16CS102,15CSS86,99,0,99,P,10,Jul-20,Regular
4JN16CS103,15CS81,19,44,63,P,7,Jul-20,Regular
4JN16CS103,15CS82,19,47,66,P,7,Jul-20,Regular
4JN16CS103,15CS84,49,50,99,P,10,Jul-20,Regular
4JN16CS103,15CS834,20,50,70,P,8,Jul-20,Regular
4JN16CS103,15CSP85,98,99,197,P,10,Jul-20,Regular
4JN16CS103,15CSS86,100,0,100,P,10,Jul-20,Regular
4JN16CS104,15CS81,20,70,90,P,10,Jul-20,Regular
4JN16CS104,15CS82,19,62,81,P,9,Jul-20,Regular
4JN16CS104,15CS84,50,50,100,P,10,Jul-20,Regular
4JN16CS104,15CS834,18,50,68,P,7,Jul-20,Regular
4JN16CS104,15CSP85,100,100,200,P,10,Jul-20,Regular
4JN16CS104,15CSS86,100,0,100,P,10,Jul-20,Regular
4JN16CS106,15CS81,19,40,59,P,6,Jul-20,Regular
4JN16CS106,15CS82,19,41,60,P,7,Jul-20,Regular
4JN16CS106,15CS84,47,49,96,P,10,Jul-20,Regular
4JN16CS106,15CS834,17,35,52,P,6,Jul-20,Regular
4JN16CS106,15CSP85,95,93,188,P,10,Jul-20,Regular
4JN16CS106,15CSS86,95,0,95,P,10,Jul-20,Regular
4JN16CS107,15CS81,20,37,57,P,6,20-Jul,Regular
4JN16CS107,15CS82,19,46,65,P,7,20-Jul,Regular
4JN16CS107,15CS834,17,41,58,P,6,20-Jul,Regular
4JN16CS107,15CS84,48,48,96,P,10,Jul-20,Regular
4JN16CS107,15CSP85,96,93,189,P,10,Jul-20,Regular
4JN16CS107,15CSS86,96,0,96,P,10,Jul-20,Regular
4JN16CS108,15CS81,19,48,67,P,7,Jul-20,Regular
4JN16CS108,15CS82,19,51,70,P,8,Jul-20,Regular
4JN16CS108,15CS84,48,49,97,P,10,Jul-20,Regular
4JN16CS108,15CS834,19,54,73,P,8,Jul-20,Regular
4JN16CS108,15CSP85,96,97,193,P,10,Jul-20,Regular
4JN16CS108,15CSS86,99,0,99,P,10,Jul-20,Regular
4JN16CS110,15CS81,20,42,62,P,7,Jul-20,Regular
4JN16CS110,15CS82,19,39,58,P,6,Jul-20,Regular
4JN16CS110,15CS84,48,48,96,P,10,Jul-20,Regular
4JN16CS110,15CS834,17,46,63,P,7,Jul-20,Regular
4JN16CS110,15CSP85,90,94,184,P,10,Jul-20,Regular
4JN16CS110,15CSS86,89,0,89,P,9,Jul-20,Regular
4JN16CS112,15CS81,20,50,70,P,8,Jul-20,Regular
4JN16CS112,15CS82,19,52,71,P,8,Jul-20,Regular
4JN16CS112,15CS84,48,48,96,P,10,Jul-20,Regular
4JN16CS112,15CS834,20,62,82,P,9,Jul-20,Regular
4JN16CS112,15CSP85,95,98,193,P,10,Jul-20,Regular
4JN16CS112,15CSS86,99,0,99,P,10,Jul-20,Regular
4JN16CS113,15CS81,20,52,72,P,8,Jul-20,Regular
4JN16CS113,15CS82,19,57,76,P,8,Jul-20,Regular
4JN16CS113,15CS84,46,48,94,P,10,Jul-20,Regular
4JN16CS113,15CS834,18,50,68,P,7,Jul-20,Regular
4JN16CS113,15CSP85,94,90,184,P,10,Jul-20,Regular
4JN16CS113,15CSS86,94,0,94,P,10,Jul-20,Regular
4JN16CS114,15CS81,19,63,82,P,9,Jul-20,Regular
4JN16CS114,15CS82,19,52,71,P,8,Jul-20,Regular
4JN16CS114,15CS84,46,45,91,P,10,Jul-20,Regular
4JN16CS114,15CS834,19,57,76,P,8,Jul-20,Regular
4JN16CS114,15CSP85,95,96,191,P,10,Jul-20,Regular
4JN16CS114,15CSS86,98,0,98,P,10,Jul-20,Regular
4JN16CS119,15CS81,20,39,59,P,6,20-Jul,Regular
4JN16CS119,15CS82,19,55,74,P,8,20-Jul,Regular
4JN16CS119,15CS84,47,47,94,P,10,Jul-20,Regular
4JN16CS119,15CS834,19,51,70,P,8,20-Jul,Regular
4JN16CS119,15CSP85,92,91,183,P,10,Jul-20,Regular
4JN16CS119,15CSS86,96,0,96,P,10,Jul-20,Regular
4JN16CS120,15CS81,19,49,68,P,7,Jul-20,Regular
4JN16CS120,15CS82,19,52,71,P,8,Jul-20,Regular
4JN16CS120,15CS84,49,50,99,P,10,Jul-20,Regular
4JN16CS120,15CS834,20,58,78,P,8,Jul-20,Regular
4JN16CS120,15CSP85,98,98,196,P,10,Jul-20,Regular
4JN16CS120,15CSS86,98,0,98,P,10,Jul-20,Regular
4JN16CS122,15CS81,18,34,52,P,6,Jul-20,Regular
4JN16CS122,15CS82,19,41,60,P,7,Jul-20,Regular
4JN16CS122,15CS84,49,48,97,P,10,Jul-20,Regular
4JN16CS122,15CS834,17,40,57,P,6,Jul-20,Regular
4JN16CS122,15CSP85,97,98,195,P,10,Jul-20,Regular
4JN16CS122,15CSS86,97,0,97,P,10,Jul-20,Regular
4JN16CS124,15CS81,20,70,90,P,10,Jul-20,Regular
4JN16CS124,15CS82,19,61,80,P,9,Jul-20,Regular
4JN16CS124,15CS834,19,56,75,P,8,Jul-20,Regular
4JN16CS124,15CS84,50,50,100,P,10,Jul-20,Regular
4JN16CS124,15CSP85,100,100,200,P,10,Jul-20,Regular
4JN16CS124,15CSS86,100,0,100,P,10,Jul-20,Regular
4JN16CS125,15CS81,20,57,77,P,8,Jul-20,Regular
4JN16CS125,15CS82,19,60,79,P,8,Jul-20,Regular
4JN16CS125,15CS84,48,46,94,P,10,Jul-20,Regular
4JN16CS125,15CS834,20,58,78,P,8,Jul-20,Regular
4JN16CS125,15CSP85,100,100,200,P,10,Jul-20,Regular
4JN16CS125,15CSS86,97,0,97,P,10,Jul-20,Regular
4JN16CS126,15CS81,20,53,73,P,8,Jul-20,Regular
4JN16CS126,15CS82,19,42,61,P,7,Jul-20,Regular
4JN16CS126,15CS834,20,57,77,P,8,Jul-20,Regular
4JN16CS126,15CS84,49,50,99,P,10,Jul-20,Regular
4JN16CS126,15CSP85,100,100,200,P,10,Jul-20,Regular
4JN16CS126,15CSS86,98,0,98,P,10,Jul-20,Regular
4JN16CS127,15CS81,20,47,67,P,7,Jul-20,Regular
4JN16CS127,15CS82,19,58,77,P,8,Jul-20,Regular
4JN16CS127,15CS84,49,50,99,P,10,Jul-20,Regular
4JN16CS127,15CS834,17,60,77,P,8,Jul-20,Regular
4JN16CS127,15CSP85,98,98,196,P,10,Jul-20,Regular
4JN16CS127,15CSS86,95,0,95,P,10,Jul-20,Regular
4JN16CS128,15CS81,20,63,83,P,9,Jul-20,Regular
4JN16CS128,15CS82,19,59,78,P,8,Jul-20,Regular
4JN16CS128,15CS84,46,48,94,P,10,Jul-20,Regular
4JN16CS128,15CS834,17,45,62,P,7,Jul-20,Regular
4JN16CS128,15CSP85,94,93,187,P,10,Jul-20,Regular
4JN16CS128,15CSS86,96,0,96,P,10,Jul-20,Regular
4JN16CS129,15CS81,20,45,65,P,7,Jul-20,Regular
4JN16CS129,15CS82,19,45,64,P,7,Jul-20,Regular
4JN16CS129,15CS84,47,48,95,P,10,Jul-20,Regular
4JN16CS129,15CS834,20,28,48,P,5,Jul-20,Regular
4JN16CS129,15CSP85,100,100,200,P,10,Jul-20,Regular
4JN16CS129,15CSS86,97,0,97,P,10,Jul-20,Regular
4JN16CS131,15CS81,20,53,73,P,8,20-Jul,Regular
4JN16CS131,15CS82,19,41,60,P,7,Jul-20,Regular
4JN16CS131,15CS84,47,49,96,P,10,Jul-20,Regular
4JN16CS131,15CS834,19,47,66,P,7,20-Jul,Regular
4JN16CS131,15CSP85,94,96,190,P,10,Jul-20,Regular
4JN16CS131,15CSS86,96,0,96,P,10,Jul-20,Regular
4JN16CS132,15CS81,19,61,80,P,9,Jul-20,Regular
4JN16CS132,15CS82,19,60,79,P,8,Jul-20,Regular
4JN16CS132,15CS834,18,28,46,P,5,Jul-20,Regular
4JN16CS132,15CS84,49,49,98,P,10,Jul-20,Regular
4JN16CS132,15CSP85,94,95,189,P,10,Jul-20,Regular
4JN16CS132,15CSS86,98,0,98,P,10,Jul-20,Regular
4JN17CS404,15CS81,18,39,57,P,6,Jul-20,Regular
4JN17CS404,15CS82,19,45,64,P,7,Jul-20,Regular
4JN17CS404,15CS84,48,49,97,P,10,Jul-20,Regular
4JN17CS404,15CS834,17,40,57,P,6,Jul-20,Regular
4JN17CS404,15CSP85,90,94,184,P,10,Jul-20,Regular
4JN17CS404,15CSS86,86,0,86,P,9,Jul-20,Regular
4JN17CS400,15CS81,18,35,53,P,6,Jul-20,Regular
4JN17CS400,15CS82,19,28,47,P,5,Jul-20,Regular
4JN17CS400,15CS84,48,47,95,P,10,Jul-20,Regular
4JN17CS400,15CS834,17,29,46,P,5,Jul-20,Regular
4JN17CS400,15CSP85,95,91,186,P,10,Jul-20,Regular
4JN17CS400,15CSS86,90,0,90,P,10,Jul-20,Regular
4JN17CS406,15CS81,20,28,48,P,5,Jul-20,Regular
4JN17CS406,15CS82,19,48,67,P,7,Jul-20,Regular
4JN17CS406,15CS84,45,47,92,P,10,Jul-20,Regular
4JN17CS406,15CS834,16,42,58,P,6,Jul-20,Regular
4JN17CS406,15CSP85,90,91,181,P,10,Jul-20,Regular
4JN17CS406,15CSS86,86,0,86,P,9,Jul-20,Regular
4JN17CS410,15CS81,19,39,58,P,6,Jul-20,Regular
4JN17CS410,15CS82,19,40,59,P,6,Jul-20,Regular
4JN17CS410,15CS84,45,44,89,P,9,Jul-20,Regular
4JN17CS410,15CS834,17,18,35,F,0,20-Jul,Regular
4JN17CS410,15CSP85,90,91,181,P,10,Jul-20,Regular
4JN17CS410,15CSS86,88,0,88,P,9,Jul-20,Regular
4JN15CS080,15CS82,16,30,46,P,5,Jul-20,Regular
4JN17CS058,18MAT41,49,17,66,P,7,Jul-20,Regular
4JN17CS058,18CS42,43,17,60,P,7,Jul-20,Regular
4JN17CS058,18CS43,45,17,62,P,7,Jul-20,Regular
4JN17CS058,18CS44,45,17,62,P,7,Jul-20,Regular
4JN17CS058,18CS45,42,17,59,P,6,Jul-20,Regular
4JN17CS058,18CS46,48,17,65,P,7,Jul-20,Regular
4JN17CS058,18CSL47,43,17,60,P,7,Jul-20,Regular
4JN17CS058,18CSL48,48,17,65,P,7,Jul-20,Regular
4JN17CS058,18CPC49,49,17,66,P,7,Jul-20,Regular
4JN18CS408,17CS61,50,22,72,P,8,Jul-20,Regular
4JN18CS408,17CS62,50,22,72,P,8,Jul-20,Regular
4JN18CS408,17CS63,45,22,67,P,7,Jul-20,Regular
4JN18CS408,17CS664,45,22,67,P,7,Jul-20,Regular
4JN18CS408,17CS654,48,22,70,P,8,Jul-20,Regular
4JN18CS408,17CS64,45,22,67,P,7,Jul-20,Regular
4JN18CS408,17CSL67,44,22,66,P,7,Jul-20,Regular
4JN18CS408,17CSL68,50,22,72,P,8,Jul-20,Regular
4JN18CS400,17CS61,50,26,76,P,8,Jul-20,Regular
4JN18CS400,17CS62,48,26,74,P,8,Jul-20,Regular
4JN18CS400,17CS63,49,26,75,P,8,Jul-20,Regular
4JN18CS400,17CS664,44,26,70,P,8,Jul-20,Regular
4JN18CS400,17CS654,45,26,71,P,8,Jul-20,Regular
4JN18CS400,17CS64,44,26,70,P,8,Jul-20,Regular
4JN18CS400,17CSL67,45,26,71,P,8,Jul-20,Regular
4JN18CS400,17CSL68,49,26,75,P,8,Jul-20,Regular
4JN17CS032,17CS61,50,28,78,P,8,Jul-20,Regular
4JN17CS032,17CS62,50,28,78,P,8,Jul-20,Regular
4JN17CS032,17CS653,50,28,78,P,8,Jul-20,Regular
4JN17CS032,17CS63,44,28,72,P,8,Jul-20,Regular
4JN17CS032,17CS664,47,28,75,P,8,Jul-20,Regular
4JN17CS032,17CS64,45,28,73,P,8,Jul-20,Regular
4JN17CS032,17CSL67,45,28,73,P,8,Jul-20,Regular
4JN17CS032,17CSL68,50,28,78,P,8,Jul-20,Regular
4JN17CS091,17CS61,49,26,75,P,8,Jul-20,Regular
4JN17CS091,17CS62,49,26,75,P,8,Jul-20,Regular
4JN17CS091,17CS63,43,26,69,P,7,Jul-20,Regular
4JN17CS091,17CS664,43,26,69,P,7,Jul-20,Regular
4JN17CS091,17CS654,49,26,75,P,8,Jul-20,Regular
4JN17CS091,17CS64,45,26,71,P,8,Jul-20,Regular
4JN17CS091,17CSL67,44,26,70,P,8,Jul-20,Regular
4JN17CS091,17CSL68,49,26,75,P,8,Jul-20,Regular
4JN17CS109,17CS61,49,31,80,P,9,Jul-20,Regular
4JN17CS109,17CS62,49,31,80,P,9,Jul-20,Regular
4JN17CS109,17CS63,49,31,80,P,9,Jul-20,Regular
4JN17CS109,17CS664,48,31,79,P,8,Jul-20,Regular
4JN17CS109,17CS654,49,31,80,P,9,Jul-20,Regular
4JN17CS109,17CS64,47,31,78,P,8,Jul-20,Regular
4JN17CS109,17CSL67,48,31,79,P,8,Jul-20,Regular
4JN17CS109,17CSL68,49,31,80,P,9,Jul-20,Regular
4JN18CS401,17CS61,45,31,76,P,8,Jul-20,Regular
4JN18CS401,17CS62,48,31,79,P,8,Jul-20,Regular
4JN18CS401,17CS63,49,31,80,P,9,Jul-20,Regular
4JN18CS401,17CS664,49,31,80,P,9,Jul-20,Regular
4JN18CS401,17CS654,44,31,75,P,8,Jul-20,Regular
4JN18CS401,17CS64,47,31,78,P,8,Jul-20,Regular
4JN18CS401,17CSL67,45,31,76,P,8,Jul-20,Regular
4JN18CS401,17CSL68,49,31,80,P,9,Jul-20,Regular
4JN17CS053,17CS61,49,22,71,P,8,Jul-20,Regular
4JN17CS053,17CS62,49,22,71,P,8,Jul-20,Regular
4JN17CS053,17CS63,49,22,71,P,8,Jul-20,Regular
4JN17CS053,17CS664,45,22,67,P,7,Jul-20,Regular
4JN17CS053,17CS654,49,22,71,P,8,Jul-20,Regular
4JN17CS053,17CS64,48,22,70,P,8,Jul-20,Regular
4JN17CS053,17CSL67,44,22,66,P,7,Jul-20,Regular
4JN17CS053,17CSL68,49,22,71,P,8,Jul-20,Regular
4JN18CS421,17CS61,50,21,71,P,8,Jul-20,Regular
4JN18CS421,17CS62,50,21,71,P,8,Jul-20,Regular
4JN18CS421,17CS63,45,21,66,P,7,Jul-20,Regular
4JN18CS421,17CS664,45,21,66,P,7,Jul-20,Regular
4JN18CS421,17CS654,47,21,68,P,7,Jul-20,Regular
4JN18CS421,17CS64,48,21,69,P,7,Jul-20,Regular
4JN18CS421,17CSL67,44,21,65,P,7,Jul-20,Regular
4JN18CS421,17CSL68,50,21,71,P,8,Jul-20,Regular
4JN17CS086,17CS61,50,21,71,P,8,Jul-20,Regular
4JN17CS086,17CS62,50,21,71,P,8,Jul-20,Regular
4JN17CS086,17CS653,49,21,70,P,8,Jul-20,Regular
4JN17CS086,17CS63,44,21,65,P,7,Jul-20,Regular
4JN17CS086,17CS664,44,21,65,P,7,Jul-20,Regular
4JN17CS086,17CS64,45,21,66,P,7,Jul-20,Regular
4JN17CS086,17CSL67,44,21,65,P,7,Jul-20,Regular
4JN17CS086,17CSL68,50,21,71,P,8,Jul-20,Regular
4JN17CS121,17CS61,50,28,78,P,8,Jul-20,Regular
4JN17CS121,17CS62,50,28,78,P,8,Jul-20,Regular
4JN17CS121,17CS653,45,28,73,P,8,Jul-20,Regular
4JN17CS121,17CS63,43,28,71,P,8,Jul-20,Regular
4JN17CS121,17CS664,47,28,75,P,8,Jul-20,Regular
4JN17CS121,17CS64,47,28,75,P,8,Jul-20,Regular
4JN17CS121,17CSL67,44,28,72,P,8,Jul-20,Regular
4JN17CS121,17CSL68,50,28,78,P,8,Jul-20,Regular
4JN17CS046,17CS61,49,25,74,P,8,Jul-20,Regular
4JN17CS046,17CS62,49,25,74,P,8,Jul-20,Regular
4JN17CS046,17CS63,49,25,74,P,8,Jul-20,Regular
4JN17CS046,17CS664,43,25,68,P,7,Jul-20,Regular
4JN17CS046,17CS654,49,25,74,P,8,Jul-20,Regular
4JN17CS046,17CS64,44,25,69,P,7,Jul-20,Regular
4JN17CS046,17CSL67,48,25,73,P,8,Jul-20,Regular
4JN17CS046,17CSL68,49,25,74,P,8,Jul-20,Regular
4JN16CS068,17CS61,49,28,77,P,8,Jul-20,Regular
4JN16CS068,17CS62,50,28,78,P,8,Jul-20,Regular
4JN16CS068,17CS653,50,28,78,P,8,Jul-20,Regular
4JN16CS068,17CS63,49,28,77,P,8,Jul-20,Regular
4JN16CS068,17CS664,47,28,75,P,8,Jul-20,Regular
4JN16CS068,17CS64,50,28,78,P,8,Jul-20,Regular
4JN16CS068,17CSL67,45,28,73,P,8,Jul-20,Regular
4JN16CS068,17CSL68,50,28,78,P,8,Jul-20,Regular
4JN17CS088,17CS61,50,24,74,P,8,Jul-20,Regular
4JN17CS088,17CS62,49,24,73,P,8,Jul-20,Regular
4JN17CS088,17CS63,49,24,73,P,8,Jul-20,Regular
4JN17CS088,17CS664,42,24,66,P,7,Jul-20,Regular
4JN17CS088,17CS654,50,24,74,P,8,Jul-20,Regular
4JN17CS088,17CS64,47,24,71,P,8,Jul-20,Regular
4JN17CS088,17CSL67,48,24,72,P,8,Jul-20,Regular
4JN17CS088,17CSL68,49,24,73,P,8,Jul-20,Regular
4JN17CS103,17CS61,48,24,72,P,8,Jul-20,Regular
4JN17CS103,17CS62,49,24,73,P,8,Jul-20,Regular
4JN17CS103,17CS63,49,24,73,P,8,Jul-20,Regular
4JN17CS103,17CS664,49,24,73,P,8,Jul-20,Regular
4JN17CS103,17CS654,48,24,72,P,8,Jul-20,Regular
4JN17CS103,17CS64,47,24,71,P,8,Jul-20,Regular
4JN17CS103,17CSL67,49,24,73,P,8,Jul-20,Regular
4JN17CS103,17CSL68,49,24,73,P,8,Jul-20,Regular
4JN16CS004,17CS61,50,21,71,P,8,Jul-20,Regular
4JN16CS004,17CS62,50,21,71,P,8,Jul-20,Regular
4JN16CS004,17CS653,49,21,70,P,8,Jul-20,Regular
4JN16CS004,17CS63,44,21,65,P,7,Jul-20,Regular
4JN16CS004,17CS664,45,21,66,P,7,Jul-20,Regular
4JN16CS004,17CS64,44,21,65,P,7,Jul-20,Regular
4JN16CS004,17CSL67,47,21,68,P,7,Jul-20,Regular
4JN16CS004,17CSL68,50,21,71,P,8,Jul-20,Regular
4JN17CS081,17CS61,50,24,74,P,8,Jul-20,Regular
4JN17CS081,17CS62,50,24,74,P,8,Jul-20,Regular
4JN17CS081,17CS653,44,24,68,P,7,Jul-20,Regular
4JN17CS081,17CS63,45,24,69,P,7,Jul-20,Regular
4JN17CS081,17CS664,47,24,71,P,8,Jul-20,Regular
4JN17CS081,17CS64,48,24,72,P,8,Jul-20,Regular
4JN17CS081,17CSL67,45,24,69,P,7,Jul-20,Regular
4JN17CS081,17CSL68,50,24,74,P,8,Jul-20,Regular
4JN16CS076,17CS61,50,19,69,P,7,Jul-20,Regular
4JN16CS076,17CS62,49,19,68,P,7,Jul-20,Regular
4JN16CS076,17CS653,50,19,69,P,7,Jul-20,Regular
4JN16CS076,17CS63,49,19,68,P,7,Jul-20,Regular
4JN16CS076,17CS664,43,19,62,P,7,Jul-20,Regular
4JN16CS076,17CS64,45,19,64,P,7,Jul-20,Regular
4JN16CS076,17CSL67,44,19,63,P,7,Jul-20,Regular
4JN16CS076,17CSL68,49,19,68,P,7,Jul-20,Regular
4JN17CS049,17CS61,49,19,68,P,7,Jul-20,Regular
4JN17CS049,17CS62,49,19,68,P,7,Jul-20,Regular
4JN17CS049,17CS63,49,19,68,P,7,Jul-20,Regular
4JN17CS049,17CS664,45,19,64,P,7,Jul-20,Regular
4JN17CS049,17CS654,49,19,68,P,7,Jul-20,Regular
4JN17CS049,17CS64,45,19,64,P,7,Jul-20,Regular
4JN17CS049,17CSL67,47,19,66,P,7,Jul-20,Regular
4JN17CS049,17CSL68,49,19,68,P,7,Jul-20,Regular
4JN17CS060,17CS61,47,23,70,P,8,Jul-20,Regular
4JN17CS060,17CS62,49,23,72,P,8,Jul-20,Regular
4JN17CS060,17CS653,50,23,73,P,8,Jul-20,Regular
4JN17CS060,17CS63,49,23,72,P,8,Jul-20,Regular
4JN17CS060,17CS664,47,23,70,P,8,Jul-20,Regular
4JN17CS060,17CS64,48,23,71,P,8,Jul-20,Regular
4JN17CS060,17CSL67,49,23,72,P,8,Jul-20,Regular
4JN17CS060,17CSL68,49,23,72,P,8,Jul-20,Regular
4JN17CS079,17CS61,49,24,73,P,8,Jul-20,Regular
4JN17CS079,17CS62,49,24,73,P,8,Jul-20,Regular
4JN17CS079,17CS653,50,24,74,P,8,Jul-20,Regular
4JN17CS079,17CS63,49,24,73,P,8,Jul-20,Regular
4JN17CS079,17CS64,48,24,72,P,8,Jul-20,Regular
4JN17CS079,17CS664,45,24,69,P,7,Jul-20,Regular
4JN17CS079,17CSL67,44,24,68,P,7,Jul-20,Regular
4JN17CS079,17CSL68,49,24,73,P,8,Jul-20,Regular
4JN17CS007,17CS61,50,24,74,P,8,Jul-20,Regular
4JN17CS007,17CS62,49,24,73,P,8,Jul-20,Regular
4JN17CS007,17CS653,50,24,74,P,8,Jul-20,Regular
4JN17CS007,17CS63,49,24,73,P,8,Jul-20,Regular
4JN17CS007,17CS664,49,24,73,P,8,Jul-20,Regular
4JN17CS007,17CS64,48,24,72,P,8,Jul-20,Regular
4JN17CS007,17CSL67,47,24,71,P,8,Jul-20,Regular
4JN17CS007,17CSL68,49,24,73,P,8,Jul-20,Regular
4JN17CS022,17CS61,49,26,75,P,8,Jul-20,Regular
4JN17CS022,17CS62,49,26,75,P,8,Jul-20,Regular
4JN17CS022,17CS653,50,26,76,P,8,Jul-20,Regular
4JN17CS022,17CS63,49,26,75,P,8,Jul-20,Regular
4JN17CS022,17CS664,49,26,75,P,8,Jul-20,Regular
4JN17CS022,17CS64,49,26,75,P,8,Jul-20,Regular
4JN17CS022,17CSL67,47,26,73,P,8,Jul-20,Regular
4JN17CS022,17CSL68,49,26,75,P,8,Jul-20,Regular
4JN18CS419,17CS61,50,26,76,P,8,Jul-20,Regular
4JN18CS419,17CS62,50,26,76,P,8,Jul-20,Regular
4JN18CS419,17CS63,45,26,71,P,8,Jul-20,Regular
4JN18CS419,17CS664,48,26,74,P,8,Jul-20,Regular
4JN18CS419,17CS654,47,26,73,P,8,Jul-20,Regular
4JN18CS419,17CS64,48,26,74,P,8,Jul-20,Regular
4JN18CS419,17CSL67,44,26,70,P,8,Jul-20,Regular
4JN18CS419,17CSL68,50,26,76,P,8,Jul-20,Regular
4JN17CS071,17CS61,50,26,76,P,8,Jul-20,Regular
4JN17CS071,17CS62,50,26,76,P,8,Jul-20,Regular
4JN17CS071,17CS653,45,26,71,P,8,Jul-20,Regular
4JN17CS071,17CS63,43,26,69,P,7,Jul-20,Regular
4JN17CS071,17CS64,48,26,74,P,8,Jul-20,Regular
4JN17CS071,17CS664,44,26,70,P,8,Jul-20,Regular
4JN17CS071,17CSL67,45,26,71,P,8,Jul-20,Regular
4JN17CS071,17CSL68,50,26,76,P,8,Jul-20,Regular
4JN17CS126,17CS61,50,28,78,P,8,Jul-20,Regular
4JN17CS126,17CS62,50,28,78,P,8,Jul-20,Regular
4JN17CS126,17CS653,50,28,78,P,8,Jul-20,Regular
4JN17CS126,17CS63,47,28,75,P,8,Jul-20,Regular
4JN17CS126,17CS664,47,28,75,P,8,Jul-20,Regular
4JN17CS126,17CS64,49,28,77,P,8,Jul-20,Regular
4JN17CS126,17CSL67,48,28,76,P,8,Jul-20,Regular
4JN17CS126,17CSL68,50,28,78,P,8,Jul-20,Regular
4JN16CS002,17CS61,50,30,80,P,9,Jul-20,Regular
4JN16CS002,17CS62,49,30,79,P,8,Jul-20,Regular
4JN16CS002,17CS653,50,30,80,P,9,Jul-20,Regular
4JN16CS002,17CS63,49,30,79,P,8,Jul-20,Regular
4JN16CS002,17CS664,45,30,75,P,8,Jul-20,Regular
4JN16CS002,17CS64,45,30,75,P,8,Jul-20,Regular
4JN16CS002,17CSL67,48,30,78,P,8,Jul-20,Regular
4JN16CS002,17CSL68,49,30,79,P,8,Jul-20,Regular
4JN17CS002,17CS61,50,25,75,P,8,Jul-20,Regular
4JN17CS002,17CS62,50,25,75,P,8,Jul-20,Regular
4JN17CS002,17CS653,49,25,74,P,8,Jul-20,Regular
4JN17CS002,17CS63,44,25,69,P,7,Jul-20,Regular
4JN17CS002,17CS664,48,25,73,P,8,Jul-20,Regular
4JN17CS002,17CS64,45,25,70,P,8,Jul-20,Regular
4JN17CS002,17CSL67,45,25,70,P,8,Jul-20,Regular
4JN17CS002,17CSL68,50,25,75,P,8,Jul-20,Regular
4JN17CS004,17CS61,50,38,88,P,9,Jul-20,Regular
4JN17CS004,17CS62,50,38,88,P,9,Jul-20,Regular
4JN17CS004,17CS653,50,38,88,P,9,Jul-20,Regular
4JN17CS004,17CS63,49,38,87,P,9,Jul-20,Regular
4JN17CS004,17CS664,47,38,85,P,9,Jul-20,Regular
4JN17CS004,17CS64,49,38,87,P,9,Jul-20,Regular
4JN17CS004,17CSL67,45,38,83,P,9,Jul-20,Regular
4JN17CS004,17CSL68,50,38,88,P,9,Jul-20,Regular
4JN17CS008,17CS61,50,37,87,P,9,Jul-20,Regular
4JN17CS008,17CS62,49,37,86,P,9,Jul-20,Regular
4JN17CS008,17CS653,50,37,87,P,9,Jul-20,Regular
4JN17CS008,17CS63,50,37,87,P,9,Jul-20,Regular
4JN17CS008,17CS64,50,37,87,P,9,Jul-20,Regular
4JN17CS008,17CS664,49,37,86,P,9,Jul-20,Regular
4JN17CS008,17CSL67,45,37,82,P,9,Jul-20,Regular
4JN17CS008,17CSL68,49,37,86,P,9,Jul-20,Regular
4JN17CS009,17CS61,50,38,88,P,9,Jul-20,Regular
4JN17CS009,17CS62,49,38,87,P,9,Jul-20,Regular
4JN17CS009,17CS653,50,38,88,P,9,Jul-20,Regular
4JN17CS009,17CS63,49,38,87,P,9,Jul-20,Regular
4JN17CS009,17CS664,50,38,88,P,9,Jul-20,Regular
4JN17CS009,17CS64,49,38,87,P,9,Jul-20,Regular
4JN17CS009,17CSL67,48,38,86,P,9,Jul-20,Regular
4JN17CS009,17CSL68,49,38,87,P,9,Jul-20,Regular
4JN17CS010,17CS61,49,30,79,P,8,Jul-20,Regular
4JN17CS010,17CS62,50,30,80,P,9,Jul-20,Regular
4JN17CS010,17CS653,48,30,78,P,8,Jul-20,Regular
4JN17CS010,17CS63,47,30,77,P,8,Jul-20,Regular
4JN17CS010,17CS664,48,30,78,P,8,Jul-20,Regular
4JN17CS010,17CS64,48,30,78,P,8,Jul-20,Regular
4JN17CS010,17CSL67,45,30,75,P,8,Jul-20,Regular
4JN17CS010,17CSL68,50,30,80,P,9,Jul-20,Regular
4JN17CS012,17CS61,50,32,82,P,9,Jul-20,Regular
4JN17CS012,17CS62,50,32,82,P,9,Jul-20,Regular
4JN17CS012,17CS653,50,32,82,P,9,Jul-20,Regular
4JN17CS012,17CS63,47,32,79,P,8,Jul-20,Regular
4JN17CS012,17CS664,43,32,75,P,8,Jul-20,Regular
4JN17CS012,17CS64,48,32,80,P,9,Jul-20,Regular
4JN17CS012,17CSL67,44,32,76,P,8,Jul-20,Regular
4JN17CS012,17CSL68,50,32,82,P,9,Jul-20,Regular
4JN17CS013,17CS61,50,29,79,P,8,Jul-20,Regular
4JN17CS013,17CS62,50,29,79,P,8,Jul-20,Regular
4JN17CS013,17CS653,49,29,78,P,8,Jul-20,Regular
4JN17CS013,17CS63,44,29,73,P,8,Jul-20,Regular
4JN17CS013,17CS664,48,29,77,P,8,Jul-20,Regular
4JN17CS013,17CS64,45,29,74,P,8,Jul-20,Regular
4JN17CS013,17CSL67,47,29,76,P,8,Jul-20,Regular
4JN17CS013,17CSL68,50,29,79,P,8,Jul-20,Regular
4JN17CS014,17CS61,50,38,88,P,9,Jul-20,Regular
4JN17CS014,17CS62,50,38,88,P,9,Jul-20,Regular
4JN17CS014,17CS653,49,38,87,P,9,Jul-20,Regular
4JN17CS014,17CS63,49,38,87,P,9,Jul-20,Regular
4JN17CS014,17CS664,49,38,87,P,9,Jul-20,Regular
4JN17CS014,17CS64,50,38,88,P,9,Jul-20,Regular
4JN17CS014,17CSL67,45,38,83,P,9,Jul-20,Regular
4JN17CS014,17CSL68,50,38,88,P,9,Jul-20,Regular
4JN17CS016,17CS61,50,39,89,P,9,Jul-20,Regular
4JN17CS016,17CS62,50,39,89,P,9,Jul-20,Regular
4JN17CS016,17CS653,50,39,89,P,9,Jul-20,Regular
4JN17CS016,17CS63,48,39,87,P,9,Jul-20,Regular
4JN17CS016,17CS64,50,39,89,P,9,Jul-20,Regular
4JN17CS016,17CS664,47,39,86,P,9,Jul-20,Regular
4JN17CS016,17CSL67,45,39,84,P,9,Jul-20,Regular
4JN17CS016,17CSL68,50,39,89,P,9,Jul-20,Regular
4JN17CS019,17CS61,50,38,88,P,9,Jul-20,Regular
4JN17CS019,17CS62,50,38,88,P,9,Jul-20,Regular
4JN17CS019,17CS653,49,38,87,P,9,Jul-20,Regular
4JN17CS019,17CS63,48,38,86,P,9,Jul-20,Regular
4JN17CS019,17CS664,48,38,86,P,9,Jul-20,Regular
4JN17CS019,17CS64,50,38,88,P,9,Jul-20,Regular
4JN17CS019,17CSL67,48,38,86,P,9,Jul-20,Regular
4JN17CS019,17CSL68,50,38,88,P,9,Jul-20,Regular
4JN17CS025,17CS61,50,33,83,P,9,Jul-20,Regular
4JN17CS025,17CS62,50,33,83,P,9,Jul-20,Regular
4JN17CS025,17CS653,50,33,83,P,9,Jul-20,Regular
4JN17CS025,17CS63,45,33,78,P,8,Jul-20,Regular
4JN17CS025,17CS664,47,33,80,P,9,Jul-20,Regular
4JN17CS025,17CS64,47,33,80,P,9,Jul-20,Regular
4JN17CS025,17CSL67,44,33,77,P,8,Jul-20,Regular
4JN17CS025,17CSL68,50,33,83,P,9,Jul-20,Regular
4JN17CS026,17CS61,50,33,83,P,9,Jul-20,Regular
4JN17CS026,17CS62,50,33,83,P,9,Jul-20,Regular
4JN17CS026,17CS653,48,33,81,P,9,Jul-20,Regular
4JN17CS026,17CS63,45,33,78,P,8,Jul-20,Regular
4JN17CS026,17CS664,47,33,80,P,9,Jul-20,Regular
4JN17CS026,17CS64,47,33,80,P,9,Jul-20,Regular
4JN17CS026,17CSL67,47,33,80,P,9,Jul-20,Regular
4JN17CS026,17CSL68,50,33,83,P,9,Jul-20,Regular
4JN17CS027,17CS61,50,37,87,P,9,Jul-20,Regular
4JN17CS027,17CS62,49,37,86,P,9,Jul-20,Regular
4JN17CS027,17CS653,50,37,87,P,9,Jul-20,Regular
4JN17CS027,17CS63,50,37,87,P,9,Jul-20,Regular
4JN17CS027,17CS64,49,37,86,P,9,Jul-20,Regular
4JN17CS027,17CS664,50,37,87,P,9,Jul-20,Regular
4JN17CS027,17CSL67,45,37,82,P,9,Jul-20,Regular
4JN17CS027,17CSL68,49,37,86,P,9,Jul-20,Regular
4JN17CS028,17CS61,50,38,88,P,9,Jul-20,Regular
4JN17CS028,17CS62,49,38,87,P,9,Jul-20,Regular
4JN17CS028,17CS653,50,38,88,P,9,Jul-20,Regular
4JN17CS028,17CS63,49,38,87,P,9,Jul-20,Regular
4JN17CS028,17CS664,50,38,88,P,9,Jul-20,Regular
4JN17CS028,17CS64,50,38,88,P,9,Jul-20,Regular
4JN17CS028,17CSL67,44,38,82,P,9,Jul-20,Regular
4JN17CS028,17CSL68,49,38,87,P,9,Jul-20,Regular
4JN17CS030,17CS61,49,25,74,P,8,Jul-20,Regular
4JN17CS030,17CS62,50,25,75,P,8,Jul-20,Regular
4JN17CS030,17CS653,49,25,74,P,8,Jul-20,Regular
4JN17CS030,17CS63,44,25,69,P,7,Jul-20,Regular
4JN17CS030,17CS664,48,25,73,P,8,Jul-20,Regular
4JN17CS030,17CS64,48,25,73,P,8,Jul-20,Regular
4JN17CS030,17CSL67,44,25,69,P,7,Jul-20,Regular
4JN17CS030,17CSL68,50,25,75,P,8,Jul-20,Regular
4JN17CS033,17CS61,50,30,80,P,9,Jul-20,Regular
4JN17CS033,17CS62,49,30,79,P,8,Jul-20,Regular
4JN17CS033,17CS653,50,30,80,P,9,Jul-20,Regular
4JN17CS033,17CS63,49,30,79,P,8,Jul-20,Regular
4JN17CS033,17CS664,47,30,77,P,8,Jul-20,Regular
4JN17CS033,17CS64,45,30,75,P,8,Jul-20,Regular
4JN17CS033,17CSL67,45,30,75,P,8,Jul-20,Regular
4JN17CS033,17CSL68,49,30,79,P,8,Jul-20,Regular
4JN17CS035,17CS61,50,29,79,P,8,Jul-20,Regular
4JN17CS035,17CS62,50,29,79,P,8,Jul-20,Regular
4JN17CS035,17CS653,50,29,79,P,8,Jul-20,Regular
4JN17CS035,17CS63,48,29,77,P,8,Jul-20,Regular
4JN17CS035,17CS664,45,29,74,P,8,Jul-20,Regular
4JN17CS035,17CS64,48,29,77,P,8,Jul-20,Regular
4JN17CS035,17CSL67,47,29,76,P,8,Jul-20,Regular
4JN17CS035,17CSL68,50,29,79,P,8,Jul-20,Regular
4JN17CS038,17CS61,50,37,87,P,9,Jul-20,Regular
4JN17CS038,17CS62,50,37,87,P,9,Jul-20,Regular
4JN17CS038,17CS653,45,37,82,P,9,Jul-20,Regular
4JN17CS038,17CS63,48,37,85,P,9,Jul-20,Regular
4JN17CS038,17CS664,49,37,86,P,9,Jul-20,Regular
4JN17CS038,17CS64,50,37,87,P,9,Jul-20,Regular
4JN17CS038,17CSL67,47,37,84,P,9,Jul-20,Regular
4JN17CS038,17CSL68,50,37,87,P,9,Jul-20,Regular
4JN17CS039,17CS61,50,40,90,P,10,Jul-20,Regular
4JN17CS039,17CS62,50,40,90,P,10,Jul-20,Regular
4JN17CS039,17CS653,50,40,90,P,10,Jul-20,Regular
4JN17CS039,17CS63,49,40,89,P,9,Jul-20,Regular
4JN17CS039,17CS664,48,40,88,P,9,Jul-20,Regular
4JN17CS039,17CS64,50,40,90,P,10,Jul-20,Regular
4JN17CS039,17CSL67,47,40,87,P,9,Jul-20,Regular
4JN17CS039,17CSL68,50,40,90,P,10,Jul-20,Regular
4JN17CS043,17CS61,50,38,88,P,9,Jul-20,Regular
4JN17CS043,17CS62,49,38,87,P,9,Jul-20,Regular
4JN17CS043,17CS653,50,38,88,P,9,Jul-20,Regular
4JN17CS043,17CS63,49,38,87,P,9,Jul-20,Regular
4JN17CS043,17CS64,48,38,86,P,9,Jul-20,Regular
4JN17CS043,17CS664,47,38,85,P,9,Jul-20,Regular
4JN17CS043,17CSL67,44,38,82,P,9,Jul-20,Regular
4JN17CS043,17CSL68,49,38,87,P,9,Jul-20,Regular
4JN17CS044,17CS61,50,28,78,P,8,Jul-20,Regular
4JN17CS044,17CS62,50,28,78,P,8,Jul-20,Regular
4JN17CS044,17CS653,50,28,78,P,8,Jul-20,Regular
4JN17CS044,17CS63,47,28,75,P,8,Jul-20,Regular
4JN17CS044,17CS664,45,28,73,P,8,Jul-20,Regular
4JN17CS044,17CS64,48,28,76,P,8,Jul-20,Regular
4JN17CS044,17CSL67,45,28,73,P,8,Jul-20,Regular
4JN17CS044,17CSL68,50,28,78,P,8,Jul-20,Regular
4JN17CS045,17CS61,49,30,79,P,8,Jul-20,Regular
4JN17CS045,17CS62,50,30,80,P,9,Jul-20,Regular
4JN17CS045,17CS653,45,30,75,P,8,Jul-20,Regular
4JN17CS045,17CS63,49,30,79,P,8,Jul-20,Regular
4JN17CS045,17CS664,47,30,77,P,8,Jul-20,Regular
4JN17CS045,17CS64,49,30,79,P,8,Jul-20,Regular
4JN17CS045,17CSL67,45,30,75,P,8,Jul-20,Regular
4JN17CS045,17CSL68,50,30,80,P,9,Jul-20,Regular
4JN17CS047,17CS61,50,25,75,P,8,Jul-20,Regular
4JN17CS047,17CS62,50,25,75,P,8,Jul-20,Regular
4JN17CS047,17CS653,50,25,75,P,8,Jul-20,Regular
4JN17CS047,17CS63,44,25,69,P,7,Jul-20,Regular
4JN17CS047,17CS664,45,25,70,P,8,Jul-20,Regular
4JN17CS047,17CS64,45,25,70,P,8,Jul-20,Regular
4JN17CS047,17CSL67,44,25,69,P,7,Jul-20,Regular
4JN17CS047,17CSL68,50,25,75,P,8,Jul-20,Regular
4JN17CS048,17CS61,50,29,79,P,8,Jul-20,Regular
4JN17CS048,17CS62,50,29,79,P,8,Jul-20,Regular
4JN17CS048,17CS653,49,29,78,P,8,Jul-20,Regular
4JN17CS048,17CS63,48,29,77,P,8,Jul-20,Regular
4JN17CS048,17CS664,48,29,77,P,8,Jul-20,Regular
4JN17CS048,17CS64,48,29,77,P,8,Jul-20,Regular
4JN17CS048,17CSL67,45,29,74,P,8,Jul-20,Regular
4JN17CS048,17CSL68,50,29,79,P,8,Jul-20,Regular
4JN17CS051,17CS61,50,28,78,P,8,Jul-20,Regular
4JN17CS051,17CS62,49,28,77,P,8,Jul-20,Regular
4JN17CS051,17CS653,50,28,78,P,8,Jul-20,Regular
4JN17CS051,17CS63,50,28,78,P,8,Jul-20,Regular
4JN17CS051,17CS664,48,28,76,P,8,Jul-20,Regular
4JN17CS051,17CS64,48,28,76,P,8,Jul-20,Regular
4JN17CS051,17CSL67,47,28,75,P,8,Jul-20,Regular
4JN17CS051,17CSL68,49,28,77,P,8,Jul-20,Regular
4JN17CS055,17CS61,50,29,79,P,8,Jul-20,Regular
4JN17CS055,17CS62,49,29,78,P,8,Jul-20,Regular
4JN17CS055,17CS653,50,29,79,P,8,Jul-20,Regular
4JN17CS055,17CS63,50,29,79,P,8,Jul-20,Regular
4JN17CS055,17CS64,47,29,76,P,8,Jul-20,Regular
4JN17CS055,17CS664,48,29,77,P,8,Jul-20,Regular
4JN17CS055,17CSL67,45,29,74,P,8,Jul-20,Regular
4JN17CS055,17CSL68,49,29,78,P,8,Jul-20,Regular
4JN17CS056,17CS61,50,38,88,P,9,Jul-20,Regular
4JN17CS056,17CS62,49,38,87,P,9,Jul-20,Regular
4JN17CS056,17CS653,50,38,88,P,9,Jul-20,Regular
4JN17CS056,17CS63,50,38,88,P,9,Jul-20,Regular
4JN17CS056,17CS664,49,38,87,P,9,Jul-20,Regular
4JN17CS056,17CS64,50,38,88,P,9,Jul-20,Regular
4JN17CS056,17CSL67,44,38,82,P,9,Jul-20,Regular
4JN17CS056,17CSL68,49,38,87,P,9,Jul-20,Regular
4JN17CS057,17CS61,50,29,79,P,8,Jul-20,Regular
4JN17CS057,17CS62,50,29,79,P,8,Jul-20,Regular
4JN17CS057,17CS653,49,29,78,P,8,Jul-20,Regular
4JN17CS057,17CS63,48,29,77,P,8,Jul-20,Regular
4JN17CS057,17CS664,48,29,77,P,8,Jul-20,Regular
4JN17CS057,17CS64,47,29,76,P,8,Jul-20,Regular
4JN17CS057,17CSL67,47,29,76,P,8,Jul-20,Regular
4JN17CS057,17CSL68,50,29,79,P,8,Jul-20,Regular
4JN17CS059,17CS61,49,28,77,P,8,Jul-20,Regular
4JN17CS059,17CS62,49,28,77,P,8,Jul-20,Regular
4JN17CS059,17CS653,50,28,78,P,8,Jul-20,Regular
4JN17CS059,17CS63,49,28,77,P,8,Jul-20,Regular
4JN17CS059,17CS64,50,28,78,P,8,Jul-20,Regular
4JN17CS059,17CS664,49,28,77,P,8,Jul-20,Regular
4JN17CS059,17CSL67,48,28,76,P,8,Jul-20,Regular
4JN17CS059,17CSL68,49,28,77,P,8,Jul-20,Regular
4JN17CS061,17CS61,50,30,80,P,9,Jul-20,Regular
4JN17CS061,17CS62,49,30,79,P,8,Jul-20,Regular
4JN17CS061,17CS653,50,30,80,P,9,Jul-20,Regular
4JN17CS061,17CS63,50,30,80,P,9,Jul-20,Regular
4JN17CS061,17CS664,45,30,75,P,8,Jul-20,Regular
4JN17CS061,17CS64,47,30,77,P,8,Jul-20,Regular
4JN17CS061,17CSL67,48,30,78,P,8,Jul-20,Regular
4JN17CS061,17CSL68,49,30,79,P,8,Jul-20,Regular
4JN17CS062,17CS61,50,36,86,P,9,Jul-20,Regular
4JN17CS062,17CS62,49,36,85,P,9,Jul-20,Regular
4JN17CS062,17CS653,50,36,86,P,9,Jul-20,Regular
4JN17CS062,17CS63,50,36,86,P,9,Jul-20,Regular
4JN17CS062,17CS664,49,36,85,P,9,Jul-20,Regular
4JN17CS062,17CS64,50,36,86,P,9,Jul-20,Regular
4JN17CS062,17CSL67,47,36,83,P,9,Jul-20,Regular
4JN17CS062,17CSL68,49,36,85,P,9,Jul-20,Regular
4JN17CS063,17CS61,50,29,79,P,8,Jul-20,Regular
4JN17CS063,17CS62,50,29,79,P,8,Jul-20,Regular
4JN17CS063,17CS653,49,29,78,P,8,Jul-20,Regular
4JN17CS063,17CS63,47,29,76,P,8,Jul-20,Regular
4JN17CS063,17CS664,45,29,74,P,8,Jul-20,Regular
4JN17CS063,17CS64,48,29,77,P,8,Jul-20,Regular
4JN17CS063,17CSL67,47,29,76,P,8,Jul-20,Regular
4JN17CS063,17CSL68,50,29,79,P,8,Jul-20,Regular
4JN17CS066,17CS61,50,32,82,P,9,Jul-20,Regular
4JN17CS066,17CS62,50,32,82,P,9,Jul-20,Regular
4JN17CS066,17CS653,49,32,81,P,9,Jul-20,Regular
4JN17CS066,17CS63,47,32,79,P,8,Jul-20,Regular
4JN17CS066,17CS664,43,32,75,P,8,Jul-20,Regular
4JN17CS066,17CS64,49,32,81,P,9,Jul-20,Regular
4JN17CS066,17CSL67,47,32,79,P,8,Jul-20,Regular
4JN17CS066,17CSL68,50,32,82,P,9,Jul-20,Regular
4JN17CS067,17CS61,49,30,79,P,8,Jul-20,Regular
4JN17CS067,17CS62,49,30,79,P,8,Jul-20,Regular
4JN17CS067,17CS653,50,30,80,P,9,Jul-20,Regular
4JN17CS067,17CS63,49,30,79,P,8,Jul-20,Regular
4JN17CS067,17CS664,48,30,78,P,8,Jul-20,Regular
4JN17CS067,17CS64,48,30,78,P,8,Jul-20,Regular
4JN17CS067,17CSL67,48,30,78,P,8,Jul-20,Regular
4JN17CS067,17CSL68,49,30,79,P,8,Jul-20,Regular
4JN17CS068,17CS61,50,31,81,P,9,Jul-20,Regular
4JN17CS068,17CS62,50,31,81,P,9,Jul-20,Regular
4JN17CS068,17CS653,49,31,80,P,9,Jul-20,Regular
4JN17CS068,17CS63,44,31,75,P,8,Jul-20,Regular
4JN17CS068,17CS64,48,31,79,P,8,Jul-20,Regular
4JN17CS068,17CS664,48,31,79,P,8,Jul-20,Regular
4JN17CS068,17CSL67,44,31,75,P,8,Jul-20,Regular
4JN17CS068,17CSL68,50,31,81,P,9,Jul-20,Regular
4JN17CS069,17CS61,50,39,89,P,9,Jul-20,Regular
4JN17CS069,17CS62,49,39,88,P,9,Jul-20,Regular
4JN17CS069,17CS653,50,39,89,P,9,Jul-20,Regular
4JN17CS069,17CS63,49,39,88,P,9,Jul-20,Regular
4JN17CS069,17CS664,49,39,88,P,9,Jul-20,Regular
4JN17CS069,17CS64,49,39,88,P,9,Jul-20,Regular
4JN17CS069,17CSL67,47,39,86,P,9,Jul-20,Regular
4JN17CS069,17CSL68,49,39,88,P,9,Jul-20,Regular
4JN17CS070,17CS61,50,37,87,P,9,Jul-20,Regular
4JN17CS070,17CS62,49,37,86,P,9,Jul-20,Regular
4JN17CS070,17CS653,50,37,87,P,9,Jul-20,Regular
4JN17CS070,17CS63,50,37,87,P,9,Jul-20,Regular
4JN17CS070,17CS664,49,37,86,P,9,Jul-20,Regular
4JN17CS070,17CS64,49,37,86,P,9,Jul-20,Regular
4JN17CS070,17CSL67,44,37,81,P,9,Jul-20,Regular
4JN17CS070,17CSL68,49,37,86,P,9,Jul-20,Regular
4JN17CS073,17CS61,49,25,74,P,8,Jul-20,Regular
4JN17CS073,17CS62,50,25,75,P,8,Jul-20,Regular
4JN17CS073,17CS653,50,25,75,P,8,Jul-20,Regular
4JN17CS073,17CS63,44,25,69,P,7,Jul-20,Regular
4JN17CS073,17CS664,45,25,70,P,8,Jul-20,Regular
4JN17CS073,17CS64,48,25,73,P,8,Jul-20,Regular
4JN17CS073,17CSL67,44,25,69,P,7,Jul-20,Regular
4JN17CS073,17CSL68,50,25,75,P,8,Jul-20,Regular
4JN17CS074,17CS61,50,32,82,P,9,Jul-20,Regular
4JN17CS074,17CS62,50,32,82,P,9,Jul-20,Regular
4JN17CS074,17CS653,50,32,82,P,9,Jul-20,Regular
4JN17CS074,17CS63,47,32,79,P,8,Jul-20,Regular
4JN17CS074,17CS664,47,32,79,P,8,Jul-20,Regular
4JN17CS074,17CS64,47,32,79,P,8,Jul-20,Regular
4JN17CS074,17CSL67,44,32,76,P,8,Jul-20,Regular
4JN17CS074,17CSL68,50,32,82,P,9,Jul-20,Regular
4JN17CS076,17CS61,50,33,83,P,9,Jul-20,Regular
4JN17CS076,17CS62,50,33,83,P,9,Jul-20,Regular
4JN17CS076,17CS653,50,33,83,P,9,Jul-20,Regular
4JN17CS076,17CS63,47,33,80,P,9,Jul-20,Regular
4JN17CS076,17CS664,45,33,78,P,8,Jul-20,Regular
4JN17CS076,17CS64,47,33,80,P,9,Jul-20,Regular
4JN17CS076,17CSL67,44,33,77,P,8,Jul-20,Regular
4JN17CS076,17CSL68,50,33,83,P,9,Jul-20,Regular
4JN17CS077,17CS61,49,34,83,P,9,Jul-20,Regular
4JN17CS077,17CS62,49,34,83,P,9,Jul-20,Regular
4JN17CS077,17CS653,50,34,84,P,9,Jul-20,Regular
4JN17CS077,17CS63,49,34,83,P,9,Jul-20,Regular
4JN17CS077,17CS664,47,34,81,P,9,Jul-20,Regular
4JN17CS077,17CS64,48,34,82,P,9,Jul-20,Regular
4JN17CS077,17CSL67,48,34,82,P,9,Jul-20,Regular
4JN17CS077,17CSL68,49,34,83,P,9,Jul-20,Regular
4JN17CS078,17CS61,49,31,80,P,9,Jul-20,Regular
4JN17CS078,17CS62,49,31,80,P,9,Jul-20,Regular
4JN17CS078,17CS653,50,31,81,P,9,Jul-20,Regular
4JN17CS078,17CS63,50,31,81,P,9,Jul-20,Regular
4JN17CS078,17CS664,45,31,76,P,8,Jul-20,Regular
4JN17CS078,17CS64,47,31,78,P,8,Jul-20,Regular
4JN17CS078,17CSL67,45,31,76,P,8,Jul-20,Regular
4JN17CS078,17CSL68,49,31,80,P,9,Jul-20,Regular
4JN17CS083,17CS61,49,37,86,P,9,Jul-20,Regular
4JN17CS083,17CS62,49,37,86,P,9,Jul-20,Regular
4JN17CS083,17CS653,50,37,87,P,9,Jul-20,Regular
4JN17CS083,17CS63,49,37,86,P,9,Jul-20,Regular
4JN17CS083,17CS664,50,37,87,P,9,Jul-20,Regular
4JN17CS083,17CS64,49,37,86,P,9,Jul-20,Regular
4JN17CS083,17CSL67,49,37,86,P,9,Jul-20,Regular
4JN17CS083,17CSL68,49,37,86,P,9,Jul-20,Regular
4JN17CS084,17CS61,49,28,77,P,8,Jul-20,Regular
4JN17CS084,17CS62,50,28,78,P,8,Jul-20,Regular
4JN17CS084,17CS653,49,28,77,P,8,Jul-20,Regular
4JN17CS084,17CS63,45,28,73,P,8,Jul-20,Regular
4JN17CS084,17CS64,49,28,77,P,8,Jul-20,Regular
4JN17CS084,17CS664,45,28,73,P,8,Jul-20,Regular
4JN17CS084,17CSL67,47,28,75,P,8,Jul-20,Regular
4JN17CS084,17CSL68,50,28,78,P,8,Jul-20,Regular
4JN17CS087,17CS61,50,39,89,P,9,Jul-20,Regular
4JN17CS087,17CS62,49,39,88,P,9,Jul-20,Regular
4JN17CS087,17CS653,50,39,89,P,9,Jul-20,Regular
4JN17CS087,17CS63,50,39,89,P,9,Jul-20,Regular
4JN17CS087,17CS64,49,39,88,P,9,Jul-20,Regular
4JN17CS087,17CS664,50,39,89,P,9,Jul-20,Regular
4JN17CS087,17CSL67,47,39,86,P,9,Jul-20,Regular
4JN17CS087,17CSL68,49,39,88,P,9,Jul-20,Regular
4JN17CS089,17CS61,50,36,86,P,9,Jul-20,Regular
4JN17CS089,17CS62,50,36,86,P,9,Jul-20,Regular
4JN17CS089,17CS653,50,36,86,P,9,Jul-20,Regular
4JN17CS089,17CS63,50,36,86,P,9,Jul-20,Regular
4JN17CS089,17CS664,47,36,83,P,9,Jul-20,Regular
4JN17CS089,17CS64,50,36,86,P,9,Jul-20,Regular
4JN17CS089,17CSL67,48,36,84,P,9,Jul-20,Regular
4JN17CS089,17CSL68,50,36,86,P,9,Jul-20,Regular
4JN17CS092,17CS61,50,35,85,P,9,Jul-20,Regular
4JN17CS092,17CS62,49,35,84,P,9,Jul-20,Regular
4JN17CS092,17CS653,50,35,85,P,9,Jul-20,Regular
4JN17CS092,17CS63,48,35,83,P,9,Jul-20,Regular
4JN17CS092,17CS664,49,35,84,P,9,Jul-20,Regular
4JN17CS092,17CS64,45,35,80,P,9,Jul-20,Regular
4JN17CS092,17CSL67,45,35,80,P,9,Jul-20,Regular
4JN17CS092,17CSL68,49,35,84,P,9,Jul-20,Regular
4JN17CS093,17CS61,50,37,87,P,9,Jul-20,Regular
4JN17CS093,17CS62,50,37,87,P,9,Jul-20,Regular
4JN17CS093,17CS653,49,37,86,P,9,Jul-20,Regular
4JN17CS093,17CS63,49,37,86,P,9,Jul-20,Regular
4JN17CS093,17CS664,47,37,84,P,9,Jul-20,Regular
4JN17CS093,17CS64,48,37,85,P,9,Jul-20,Regular
4JN17CS093,17CSL67,47,37,84,P,9,Jul-20,Regular
4JN17CS093,17CSL68,50,37,87,P,9,Jul-20,Regular
4JN17CS095,17CS61,50,36,86,P,9,Jul-20,Regular
4JN17CS095,17CS62,50,36,86,P,9,Jul-20,Regular
4JN17CS095,17CS653,50,36,86,P,9,Jul-20,Regular
4JN17CS095,17CS63,49,36,85,P,9,Jul-20,Regular
4JN17CS095,17CS664,50,36,86,P,9,Jul-20,Regular
4JN17CS095,17CS64,50,36,86,P,9,Jul-20,Regular
4JN17CS095,17CSL67,45,36,81,P,9,Jul-20,Regular
4JN17CS095,17CSL68,50,36,86,P,9,Jul-20,Regular
4JN17CS096,17CS61,49,38,87,P,9,Jul-20,Regular
4JN17CS096,17CS62,50,38,88,P,9,Jul-20,Regular
4JN17CS096,17CS653,50,38,88,P,9,Jul-20,Regular
4JN17CS096,17CS63,49,38,87,P,9,Jul-20,Regular
4JN17CS096,17CS664,45,38,83,P,9,Jul-20,Regular
4JN17CS096,17CS64,50,38,88,P,9,Jul-20,Regular
4JN17CS096,17CSL67,47,38,85,P,9,Jul-20,Regular
4JN17CS096,17CSL68,50,38,88,P,9,Jul-20,Regular
4JN17CS098,17CS61,50,34,84,P,9,Jul-20,Regular
4JN17CS098,17CS62,49,34,83,P,9,Jul-20,Regular
4JN17CS098,17CS653,50,34,84,P,9,Jul-20,Regular
4JN17CS098,17CS63,49,34,83,P,9,Jul-20,Regular
4JN17CS098,17CS664,45,34,79,P,8,Jul-20,Regular
4JN17CS098,17CS64,48,34,82,P,9,Jul-20,Regular
4JN17CS098,17CSL67,48,34,82,P,9,Jul-20,Regular
4JN17CS098,17CSL68,49,34,83,P,9,Jul-20,Regular
4JN17CS099,17CS61,50,36,86,P,9,Jul-20,Regular
4JN17CS099,17CS62,50,36,86,P,9,Jul-20,Regular
4JN17CS099,17CS653,50,36,86,P,9,Jul-20,Regular
4JN17CS099,17CS63,49,36,85,P,9,Jul-20,Regular
4JN17CS099,17CS664,48,36,84,P,9,Jul-20,Regular
4JN17CS099,17CS64,50,36,86,P,9,Jul-20,Regular
4JN17CS099,17CSL67,45,36,81,P,9,Jul-20,Regular
4JN17CS099,17CSL68,50,36,86,P,9,Jul-20,Regular
4JN17CS100,17CS61,50,36,86,P,9,Jul-20,Regular
4JN17CS100,17CS62,50,36,86,P,9,Jul-20,Regular
4JN17CS100,17CS653,50,36,86,P,9,Jul-20,Regular
4JN17CS100,17CS63,50,36,86,P,9,Jul-20,Regular
4JN17CS100,17CS664,49,36,85,P,9,Jul-20,Regular
4JN17CS100,17CS64,50,36,86,P,9,Jul-20,Regular
4JN17CS100,17CSL67,44,36,80,P,9,Jul-20,Regular
4JN17CS100,17CSL68,50,36,86,P,9,Jul-20,Regular
4JN17CS101,17CS61,50,28,78,P,8,Jul-20,Regular
4JN17CS101,17CS62,50,28,78,P,8,Jul-20,Regular
4JN17CS101,17CS653,49,28,77,P,8,Jul-20,Regular
4JN17CS101,17CS63,47,28,75,P,8,Jul-20,Regular
4JN17CS101,17CS664,45,28,73,P,8,Jul-20,Regular
4JN17CS101,17CS64,48,28,76,P,8,Jul-20,Regular
4JN17CS101,17CSL67,45,28,73,P,8,Jul-20,Regular
4JN17CS101,17CSL68,50,28,78,P,8,Jul-20,Regular
4JN17CS102,17CS61,50,34,84,P,9,Jul-20,Regular
4JN17CS102,17CS62,50,34,84,P,9,Jul-20,Regular
4JN17CS102,17CS653,49,34,83,P,9,Jul-20,Regular
4JN17CS102,17CS63,47,34,81,P,9,Jul-20,Regular
4JN17CS102,17CS664,45,34,79,P,8,Jul-20,Regular
4JN17CS102,17CS64,48,34,82,P,9,Jul-20,Regular
4JN17CS102,17CSL67,45,34,79,P,8,Jul-20,Regular
4JN17CS102,17CSL68,50,34,84,P,9,Jul-20,Regular
4JN17CS105,17CS61,50,32,82,P,9,Jul-20,Regular
4JN17CS105,17CS62,50,32,82,P,9,Jul-20,Regular
4JN17CS105,17CS653,50,32,82,P,9,Jul-20,Regular
4JN17CS105,17CS63,48,32,80,P,9,Jul-20,Regular
4JN17CS105,17CS664,45,32,77,P,8,Jul-20,Regular
4JN17CS105,17CS64,48,32,80,P,9,Jul-20,Regular
4JN17CS105,17CSL67,45,32,77,P,8,Jul-20,Regular
4JN17CS105,17CSL68,50,32,82,P,9,Jul-20,Regular
4JN17CS106,17CS61,50,33,83,P,9,Jul-20,Regular
4JN17CS106,17CS62,50,33,83,P,9,Jul-20,Regular
4JN17CS106,17CS653,49,33,82,P,9,Jul-20,Regular
4JN17CS106,17CS63,47,33,80,P,9,Jul-20,Regular
4JN17CS106,17CS64,48,33,81,P,9,Jul-20,Regular
4JN17CS106,17CS664,45,33,78,P,8,Jul-20,Regular
4JN17CS106,17CSL67,47,33,80,P,9,Jul-20,Regular
4JN17CS106,17CSL68,50,33,83,P,9,Jul-20,Regular
4JN17CS107,17CS61,50,35,85,P,9,Jul-20,Regular
4JN17CS107,17CS62,50,35,85,P,9,Jul-20,Regular
4JN17CS107,17CS653,48,35,83,P,9,Jul-20,Regular
4JN17CS107,17CS63,50,35,85,P,9,Jul-20,Regular
4JN17CS107,17CS64,50,35,85,P,9,Jul-20,Regular
4JN17CS107,17CS664,47,35,82,P,9,Jul-20,Regular
4JN17CS107,17CSL67,47,35,82,P,9,Jul-20,Regular
4JN17CS107,17CSL68,50,35,85,P,9,Jul-20,Regular
4JN17CS108,17CS61,50,38,88,P,9,Jul-20,Regular
4JN17CS108,17CS62,49,38,87,P,9,Jul-20,Regular
4JN17CS108,17CS653,50,38,88,P,9,Jul-20,Regular
4JN17CS108,17CS63,49,38,87,P,9,Jul-20,Regular
4JN17CS108,17CS664,48,38,86,P,9,Jul-20,Regular
4JN17CS108,17CS64,49,38,87,P,9,Jul-20,Regular
4JN17CS108,17CSL67,47,38,85,P,9,Jul-20,Regular
4JN17CS108,17CSL68,49,38,87,P,9,Jul-20,Regular
4JN17CS111,17CS61,50,34,84,P,9,Jul-20,Regular
4JN17CS111,17CS62,50,34,84,P,9,Jul-20,Regular
4JN17CS111,17CS653,50,34,84,P,9,Jul-20,Regular
4JN17CS111,17CS63,45,34,79,P,8,Jul-20,Regular
4JN17CS111,17CS664,47,34,81,P,9,Jul-20,Regular
4JN17CS111,17CS64,50,34,84,P,9,Jul-20,Regular
4JN17CS111,17CSL67,44,34,78,P,8,Jul-20,Regular
4JN17CS111,17CSL68,50,34,84,P,9,Jul-20,Regular
4JN17CS112,17CS61,50,34,84,P,9,Jul-20,Regular
4JN17CS112,17CS62,50,34,84,P,9,Jul-20,Regular
4JN17CS112,17CS653,50,34,84,P,9,Jul-20,Regular
4JN17CS112,17CS63,45,34,79,P,8,Jul-20,Regular
4JN17CS112,17CS664,45,34,79,P,8,Jul-20,Regular
4JN17CS112,17CS64,48,34,82,P,9,Jul-20,Regular
4JN17CS112,17CSL67,45,34,79,P,8,Jul-20,Regular
4JN17CS112,17CSL68,50,34,84,P,9,Jul-20,Regular
4JN17CS113,17CS61,50,32,82,P,9,Jul-20,Regular
4JN17CS113,17CS62,50,32,82,P,9,Jul-20,Regular
4JN17CS113,17CS653,49,32,81,P,9,Jul-20,Regular
4JN17CS113,17CS63,47,32,79,P,8,Jul-20,Regular
4JN17CS113,17CS664,47,32,79,P,8,Jul-20,Regular
4JN17CS113,17CS64,48,32,80,P,9,Jul-20,Regular
4JN17CS113,17CSL67,47,32,79,P,8,Jul-20,Regular
4JN17CS113,17CSL68,50,32,82,P,9,Jul-20,Regular
4JN17CS115,17CS61,49,36,85,P,9,Jul-20,Regular
4JN17CS115,17CS62,49,36,85,P,9,Jul-20,Regular
4JN17CS115,17CS653,50,36,86,P,9,Jul-20,Regular
4JN17CS115,17CS63,49,36,85,P,9,Jul-20,Regular
4JN17CS115,17CS664,48,36,84,P,9,Jul-20,Regular
4JN17CS115,17CS64,49,36,85,P,9,Jul-20,Regular
4JN17CS115,17CSL67,48,36,84,P,9,Jul-20,Regular
4JN17CS115,17CSL68,49,36,85,P,9,Jul-20,Regular
4JN17CS116,17CS61,50,30,80,P,9,Jul-20,Regular
4JN17CS116,17CS62,50,30,80,P,9,Jul-20,Regular
4JN17CS116,17CS653,49,30,79,P,8,Jul-20,Regular
4JN17CS116,17CS63,49,30,79,P,8,Jul-20,Regular
4JN17CS116,17CS664,47,30,77,P,8,Jul-20,Regular
4JN17CS116,17CS64,50,30,80,P,9,Jul-20,Regular
4JN17CS116,17CSL67,44,30,74,P,8,Jul-20,Regular
4JN17CS116,17CSL68,50,30,80,P,9,Jul-20,Regular
4JN17CS117,17CS61,50,31,81,P,9,Jul-20,Regular
4JN17CS117,17CS62,50,31,81,P,9,Jul-20,Regular
4JN17CS117,17CS653,49,31,80,P,9,Jul-20,Regular
4JN17CS117,17CS63,50,31,81,P,9,Jul-20,Regular
4JN17CS117,17CS664,47,31,78,P,8,Jul-20,Regular
4JN17CS117,17CS64,49,31,80,P,9,Jul-20,Regular
4JN17CS117,17CSL67,47,31,78,P,8,Jul-20,Regular
4JN17CS117,17CSL68,50,31,81,P,9,Jul-20,Regular
4JN17CS118,17CS61,50,34,84,P,9,Jul-20,Regular
4JN17CS118,17CS62,50,34,84,P,9,Jul-20,Regular
4JN17CS118,17CS653,50,34,84,P,9,Jul-20,Regular
4JN17CS118,17CS63,48,34,82,P,9,Jul-20,Regular
4JN17CS118,17CS664,45,34,79,P,8,Jul-20,Regular
4JN17CS118,17CS64,48,34,82,P,9,Jul-20,Regular
4JN17CS118,17CSL67,45,34,79,P,8,Jul-20,Regular
4JN17CS118,17CSL68,50,34,84,P,9,Jul-20,Regular
4JN17CS119,17CS61,50,29,79,P,8,Jul-20,Regular
4JN17CS119,17CS62,50,29,79,P,8,Jul-20,Regular
4JN17CS119,17CS653,50,29,79,P,8,Jul-20,Regular
4JN17CS119,17CS63,45,29,74,P,8,Jul-20,Regular
4JN17CS119,17CS664,44,29,73,P,8,Jul-20,Regular
4JN17CS119,17CS64,49,29,78,P,8,Jul-20,Regular
4JN17CS119,17CSL67,45,29,74,P,8,Jul-20,Regular
4JN17CS119,17CSL68,50,29,79,P,8,Jul-20,Regular
4JN17CS120,17CS61,49,32,81,P,9,Jul-20,Regular
4JN17CS120,17CS62,50,32,82,P,9,Jul-20,Regular
4JN17CS120,17CS653,45,32,77,P,8,Jul-20,Regular
4JN17CS120,17CS63,47,32,79,P,8,Jul-20,Regular
4JN17CS120,17CS64,49,32,81,P,9,Jul-20,Regular
4JN17CS120,17CS664,45,32,77,P,8,Jul-20,Regular
4JN17CS120,17CSL67,47,32,79,P,8,Jul-20,Regular
4JN17CS120,17CSL68,50,32,82,P,9,Jul-20,Regular
4JN17CS122,17CS61,49,31,80,P,9,Jul-20,Regular
4JN17CS122,17CS62,49,31,80,P,9,Jul-20,Regular
4JN17CS122,17CS653,50,31,81,P,9,Jul-20,Regular
4JN17CS122,17CS63,50,31,81,P,9,Jul-20,Regular
4JN17CS122,17CS664,48,31,79,P,8,Jul-20,Regular
4JN17CS122,17CS64,48,31,79,P,8,Jul-20,Regular
4JN17CS122,17CSL67,45,31,76,P,8,Jul-20,Regular
4JN17CS122,17CSL68,49,31,80,P,9,Jul-20,Regular
4JN17CS123,17CS61,50,29,79,P,8,Jul-20,Regular
4JN17CS123,17CS62,49,29,78,P,8,Jul-20,Regular
4JN17CS123,17CS653,50,29,79,P,8,Jul-20,Regular
4JN17CS123,17CS63,50,29,79,P,8,Jul-20,Regular
4JN17CS123,17CS664,44,29,73,P,8,Jul-20,Regular
4JN17CS123,17CS64,48,29,77,P,8,Jul-20,Regular
4JN17CS123,17CSL67,47,29,76,P,8,Jul-20,Regular
4JN17CS123,17CSL68,49,29,78,P,8,Jul-20,Regular
4JN17CS124,17CS61,50,25,75,P,8,Jul-20,Regular
4JN17CS124,17CS62,49,25,74,P,8,Jul-20,Regular
4JN17CS124,17CS653,50,25,75,P,8,Jul-20,Regular
4JN17CS124,17CS63,49,25,74,P,8,Jul-20,Regular
4JN17CS124,17CS664,44,25,69,P,7,Jul-20,Regular
4JN17CS124,17CS64,47,25,72,P,8,Jul-20,Regular
4JN17CS124,17CSL67,45,25,70,P,8,Jul-20,Regular
4JN17CS124,17CSL68,49,25,74,P,8,Jul-20,Regular
4JN17CS125,17CS61,50,31,81,P,9,Jul-20,Regular
4JN17CS125,17CS62,50,31,81,P,9,Jul-20,Regular
4JN17CS125,17CS653,49,31,80,P,9,Jul-20,Regular
4JN17CS125,17CS63,47,31,78,P,8,Jul-20,Regular
4JN17CS125,17CS664,48,31,79,P,8,Jul-20,Regular
4JN17CS125,17CS64,50,31,81,P,9,Jul-20,Regular
4JN17CS125,17CSL67,47,31,78,P,8,Jul-20,Regular
4JN17CS125,17CSL68,50,31,81,P,9,Jul-20,Regular
4JN17CS127,17CS61,48,29,77,P,8,Jul-20,Regular
4JN17CS127,17CS62,49,29,78,P,8,Jul-20,Regular
4JN17CS127,17CS653,50,29,79,P,8,Jul-20,Regular
4JN17CS127,17CS63,49,29,78,P,8,Jul-20,Regular
4JN17CS127,17CS664,47,29,76,P,8,Jul-20,Regular
4JN17CS127,17CS64,48,29,77,P,8,Jul-20,Regular
4JN17CS127,17CSL67,48,29,77,P,8,Jul-20,Regular
4JN17CS127,17CSL68,49,29,78,P,8,Jul-20,Regular
4JN17CS128,17CS61,50,26,76,P,8,Jul-20,Regular
4JN17CS128,17CS62,49,26,75,P,8,Jul-20,Regular
4JN17CS128,17CS653,50,26,76,P,8,Jul-20,Regular
4JN17CS128,17CS63,49,26,75,P,8,Jul-20,Regular
4JN17CS128,17CS664,47,26,73,P,8,Jul-20,Regular
4JN17CS128,17CS64,47,26,73,P,8,Jul-20,Regular
4JN17CS128,17CSL67,44,26,70,P,8,Jul-20,Regular
4JN17CS128,17CSL68,49,26,75,P,8,Jul-20,Regular
4JN17CS129,17CS61,48,28,76,P,8,Jul-20,Regular
4JN17CS129,17CS62,49,28,77,P,8,Jul-20,Regular
4JN17CS129,17CS653,50,28,78,P,8,Jul-20,Regular
4JN17CS129,17CS63,50,28,78,P,8,Jul-20,Regular
4JN17CS129,17CS664,47,28,75,P,8,Jul-20,Regular
4JN17CS129,17CS64,47,28,75,P,8,Jul-20,Regular
4JN17CS129,17CSL67,45,28,73,P,8,Jul-20,Regular
4JN17CS129,17CSL68,49,28,77,P,8,Jul-20,Regular
4JN17CS130,17CS61,49,29,78,P,8,Jul-20,Regular
4JN17CS130,17CS62,49,29,78,P,8,Jul-20,Regular
4JN17CS130,17CS653,50,29,79,P,8,Jul-20,Regular
4JN17CS130,17CS63,50,29,79,P,8,Jul-20,Regular
4JN17CS130,17CS664,45,29,74,P,8,Jul-20,Regular
4JN17CS130,17CS64,45,29,74,P,8,Jul-20,Regular
4JN17CS130,17CSL67,45,29,74,P,8,Jul-20,Regular
4JN17CS130,17CSL68,49,29,78,P,8,Jul-20,Regular
4JN17CS034,17CS61,48,26,74,P,8,Jul-20,Regular
4JN17CS034,17CS62,49,26,75,P,8,Jul-20,Regular
4JN17CS034,17CS63,49,26,75,P,8,Jul-20,Regular
4JN17CS034,17CS664,42,26,68,P,7,Jul-20,Regular
4JN17CS034,17CS654,44,26,70,P,8,Jul-20,Regular
4JN17CS034,17CS64,45,26,71,P,8,Jul-20,Regular
4JN17CS034,17CSL67,45,26,71,P,8,Jul-20,Regular
4JN17CS034,17CSL68,49,26,75,P,8,Jul-20,Regular
4JN17CS097,17CS61,48,22,70,P,8,Jul-20,Regular
4JN17CS097,17CS62,49,22,71,P,8,Jul-20,Regular
4JN17CS097,17CS63,49,22,71,P,8,Jul-20,Regular
4JN17CS097,17CS664,47,22,69,P,7,Jul-20,Regular
4JN17CS097,17CS654,47,22,69,P,7,Jul-20,Regular
4JN17CS097,17CS64,45,22,67,P,7,Jul-20,Regular
4JN17CS097,17CSL67,48,22,70,P,8,Jul-20,Regular
4JN17CS097,17CSL68,49,22,71,P,8,Jul-20,Regular
4JN17CS114,17CS61,49,20,69,P,7,Jul-20,Regular
4JN17CS114,17CS62,49,20,69,P,7,Jul-20,Regular
4JN17CS114,17CS63,50,20,70,P,8,Jul-20,Regular
4JN17CS114,17CS664,47,20,67,P,7,Jul-20,Regular
4JN17CS114,17CS654,49,20,69,P,7,Jul-20,Regular
4JN17CS114,17CS64,47,20,67,P,7,Jul-20,Regular
4JN17CS114,17CSL67,47,20,67,P,7,Jul-20,Regular
4JN17CS114,17CSL68,49,20,69,P,7,Jul-20,Regular
4JN17CS011,17CS61,49,31,80,P,9,Jul-20,Regular
4JN17CS011,17CS62,49,31,80,P,9,Jul-20,Regular
4JN17CS011,17CS63,49,31,80,P,9,Jul-20,Regular
4JN17CS011,17CS654,50,31,81,P,9,Jul-20,Regular
4JN17CS011,17CS64,49,31,80,P,9,Jul-20,Regular
4JN17CS011,17CS664,47,31,78,P,8,Jul-20,Regular
4JN17CS011,17CSL67,45,31,76,P,8,Jul-20,Regular
4JN17CS011,17CSL68,49,31,80,P,9,Jul-20,Regular
4JN17CS015,17CS61,49,30,79,P,8,Jul-20,Regular
4JN17CS015,17CS62,49,30,79,P,8,Jul-20,Regular
4JN17CS015,17CS63,50,30,80,P,9,Jul-20,Regular
4JN17CS015,17CS664,48,30,78,P,8,Jul-20,Regular
4JN17CS015,17CS654,50,30,80,P,9,Jul-20,Regular
4JN17CS015,17CS64,47,30,77,P,8,Jul-20,Regular
4JN17CS015,17CSL67,48,30,78,P,8,Jul-20,Regular
4JN17CS015,17CSL68,49,30,79,P,8,Jul-20,Regular
4JN17CS020,17CS61,50,29,79,P,8,Jul-20,Regular
4JN17CS020,17CS62,49,29,78,P,8,Jul-20,Regular
4JN17CS020,17CS63,50,29,79,P,8,Jul-20,Regular
4JN17CS020,17CS664,48,29,77,P,8,Jul-20,Regular
4JN17CS020,17CS654,50,29,79,P,8,Jul-20,Regular
4JN17CS020,17CS64,47,29,76,P,8,Jul-20,Regular
4JN17CS020,17CSL67,45,29,74,P,8,Jul-20,Regular
4JN17CS020,17CSL68,49,29,78,P,8,Jul-20,Regular
4JN17CS021,17CS61,49,28,77,P,8,Jul-20,Regular
4JN17CS021,17CS62,49,28,77,P,8,Jul-20,Regular
4JN17CS021,17CS63,49,28,77,P,8,Jul-20,Regular
4JN17CS021,17CS664,47,28,75,P,8,Jul-20,Regular
4JN17CS021,17CS654,50,28,78,P,8,Jul-20,Regular
4JN17CS021,17CS64,49,28,77,P,8,Jul-20,Regular
4JN17CS021,17CSL67,45,28,73,P,8,Jul-20,Regular
4JN17CS021,17CSL68,49,28,77,P,8,Jul-20,Regular
4JN17CS029,17CS61,48,25,73,P,8,Jul-20,Regular
4JN17CS029,17CS62,49,25,74,P,8,Jul-20,Regular
4JN17CS029,17CS63,44,25,69,P,7,Jul-20,Regular
4JN17CS029,17CS664,42,25,67,P,7,Jul-20,Regular
4JN17CS029,17CS654,47,25,72,P,8,Jul-20,Regular
4JN17CS029,17CS64,45,25,70,P,8,Jul-20,Regular
4JN17CS029,17CSL67,48,25,73,P,8,Jul-20,Regular
4JN17CS029,17CSL68,49,25,74,P,8,Jul-20,Regular
4JN17CS031,17CS61,50,37,87,P,9,Jul-20,Regular
4JN17CS031,17CS62,50,37,87,P,9,Jul-20,Regular
4JN17CS031,17CS63,47,37,84,P,9,Jul-20,Regular
4JN17CS031,17CS664,48,37,85,P,9,Jul-20,Regular
4JN17CS031,17CS654,49,37,86,P,9,Jul-20,Regular
4JN17CS031,17CS64,49,37,86,P,9,Jul-20,Regular
4JN17CS031,17CSL67,45,37,82,P,9,Jul-20,Regular
4JN17CS031,17CSL68,50,37,87,P,9,Jul-20,Regular
4JN17CS036,17CS61,50,29,79,P,8,Jul-20,Regular
4JN17CS036,17CS62,49,29,78,P,8,Jul-20,Regular
4JN17CS036,17CS63,49,29,78,P,8,Jul-20,Regular
4JN17CS036,17CS664,50,29,79,P,8,Jul-20,Regular
4JN17CS036,17CS654,50,29,79,P,8,Jul-20,Regular
4JN17CS036,17CS64,48,29,77,P,8,Jul-20,Regular
4JN17CS036,17CSL67,44,29,73,P,8,Jul-20,Regular
4JN17CS036,17CSL68,49,29,78,P,8,Jul-20,Regular
4JN17CS040,17CS61,50,26,76,P,8,Jul-20,Regular
4JN17CS040,17CS62,49,26,75,P,8,Jul-20,Regular
4JN17CS040,17CS63,50,26,76,P,8,Jul-20,Regular
4JN17CS040,17CS654,50,26,76,P,8,Jul-20,Regular
4JN17CS040,17CS64,45,26,71,P,8,Jul-20,Regular
4JN17CS040,17CS664,47,26,73,P,8,Jul-20,Regular
4JN17CS040,17CSL67,48,26,74,P,8,Jul-20,Regular
4JN17CS040,17CSL68,49,26,75,P,8,Jul-20,Regular
4JN17CS042,17CS61,50,33,83,P,9,Jul-20,Regular
4JN17CS042,17CS62,49,33,82,P,9,Jul-20,Regular
4JN17CS042,17CS63,49,33,82,P,9,Jul-20,Regular
4JN17CS042,17CS664,49,33,82,P,9,Jul-20,Regular
4JN17CS042,17CS654,50,33,83,P,9,Jul-20,Regular
4JN17CS042,17CS64,49,33,82,P,9,Jul-20,Regular
4JN17CS042,17CSL67,49,33,82,P,9,Jul-20,Regular
4JN17CS042,17CSL68,49,33,82,P,9,Jul-20,Regular
4JN17CS052,17CS61,50,27,77,P,8,Jul-20,Regular
4JN17CS052,17CS62,49,27,76,P,8,Jul-20,Regular
4JN17CS052,17CS63,49,27,76,P,8,Jul-20,Regular
4JN17CS052,17CS664,49,27,76,P,8,Jul-20,Regular
4JN17CS052,17CS654,50,27,77,P,8,Jul-20,Regular
4JN17CS052,17CS64,48,27,75,P,8,Jul-20,Regular
4JN17CS052,17CSL67,48,27,75,P,8,Jul-20,Regular
4JN17CS052,17CSL68,49,27,76,P,8,Jul-20,Regular
4JN17CS080,17CS61,49,32,81,P,9,Jul-20,Regular
4JN17CS080,17CS62,49,32,81,P,9,Jul-20,Regular
4JN17CS080,17CS63,50,32,82,P,9,Jul-20,Regular
4JN17CS080,17CS664,47,32,79,P,8,Jul-20,Regular
4JN17CS080,17CS654,50,32,82,P,9,Jul-20,Regular
4JN17CS080,17CS64,47,32,79,P,8,Jul-20,Regular
4JN17CS080,17CSL67,48,32,80,P,9,Jul-20,Regular
4JN17CS080,17CSL68,49,32,81,P,9,Jul-20,Regular
4JN17CS090,17CS61,47,27,74,P,8,Jul-20,Regular
4JN17CS090,17CS62,49,27,76,P,8,Jul-20,Regular
4JN17CS090,17CS63,45,27,72,P,8,Jul-20,Regular
4JN17CS090,17CS664,44,27,71,P,8,Jul-20,Regular
4JN17CS090,17CS654,48,27,75,P,8,Jul-20,Regular
4JN17CS090,17CS64,45,27,72,P,8,Jul-20,Regular
4JN17CS090,17CSL67,48,27,75,P,8,Jul-20,Regular
4JN17CS090,17CSL68,49,27,76,P,8,Jul-20,Regular
4JN17CS110,17CS61,50,31,81,P,9,Jul-20,Regular
4JN17CS110,17CS62,49,31,80,P,9,Jul-20,Regular
4JN17CS110,17CS63,50,31,81,P,9,Jul-20,Regular
4JN17CS110,17CS664,47,31,78,P,8,Jul-20,Regular
4JN17CS110,17CS654,50,31,81,P,9,Jul-20,Regular
4JN17CS110,17CS64,49,31,80,P,9,Jul-20,Regular
4JN17CS110,17CSL67,47,31,78,P,8,Jul-20,Regular
4JN17CS110,17CSL68,49,31,80,P,9,Jul-20,Regular
4JN18CS402,17CS61,49,25,74,P,8,Jul-20,Regular
4JN18CS402,17CS62,50,25,75,P,8,Jul-20,Regular
4JN18CS402,17CS63,45,25,70,P,8,Jul-20,Regular
4JN18CS402,17CS664,47,25,72,P,8,Jul-20,Regular
4JN18CS402,17CS654,48,25,73,P,8,Jul-20,Regular
4JN18CS402,17CS64,48,25,73,P,8,Jul-20,Regular
4JN18CS402,17CSL67,44,25,69,P,7,Jul-20,Regular
4JN18CS402,17CSL68,50,25,75,P,8,Jul-20,Regular
4JN18CS410,17CS61,50,30,80,P,9,Jul-20,Regular
4JN18CS410,17CS62,50,30,80,P,9,Jul-20,Regular
4JN18CS410,17CS63,49,30,79,P,8,Jul-20,Regular
4JN18CS410,17CS664,47,30,77,P,8,Jul-20,Regular
4JN18CS410,17CS654,48,30,78,P,8,Jul-20,Regular
4JN18CS410,17CS64,50,30,80,P,9,Jul-20,Regular
4JN18CS410,17CSL67,47,30,77,P,8,Jul-20,Regular
4JN18CS410,17CSL68,50,30,80,P,9,Jul-20,Regular
4JN18CS418,17CS61,49,31,80,P,9,Jul-20,Regular
4JN18CS418,17CS62,50,31,81,P,9,Jul-20,Regular
4JN18CS418,17CS63,48,31,79,P,8,Jul-20,Regular
4JN18CS418,17CS664,49,31,80,P,9,Jul-20,Regular
4JN18CS418,17CS654,49,31,80,P,9,Jul-20,Regular
4JN18CS418,17CS64,49,31,80,P,9,Jul-20,Regular
4JN18CS418,17CSL67,44,31,75,P,8,Jul-20,Regular
4JN18CS418,17CSL68,50,31,81,P,9,Jul-20,Regular
4JN18CS411,17CS61,49,26,75,P,8,Jul-20,Regular
4JN18CS411,17CS62,49,26,75,P,8,Jul-20,Regular
4JN18CS411,17CS63,49,26,75,P,8,Jul-20,Regular
4JN18CS411,17CS664,44,26,70,P,8,Jul-20,Regular
4JN18CS411,17CS654,45,26,71,P,8,Jul-20,Regular
4JN18CS411,17CS64,47,26,73,P,8,Jul-20,Regular
4JN18CS411,17CSL67,44,26,70,P,8,Jul-20,Regular
4JN18CS411,17CSL68,49,26,75,P,8,Jul-20,Regular
4JN18CS403,17CS61,49,26,75,P,8,Jul-20,Regular
4JN18CS403,17CS62,50,26,76,P,8,Jul-20,Regular
4JN18CS403,17CS63,40,26,66,P,7,Jul-20,Regular
4JN18CS403,17CS664,45,26,71,P,8,Jul-20,Regular
4JN18CS403,17CS654,49,26,75,P,8,Jul-20,Regular
4JN18CS403,17CS64,47,26,73,P,8,Jul-20,Regular
4JN18CS403,17CSL67,44,26,70,P,8,Jul-20,Regular
4JN18CS403,17CSL68,50,26,76,P,8,Jul-20,Regular
4JN18CS405,17CS61,49,30,79,P,8,Jul-20,Regular
4JN18CS405,17CS62,50,30,80,P,9,Jul-20,Regular
4JN18CS405,17CS63,40,30,70,P,8,Jul-20,Regular
4JN18CS405,17CS664,47,30,77,P,8,Jul-20,Regular
4JN18CS405,17CS654,48,30,78,P,8,Jul-20,Regular
4JN18CS405,17CS64,48,30,78,P,8,Jul-20,Regular
4JN18CS405,17CSL67,47,30,77,P,8,Jul-20,Regular
4JN18CS405,17CSL68,50,30,80,P,9,Jul-20,Regular
4JN18CS407,17CS61,49,32,81,P,9,Jul-20,Regular
4JN18CS407,17CS62,50,32,82,P,9,Jul-20,Regular
4JN18CS407,17CS63,48,32,80,P,9,Jul-20,Regular
4JN18CS407,17CS664,48,32,80,P,9,Jul-20,Regular
4JN18CS407,17CS654,49,32,81,P,9,Jul-20,Regular
4JN18CS407,17CS64,48,32,80,P,9,Jul-20,Regular
4JN18CS407,17CSL67,45,32,77,P,8,Jul-20,Regular
4JN18CS407,17CSL68,50,32,82,P,9,Jul-20,Regular
4JN18CS424,17CS61,49,28,77,P,8,Jul-20,Regular
4JN18CS424,17CS62,50,28,78,P,8,Jul-20,Regular
4JN18CS424,17CS63,47,28,75,P,8,Jul-20,Regular
4JN18CS424,17CS664,47,28,75,P,8,Jul-20,Regular
4JN18CS424,17CS654,48,28,76,P,8,Jul-20,Regular
4JN18CS424,17CS64,48,28,76,P,8,Jul-20,Regular
4JN18CS424,17CSL67,47,28,75,P,8,Jul-20,Regular
4JN18CS424,17CSL68,50,28,78,P,8,Jul-20,Regular
4JN18CS404,17CS61,50,27,77,P,8,Jul-20,Regular
4JN18CS404,17CS62,49,27,76,P,8,Jul-20,Regular
4JN18CS404,17CS63,49,27,76,P,8,Jul-20,Regular
4JN18CS404,17CS654,50,27,77,P,8,Jul-20,Regular
4JN18CS404,17CS64,45,27,72,P,8,Jul-20,Regular
4JN18CS404,17CS664,44,27,71,P,8,Jul-20,Regular
4JN18CS404,17CSL67,44,27,71,P,8,Jul-20,Regular
4JN18CS404,17CSL68,49,27,76,P,8,Jul-20,Regular
4JN18CS406,17CS61,50,29,79,P,8,Jul-20,Regular
4JN18CS406,17CS62,50,29,79,P,8,Jul-20,Regular
4JN18CS406,17CS63,44,29,73,P,8,Jul-20,Regular
4JN18CS406,17CS664,48,29,77,P,8,Jul-20,Regular
4JN18CS406,17CS654,47,29,76,P,8,Jul-20,Regular
4JN18CS406,17CS64,48,29,77,P,8,Jul-20,Regular
4JN18CS406,17CSL67,44,29,73,P,8,Jul-20,Regular
4JN18CS406,17CSL68,50,29,79,P,8,Jul-20,Regular
4JN18CS409,17CS61,48,30,78,P,8,Jul-20,Regular
4JN18CS409,17CS62,49,30,79,P,8,Jul-20,Regular
4JN18CS409,17CS63,50,30,80,P,9,Jul-20,Regular
4JN18CS409,17CS664,45,30,75,P,8,Jul-20,Regular
4JN18CS409,17CS654,48,30,78,P,8,Jul-20,Regular
4JN18CS409,17CS64,45,30,75,P,8,Jul-20,Regular
4JN18CS409,17CSL67,44,30,74,P,8,Jul-20,Regular
4JN18CS409,17CSL68,49,30,79,P,8,Jul-20,Regular
4JN18CS413,17CS61,49,30,79,P,8,Jul-20,Regular
4JN18CS413,17CS62,49,30,79,P,8,Jul-20,Regular
4JN18CS413,17CS63,50,30,80,P,9,Jul-20,Regular
4JN18CS413,17CS664,45,30,75,P,8,Jul-20,Regular
4JN18CS413,17CS654,48,30,78,P,8,Jul-20,Regular
4JN18CS413,17CS64,47,30,77,P,8,Jul-20,Regular
4JN18CS413,17CSL67,44,30,74,P,8,Jul-20,Regular
4JN18CS413,17CSL68,49,30,79,P,8,Jul-20,Regular
4JN18CS415,17CS61,49,26,75,P,8,Jul-20,Regular
4JN18CS415,17CS62,50,26,76,P,8,Jul-20,Regular
4JN18CS415,17CS63,45,26,71,P,8,Jul-20,Regular
4JN18CS415,17CS654,50,26,76,P,8,Jul-20,Regular
4JN18CS415,17CS64,48,26,74,P,8,Jul-20,Regular
4JN18CS415,17CS664,48,26,74,P,8,Jul-20,Regular
4JN18CS415,17CSL67,45,26,71,P,8,Jul-20,Regular
4JN18CS415,17CSL68,50,26,76,P,8,Jul-20,Regular
4JN18CS416,17CS61,49,30,79,P,8,Jul-20,Regular
4JN18CS416,17CS62,49,30,79,P,8,Jul-20,Regular
4JN18CS416,17CS63,49,30,79,P,8,Jul-20,Regular
4JN18CS416,17CS664,45,30,75,P,8,Jul-20,Regular
4JN18CS416,17CS654,49,30,79,P,8,Jul-20,Regular
4JN18CS416,17CS64,45,30,75,P,8,Jul-20,Regular
4JN18CS416,17CSL67,44,30,74,P,8,Jul-20,Regular
4JN18CS416,17CSL68,49,30,79,P,8,Jul-20,Regular
4JN18CS417,17CS61,50,31,81,P,9,Jul-20,Regular
4JN18CS417,17CS62,50,31,81,P,9,Jul-20,Regular
4JN18CS417,17CS63,48,31,79,P,8,Jul-20,Regular
4JN18CS417,17CS664,47,31,78,P,8,Jul-20,Regular
4JN18CS417,17CS654,50,31,81,P,9,Jul-20,Regular
4JN18CS417,17CS64,49,31,80,P,9,Jul-20,Regular
4JN18CS417,17CSL67,47,31,78,P,8,Jul-20,Regular
4JN18CS417,17CSL68,50,31,81,P,9,Jul-20,Regular
4JN18CS422,17CS61,49,27,76,P,8,Jul-20,Regular
4JN18CS422,17CS62,49,27,76,P,8,Jul-20,Regular
4JN18CS422,17CS63,50,27,77,P,8,Jul-20,Regular
4JN18CS422,17CS664,43,27,70,P,8,Jul-20,Regular
4JN18CS422,17CS654,50,27,77,P,8,Jul-20,Regular
4JN18CS422,17CS64,48,27,75,P,8,Jul-20,Regular
4JN18CS422,17CSL67,44,27,71,P,8,Jul-20,Regular
4JN18CS422,17CSL68,49,27,76,P,8,Jul-20,Regular
4JN18CS423,17CS61,50,28,78,P,8,Jul-20,Regular
4JN18CS423,17CS62,49,28,77,P,8,Jul-20,Regular
4JN18CS423,17CS63,50,28,78,P,8,Jul-20,Regular
4JN18CS423,17CS654,50,28,78,P,8,Jul-20,Regular
4JN18CS423,17CS64,45,28,73,P,8,Jul-20,Regular
4JN18CS423,17CS664,45,28,73,P,8,Jul-20,Regular
4JN18CS423,17CSL67,44,28,72,P,8,Jul-20,Regular
4JN18CS423,17CSL68,49,28,77,P,8,Jul-20,Regular
4JN18CS412,17CS61,50,30,80,P,9,Jul-20,Regular
4JN18CS412,17CS62,49,30,79,P,8,Jul-20,Regular
4JN18CS412,17CS63,49,30,79,P,8,Jul-20,Regular
4JN18CS412,17CS654,50,30,80,P,9,Jul-20,Regular
4JN18CS412,17CS64,47,30,77,P,8,Jul-20,Regular
4JN18CS412,17CS664,47,30,77,P,8,Jul-20,Regular
4JN18CS412,17CSL67,47,30,77,P,8,Jul-20,Regular
4JN18CS412,17CSL68,49,30,79,P,8,Jul-20,Regular
4JN17CS041,18MAT21,24,19,43,P,4,Jul-20,Regular
4JN17CS041,18CHE22,27,19,46,P,6,Jul-20,Regular
4JN17CS041,18CPS23,27,19,46,P,6,Jul-20,Regular
4JN17CS041,18ELN24,27,19,46,P,6,Jul-20,Regular
4JN17CS041,18ME25,44,19,63,P,7,Jul-20,Regular
4JN17CS041,18CHEL26,28,19,47,P,6,Jul-20,Regular
4JN17CS041,18CPL27,27,19,46,P,6,Jul-20,Regular
4JN17CS041,18EGH28,28,19,47,P,6,Jul-20,Regular
4JN17CS006,18MAT41,49,18,67,P,7,Jul-20,Regular
4JN17CS006,18CS42,49,18,67,P,7,Jul-20,Regular
4JN17CS006,18CS43,48,18,66,P,7,Jul-20,Regular
4JN17CS006,18CS44,47,18,65,P,7,Jul-20,Regular
4JN17CS006,18CS45,44,18,62,P,7,Jul-20,Regular
4JN17CS006,18CS46,49,18,67,P,7,Jul-20,Regular
4JN17CS006,18CSL47,47,18,65,P,7,Jul-20,Regular
4JN17CS006,18CSL48,48,18,66,P,7,Jul-20,Regular
4JN17CS006,18CPC49,48,18,66,P,7,Jul-20,Regular
4JN17CS065,18MAT41,48,26,74,P,8,Jul-20,Regular
4JN17CS065,18CS42,44,26,70,P,8,Jul-20,Regular
4JN17CS065,18CS43,48,26,74,P,8,Jul-20,Regular
4JN17CS065,18CS44,48,26,74,P,8,Jul-20,Regular
4JN17CS065,18CS45,43,26,69,P,7,Jul-20,Regular
4JN17CS065,18CS46,49,26,75,P,8,Jul-20,Regular
4JN17CS065,18CSL47,45,26,71,P,8,Jul-20,Regular
4JN17CS065,18CSL48,48,26,74,P,8,Jul-20,Regular
4JN17CS065,18CPC49,49,26,75,P,8,Jul-20,Regular
4JN19CS094,18MAT21,50,19,69,P,7,Jul-20,Regular
4JN19CS094,18CHE22,48,19,67,P,7,Jul-20,Regular
4JN19CS094,18CPS23,50,19,69,P,7,Jul-20,Regular
4JN19CS094,18ELN24,45,19,64,P,7,Jul-20,Regular
4JN19CS094,18ME25,44,19,63,P,7,Jul-20,Regular
4JN19CS094,18CHEL26,49,19,68,P,7,Jul-20,Regular
4JN19CS094,18CPL27,44,19,63,P,7,Jul-20,Regular
4JN19CS094,18EGH28,35,19,54,P,6,Jul-20,Regular
4JN19CS116,18MAT21,50,16,66,P,7,Jul-20,Regular
4JN19CS116,18CHE22,27,16,43,P,4,Jul-20,Regular
4JN19CS116,18CPS23,27,16,43,P,4,Jul-20,Regular
4JN19CS116,18ELN24,25,16,41,P,4,Jul-20,Regular
4JN19CS116,18ME25,27,16,43,P,4,Jul-20,Regular
4JN19CS116,18CHEL26,28,16,44,P,4,Jul-20,Regular
4JN19CS116,18CPL27,27,16,43,P,4,Jul-20,Regular
4JN19CS116,18EGH28,28,16,44,P,4,Jul-20,Regular
4JN19CS106,18MAT21,50,11,61,P,7,Jul-20,Regular
4JN19CS106,18CHE22,49,11,60,P,7,Jul-20,Regular
4JN19CS106,18CPS23,50,11,61,P,7,Jul-20,Regular
4JN19CS106,18ELN24,44,11,55,P,6,Jul-20,Regular
4JN19CS106,18ME25,49,11,60,P,7,Jul-20,Regular
4JN19CS106,18CHEL26,47,11,58,P,6,Jul-20,Regular
4JN19CS106,18CPL27,48,11,59,P,6,Jul-20,Regular
4JN19CS106,18EGH28,29,11,40,P,4,Jul-20,Regular
4JN19CS029,18MAT21,47,25,72,P,8,Jul-20,Regular
4JN19CS029,18CHE22,49,25,74,P,8,Jul-20,Regular
4JN19CS029,18CPS23,44,25,69,P,7,Jul-20,Regular
4JN19CS029,18ELN24,50,25,75,P,8,Jul-20,Regular
4JN19CS029,18ME25,44,25,69,P,7,Jul-20,Regular
4JN19CS029,18CHEL26,45,25,70,P,8,Jul-20,Regular
4JN19CS029,18CPL27,44,25,69,P,7,Jul-20,Regular
4JN19CS029,18EGH28,32,25,57,P,6,Jul-20,Regular
4JN19CS045,18MAT21,50,26,76,P,8,Jul-20,Regular
4JN19CS045,18CHE22,49,26,75,P,8,Jul-20,Regular
4JN19CS045,18CPS23,40,26,66,P,7,Jul-20,Regular
4JN19CS045,18ELN24,50,26,76,P,8,Jul-20,Regular
4JN19CS045,18ME25,49,26,75,P,8,Jul-20,Regular
4JN19CS045,18CHEL26,48,26,74,P,8,Jul-20,Regular
4JN19CS045,18CPL27,38,26,64,P,7,Jul-20,Regular
4JN19CS045,18EGH28,44,26,70,P,8,Jul-20,Regular
4JN19CS078,18MAT21,49,27,76,P,8,Jul-20,Regular
4JN19CS078,18CHE22,48,27,75,P,8,Jul-20,Regular
4JN19CS078,18CPS23,48,27,75,P,8,Jul-20,Regular
4JN19CS078,18ELN24,50,27,77,P,8,Jul-20,Regular
4JN19CS078,18ME25,49,27,76,P,8,Jul-20,Regular
4JN19CS078,18CHEL26,49,27,76,P,8,Jul-20,Regular
4JN19CS078,18CPL27,47,27,74,P,8,Jul-20,Regular
4JN19CS078,18EGH28,29,27,56,P,6,Jul-20,Regular
4JN19CS032,18MAT21,49,18,67,P,7,Jul-20,Regular
4JN19CS032,18CHE22,45,18,63,P,7,Jul-20,Regular
4JN19CS032,18CPS23,38,18,56,P,6,Jul-20,Regular
4JN19CS032,18ELN24,44,18,62,P,7,Jul-20,Regular
4JN19CS032,18ME25,43,18,61,P,7,Jul-20,Regular
4JN19CS032,18CHEL26,45,18,63,P,7,Jul-20,Regular
4JN19CS032,18CPL27,44,18,62,P,7,Jul-20,Regular
4JN19CS032,18EGH28,28,18,46,P,6,Jul-20,Regular
4JN19CS091,18MAT21,49,26,75,P,8,Jul-20,Regular
4JN19CS091,18CHE22,49,26,75,P,8,Jul-20,Regular
4JN19CS091,18CPS23,48,26,74,P,8,Jul-20,Regular
4JN19CS091,18ELN24,49,26,75,P,8,Jul-20,Regular
4JN19CS091,18ME25,49,26,75,P,8,Jul-20,Regular
4JN19CS091,18CHEL26,49,26,75,P,8,Jul-20,Regular
4JN19CS091,18CPL27,43,26,69,P,7,Jul-20,Regular
4JN19CS091,18EGH28,38,26,64,P,7,Jul-20,Regular
4JN19CS039,18MAT21,50,29,79,P,8,Jul-20,Regular
4JN19CS039,18CHE22,49,29,78,P,8,Jul-20,Regular
4JN19CS039,18CPS23,45,29,74,P,8,Jul-20,Regular
4JN19CS039,18ELN24,50,29,79,P,8,Jul-20,Regular
4JN19CS039,18ME25,50,29,79,P,8,Jul-20,Regular
4JN19CS039,18CHEL26,50,29,79,P,8,Jul-20,Regular
4JN19CS039,18CPL27,47,29,76,P,8,Jul-20,Regular
4JN19CS039,18EGH28,34,29,63,P,7,Jul-20,Regular
4JN19CS028,18MAT21,48,25,73,P,8,Jul-20,Regular
4JN19CS028,18CHE22,49,25,74,P,8,Jul-20,Regular
4JN19CS028,18CPS23,38,25,63,P,7,Jul-20,Regular
4JN19CS028,18ELN24,50,25,75,P,8,Jul-20,Regular
4JN19CS028,18ME25,45,25,70,P,8,Jul-20,Regular
4JN19CS028,18CHEL26,47,25,72,P,8,Jul-20,Regular
4JN19CS028,18CPL27,44,25,69,P,7,Jul-20,Regular
4JN19CS028,18EGH28,28,25,53,P,6,Jul-20,Regular
4JN19CS009,18MAT21,45,26,71,P,8,Jul-20,Regular
4JN19CS009,18CHE22,49,26,75,P,8,Jul-20,Regular
4JN19CS009,18CPS23,38,26,64,P,7,Jul-20,Regular
4JN19CS009,18ELN24,49,26,75,P,8,Jul-20,Regular
4JN19CS009,18ME25,42,26,68,P,7,Jul-20,Regular
4JN19CS009,18CHEL26,47,26,73,P,8,Jul-20,Regular
4JN19CS009,18CPL27,44,26,70,P,8,Jul-20,Regular
4JN19CS009,18EGH28,29,26,55,P,6,Jul-20,Regular
4JN19CS006,18MAT21,50,37,87,P,9,Jul-20,Regular
4JN19CS006,18CHE22,49,37,86,P,9,Jul-20,Regular
4JN19CS006,18CPS23,50,37,87,P,9,Jul-20,Regular
4JN19CS006,18ELN24,50,37,87,P,9,Jul-20,Regular
4JN19CS006,18ME25,49,37,86,P,9,Jul-20,Regular
4JN19CS006,18CHEL26,50,37,87,P,9,Jul-20,Regular
4JN19CS006,18CPL27,50,37,87,P,9,Jul-20,Regular
4JN19CS006,18EGH28,28,37,65,P,7,Jul-20,Regular
4JN19CS015,18MAT21,50,35,85,P,9,Jul-20,Regular
4JN19CS015,18CHE22,50,35,85,P,9,Jul-20,Regular
4JN19CS015,18CPS23,44,35,79,P,8,Jul-20,Regular
4JN19CS015,18ELN24,50,35,85,P,9,Jul-20,Regular
4JN19CS015,18ME25,47,35,82,P,9,Jul-20,Regular
4JN19CS015,18CHEL26,50,35,85,P,9,Jul-20,Regular
4JN19CS015,18CPL27,50,35,85,P,9,Jul-20,Regular
4JN19CS015,18EGH28,32,35,67,P,7,Jul-20,Regular
4JN19CS020,18MAT21,50,37,87,P,9,Jul-20,Regular
4JN19CS020,18CHE22,49,37,86,P,9,Jul-20,Regular
4JN19CS020,18CPS23,42,37,79,P,8,Jul-20,Regular
4JN19CS020,18ELN24,50,37,87,P,9,Jul-20,Regular
4JN19CS020,18ME25,49,37,86,P,9,Jul-20,Regular
4JN19CS020,18CHEL26,49,37,86,P,9,Jul-20,Regular
4JN19CS020,18CPL27,50,37,87,P,9,Jul-20,Regular
4JN19CS020,18EGH28,37,37,74,P,8,Jul-20,Regular
4JN19CS057,18MAT21,50,41,91,P,10,Jul-20,Regular
4JN19CS057,18CHE22,49,41,90,P,10,Jul-20,Regular
4JN19CS057,18CPS23,38,41,79,P,8,Jul-20,Regular
4JN19CS057,18ELN24,50,41,91,P,10,Jul-20,Regular
4JN19CS057,18ME25,49,41,90,P,10,Jul-20,Regular
4JN19CS057,18CHEL26,47,41,88,P,9,Jul-20,Regular
4JN19CS057,18CPL27,38,41,79,P,8,Jul-20,Regular
4JN19CS057,18EGH28,39,41,80,P,9,Jul-20,Regular
4JN19CS077,18MAT21,50,31,81,P,9,Jul-20,Regular
4JN19CS077,18CHE22,50,31,81,P,9,Jul-20,Regular
4JN19CS077,18CPS23,50,31,81,P,9,Jul-20,Regular
4JN19CS077,18ELN24,50,31,81,P,9,Jul-20,Regular
4JN19CS077,18ME25,50,31,81,P,9,Jul-20,Regular
4JN19CS077,18CHEL26,49,31,80,P,9,Jul-20,Regular
4JN19CS077,18CPL27,49,31,80,P,9,Jul-20,Regular
4JN19CS077,18EGH28,39,31,70,P,8,Jul-20,Regular
4JN19CS080,18MAT21,49,35,84,P,9,Jul-20,Regular
4JN19CS080,18CHE22,50,35,85,P,9,Jul-20,Regular
4JN19CS080,18CPS23,50,35,85,P,9,Jul-20,Regular
4JN19CS080,18ELN24,48,35,83,P,9,Jul-20,Regular
4JN19CS080,18ME25,49,35,84,P,9,Jul-20,Regular
4JN19CS080,18CHEL26,50,35,85,P,9,Jul-20,Regular
4JN19CS080,18CPL27,38,35,73,P,8,Jul-20,Regular
4JN19CS080,18EGH28,38,35,73,P,8,Jul-20,Regular
4JN19CS081,18MAT21,49,33,82,P,9,Jul-20,Regular
4JN19CS081,18CHE22,50,33,83,P,9,Jul-20,Regular
4JN19CS081,18CPS23,48,33,81,P,9,Jul-20,Regular
4JN19CS081,18ELN24,48,33,81,P,9,Jul-20,Regular
4JN19CS081,18ME25,49,33,82,P,9,Jul-20,Regular
4JN19CS081,18CHEL26,50,33,83,P,9,Jul-20,Regular
4JN19CS081,18CPL27,47,33,80,P,9,Jul-20,Regular
4JN19CS081,18EGH28,30,33,63,P,7,Jul-20,Regular
4JN19CS085,18MAT21,49,36,85,P,9,Jul-20,Regular
4JN19CS085,18CHE22,49,36,85,P,9,Jul-20,Regular
4JN19CS085,18CPS23,49,36,85,P,9,Jul-20,Regular
4JN19CS085,18ELN24,49,36,85,P,9,Jul-20,Regular
4JN19CS085,18ME25,49,36,85,P,9,Jul-20,Regular
4JN19CS085,18CHEL26,48,36,84,P,9,Jul-20,Regular
4JN19CS085,18CPL27,48,36,84,P,9,Jul-20,Regular
4JN19CS085,18EGH28,35,36,71,P,8,Jul-20,Regular
4JN19CS088,18MAT21,49,33,82,P,9,Jul-20,Regular
4JN19CS088,18PHY22,47,33,80,P,9,Jul-20,Regular
4JN19CS088,18ELE23,48,33,81,P,9,Jul-20,Regular
4JN19CS088,18CIV24,50,33,83,P,9,Jul-20,Regular
4JN19CS088,18EGDL25,40,33,73,P,8,Jul-20,Regular
4JN19CS088,18PHYL26,40,33,73,P,8,Jul-20,Regular
4JN19CS088,18ELEL27,42,33,75,P,8,Jul-20,Regular
4JN19CS088,18EGH28,34,33,67,P,7,Jul-20,Regular
4JN19CS121,18MAT21,50,35,85,P,9,Jul-20,Regular
4JN19CS121,18CHE22,49,35,84,P,9,Jul-20,Regular
4JN19CS121,18CPS23,50,35,85,P,9,Jul-20,Regular
4JN19CS121,18ELN24,44,35,79,P,8,Jul-20,Regular
4JN19CS121,18ME25,49,35,84,P,9,Jul-20,Regular
4JN19CS121,18CHEL26,48,35,83,P,9,Jul-20,Regular
4JN19CS121,18CPL27,44,35,79,P,8,Jul-20,Regular
4JN19CS121,18EGH28,33,35,68,P,7,Jul-20,Regular
4JN19CS072,18MAT21,50,28,78,P,8,Jul-20,Regular
4JN19CS072,18CHE22,49,28,77,P,8,Jul-20,Regular
4JN19CS072,18CPS23,48,28,76,P,8,Jul-20,Regular
4JN19CS072,18ELN24,48,28,76,P,8,Jul-20,Regular
4JN19CS072,18ME25,49,28,77,P,8,Jul-20,Regular
4JN19CS072,18CHEL26,49,28,77,P,8,Jul-20,Regular
4JN19CS072,18CPL27,43,28,71,P,8,Jul-20,Regular
4JN19CS072,18EGH28,39,28,67,P,7,Jul-20,Regular
4JN19CS118,18MAT21,50,28,78,P,8,Jul-20,Regular
4JN19CS118,18CHE22,48,28,76,P,8,Jul-20,Regular
4JN19CS118,18CPS23,40,28,68,P,7,Jul-20,Regular
4JN19CS118,18ELN24,49,28,77,P,8,Jul-20,Regular
4JN19CS118,18ME25,49,28,77,P,8,Jul-20,Regular
4JN19CS118,18CHEL26,49,28,77,P,8,Jul-20,Regular
4JN19CS118,18CPL27,38,28,66,P,7,Jul-20,Regular
4JN19CS118,18EGH28,38,28,66,P,7,Jul-20,Regular
4JN19CS016,18MAT21,48,33,81,P,9,Jul-20,Regular
4JN19CS016,18CHE22,49,33,82,P,9,Jul-20,Regular
4JN19CS016,18CPS23,45,33,78,P,8,Jul-20,Regular
4JN19CS016,18ELN24,50,33,83,P,9,Jul-20,Regular
4JN19CS016,18ME25,49,33,82,P,9,Jul-20,Regular
4JN19CS016,18CHEL26,48,33,81,P,9,Jul-20,Regular
4JN19CS016,18CPL27,44,33,77,P,8,Jul-20,Regular
4JN19CS016,18EGH28,35,33,68,P,7,Jul-20,Regular
4JN19CS064,18MAT21,35,25,60,P,7,Jul-20,Regular
4JN19CS064,18CHE22,47,25,72,P,8,Jul-20,Regular
4JN19CS064,18CPS23,44,25,69,P,7,Jul-20,Regular
4JN19CS064,18ELN24,45,25,70,P,8,Jul-20,Regular
4JN19CS064,18ME25,48,25,73,P,8,Jul-20,Regular
4JN19CS064,18CHEL26,48,25,73,P,8,Jul-20,Regular
4JN19CS064,18CPL27,38,25,63,P,7,Jul-20,Regular
4JN19CS064,18EGH28,37,25,62,P,7,Jul-20,Regular
4JN19CS096,18MAT21,50,34,84,P,9,Jul-20,Regular
4JN19CS096,18CHE22,48,34,82,P,9,Jul-20,Regular
4JN19CS096,18CPS23,50,34,84,P,9,Jul-20,Regular
4JN19CS096,18ELN24,45,34,79,P,8,Jul-20,Regular
4JN19CS096,18ME25,49,34,83,P,9,Jul-20,Regular
4JN19CS096,18CHEL26,48,34,82,P,9,Jul-20,Regular
4JN19CS096,18CPL27,47,34,81,P,9,Jul-20,Regular
4JN19CS096,18EGH28,35,34,69,P,7,Jul-20,Regular
4JN19CS124,18MAT21,50,28,78,P,8,Jul-20,Regular
4JN19CS124,18CHE22,47,28,75,P,8,Jul-20,Regular
4JN19CS124,18CPS23,50,28,78,P,8,Jul-20,Regular
4JN19CS124,18ELN24,33,28,61,P,7,Jul-20,Regular
4JN19CS124,18ME25,48,28,76,P,8,Jul-20,Regular
4JN19CS124,18CHEL26,48,28,76,P,8,Jul-20,Regular
4JN19CS124,18CPL27,45,28,73,P,8,Jul-20,Regular
4JN19CS124,18EGH28,39,28,67,P,7,Jul-20,Regular
4JN19CS010,18MAT21,47,27,74,P,8,Jul-20,Regular
4JN19CS010,18CHE22,48,27,75,P,8,Jul-20,Regular
4JN19CS010,18CPS23,38,27,65,P,7,Jul-20,Regular
4JN19CS010,18ELN24,49,27,76,P,8,Jul-20,Regular
4JN19CS010,18ME25,40,27,67,P,7,Jul-20,Regular
4JN19CS010,18CHEL26,45,27,72,P,8,Jul-20,Regular
4JN19CS010,18CPL27,44,27,71,P,8,Jul-20,Regular
4JN19CS010,18EGH28,30,27,57,P,6,Jul-20,Regular
4JN19CS001,18MAT21,50,35,85,P,9,Jul-20,Regular
4JN19CS001,18CHE22,49,35,84,P,9,Jul-20,Regular
4JN19CS001,18CPS23,40,35,75,P,8,Jul-20,Regular
4JN19CS001,18ELN24,50,35,85,P,9,Jul-20,Regular
4JN19CS001,18ME25,44,35,79,P,8,Jul-20,Regular
4JN19CS001,18CHEL26,48,35,83,P,9,Jul-20,Regular
4JN19CS001,18CPL27,44,35,79,P,8,Jul-20,Regular
4JN19CS001,18EGH28,33,35,68,P,7,Jul-20,Regular
4JN19CS002,18MAT21,49,39,88,P,9,Jul-20,Regular
4JN19CS002,18CHE22,50,39,89,P,9,Jul-20,Regular
4JN19CS002,18CPS23,50,39,89,P,9,Jul-20,Regular
4JN19CS002,18ELN24,50,39,89,P,9,Jul-20,Regular
4JN19CS002,18ME25,48,39,87,P,9,Jul-20,Regular
4JN19CS002,18CHEL26,49,39,88,P,9,Jul-20,Regular
4JN19CS002,18CPL27,50,39,89,P,9,Jul-20,Regular
4JN19CS002,18EGH28,32,39,71,P,8,Jul-20,Regular
4JN19CS003,18MAT21,50,41,91,P,10,Jul-20,Regular
4JN19CS003,18CHE22,50,41,91,P,10,Jul-20,Regular
4JN19CS003,18CPS23,43,41,84,P,9,Jul-20,Regular
4JN19CS003,18ELN24,50,41,91,P,10,Jul-20,Regular
4JN19CS003,18ME25,44,41,85,P,9,Jul-20,Regular
4JN19CS003,18CHEL26,50,41,91,P,10,Jul-20,Regular
4JN19CS003,18CPL27,50,41,91,P,10,Jul-20,Regular
4JN19CS003,18EGH28,37,41,78,P,8,Jul-20,Regular
4JN19CS005,18MAT21,50,41,91,P,10,Jul-20,Regular
4JN19CS005,18CHE22,50,41,91,P,10,Jul-20,Regular
4JN19CS005,18CPS23,50,41,91,P,10,Jul-20,Regular
4JN19CS005,18ELN24,50,41,91,P,10,Jul-20,Regular
4JN19CS005,18ME25,49,41,90,P,10,Jul-20,Regular
4JN19CS005,18CHEL26,50,41,91,P,10,Jul-20,Regular
4JN19CS005,18CPL27,50,41,91,P,10,Jul-20,Regular
4JN19CS005,18EGH28,35,41,76,P,8,Jul-20,Regular
4JN19CS007,18MAT21,48,37,85,P,9,Jul-20,Regular
4JN19CS007,18CHE22,47,37,84,P,9,Jul-20,Regular
4JN19CS007,18CPS23,44,37,81,P,9,Jul-20,Regular
4JN19CS007,18ELN24,50,37,87,P,9,Jul-20,Regular
4JN19CS007,18ME25,48,37,85,P,9,Jul-20,Regular
4JN19CS007,18CHEL26,48,37,85,P,9,Jul-20,Regular
4JN19CS007,18CPL27,50,37,87,P,9,Jul-20,Regular
4JN19CS007,18EGH28,42,37,79,P,8,Jul-20,Regular
4JN19CS008,18MAT21,49,37,86,P,9,Jul-20,Regular
4JN19CS008,18CHE22,49,37,86,P,9,Jul-20,Regular
4JN19CS008,18CPS23,43,37,80,P,9,Jul-20,Regular
4JN19CS008,18ELN24,49,37,86,P,9,Jul-20,Regular
4JN19CS008,18ME25,49,37,86,P,9,Jul-20,Regular
4JN19CS008,18CHEL26,45,37,82,P,9,Jul-20,Regular
4JN19CS008,18CPL27,48,37,85,P,9,Jul-20,Regular
4JN19CS008,18EGH28,39,37,76,P,8,Jul-20,Regular
4JN19CS011,18MAT21,50,39,89,P,9,Jul-20,Regular
4JN19CS011,18CHE22,49,39,88,P,9,Jul-20,Regular
4JN19CS011,18CPS23,50,39,89,P,9,Jul-20,Regular
4JN19CS011,18ELN24,50,39,89,P,9,Jul-20,Regular
4JN19CS011,18ME25,48,39,87,P,9,Jul-20,Regular
4JN19CS011,18CHEL26,50,39,89,P,9,Jul-20,Regular
4JN19CS011,18CPL27,50,39,89,P,9,Jul-20,Regular
4JN19CS011,18EGH28,38,39,77,P,8,Jul-20,Regular
4JN19CS012,18MAT21,49,37,86,P,9,Jul-20,Regular
4JN19CS012,18CHE22,49,37,86,P,9,Jul-20,Regular
4JN19CS012,18CPS23,39,37,76,P,8,Jul-20,Regular
4JN19CS012,18ELN24,50,37,87,P,9,Jul-20,Regular
4JN19CS012,18ME25,47,37,84,P,9,Jul-20,Regular
4JN19CS012,18CHEL26,49,37,86,P,9,Jul-20,Regular
4JN19CS012,18CPL27,50,37,87,P,9,Jul-20,Regular
4JN19CS012,18EGH28,32,37,69,P,7,Jul-20,Regular
4JN19CS013,18MAT21,50,37,87,P,9,Jul-20,Regular
4JN19CS013,18CHE22,49,37,86,P,9,Jul-20,Regular
4JN19CS013,18CPS23,42,37,79,P,8,Jul-20,Regular
4JN19CS013,18ELN24,50,37,87,P,9,Jul-20,Regular
4JN19CS013,18ME25,44,37,81,P,9,Jul-20,Regular
4JN19CS013,18CHEL26,50,37,87,P,9,Jul-20,Regular
4JN19CS013,18CPL27,50,37,87,P,9,Jul-20,Regular
4JN19CS013,18EGH28,39,37,76,P,8,Jul-20,Regular
4JN19CS014,18MAT21,50,40,90,P,10,Jul-20,Regular
4JN19CS014,18CHE22,50,40,90,P,10,Jul-20,Regular
4JN19CS014,18CPS23,48,40,88,P,9,Jul-20,Regular
4JN19CS014,18ELN24,50,40,90,P,10,Jul-20,Regular
4JN19CS014,18ME25,45,40,85,P,9,Jul-20,Regular
4JN19CS014,18CHEL26,48,40,88,P,9,Jul-20,Regular
4JN19CS014,18CPL27,50,40,90,P,10,Jul-20,Regular
4JN19CS014,18EGH28,40,40,80,P,9,Jul-20,Regular
4JN19CS017,18MAT21,48,31,79,P,8,Jul-20,Regular
4JN19CS017,18CHE22,49,31,80,P,9,Jul-20,Regular
4JN19CS017,18CPS23,50,31,81,P,9,Jul-20,Regular
4JN19CS017,18ELN24,50,31,81,P,9,Jul-20,Regular
4JN19CS017,18ME25,49,31,80,P,9,Jul-20,Regular
4JN19CS017,18CHEL26,50,31,81,P,9,Jul-20,Regular
4JN19CS017,18CPL27,50,31,81,P,9,Jul-20,Regular
4JN19CS017,18EGH28,38,31,69,P,7,Jul-20,Regular
4JN19CS018,18MAT21,50,39,89,P,9,Jul-20,Regular
4JN19CS018,18CHE22,49,39,88,P,9,Jul-20,Regular
4JN19CS018,18CPS23,39,39,78,P,8,Jul-20,Regular
4JN19CS018,18ELN24,50,39,89,P,9,Jul-20,Regular
4JN19CS018,18ME25,43,39,82,P,9,Jul-20,Regular
4JN19CS018,18CHEL26,48,39,87,P,9,Jul-20,Regular
4JN19CS018,18CPL27,38,39,77,P,8,Jul-20,Regular
4JN19CS018,18EGH28,45,39,84,P,9,Jul-20,Regular
4JN19CS019,18MAT21,49,36,85,P,9,Jul-20,Regular
4JN19CS019,18CHE22,49,36,85,P,9,Jul-20,Regular
4JN19CS019,18CPS23,38,36,74,P,8,Jul-20,Regular
4JN19CS019,18ELN24,50,36,86,P,9,Jul-20,Regular
4JN19CS019,18ME25,49,36,85,P,9,Jul-20,Regular
4JN19CS019,18CHEL26,50,36,86,P,9,Jul-20,Regular
4JN19CS019,18CPL27,50,36,86,P,9,Jul-20,Regular
4JN19CS019,18EGH28,37,36,73,P,8,Jul-20,Regular
4JN19CS022,18MAT21,50,39,89,P,9,Jul-20,Regular
4JN19CS022,18CHE22,50,39,89,P,9,Jul-20,Regular
4JN19CS022,18CPS23,39,39,78,P,8,Jul-20,Regular
4JN19CS022,18ELN24,50,39,89,P,9,Jul-20,Regular
4JN19CS022,18ME25,49,39,88,P,9,Jul-20,Regular
4JN19CS022,18CHEL26,49,39,88,P,9,Jul-20,Regular
4JN19CS022,18CPL27,50,39,89,P,9,Jul-20,Regular
4JN19CS022,18EGH28,30,39,69,P,7,Jul-20,Regular
4JN19CS023,18MAT21,50,36,86,P,9,Jul-20,Regular
4JN19CS023,18CHE22,49,36,85,P,9,Jul-20,Regular
4JN19CS023,18CPS23,38,36,74,P,8,Jul-20,Regular
4JN19CS023,18ELN24,48,36,84,P,9,Jul-20,Regular
4JN19CS023,18ME25,48,36,84,P,9,Jul-20,Regular
4JN19CS023,18CHEL26,48,36,84,P,9,Jul-20,Regular
4JN19CS023,18CPL27,44,36,80,P,9,Jul-20,Regular
4JN19CS023,18EGH28,30,36,66,P,7,Jul-20,Regular
4JN19CS024,18MAT21,49,32,81,P,9,Jul-20,Regular
4JN19CS024,18CHE22,49,32,81,P,9,Jul-20,Regular
4JN19CS024,18CPS23,43,32,75,P,8,Jul-20,Regular
4JN19CS024,18ELN24,50,32,82,P,9,Jul-20,Regular
4JN19CS024,18ME25,49,32,81,P,9,Jul-20,Regular
4JN19CS024,18CHEL26,48,32,80,P,9,Jul-20,Regular
4JN19CS024,18CPL27,38,32,70,P,8,Jul-20,Regular
4JN19CS024,18EGH28,29,32,61,P,7,Jul-20,Regular
4JN19CS025,18MAT21,49,38,87,P,9,Jul-20,Regular
4JN19CS025,18CHE22,48,38,86,P,9,Jul-20,Regular
4JN19CS025,18CPS23,43,38,81,P,9,Jul-20,Regular
4JN19CS025,18ELN24,50,38,88,P,9,Jul-20,Regular
4JN19CS025,18ME25,49,38,87,P,9,Jul-20,Regular
4JN19CS025,18CHEL26,50,38,88,P,9,Jul-20,Regular
4JN19CS025,18CPL27,50,38,88,P,9,Jul-20,Regular
4JN19CS025,18EGH28,35,38,73,P,8,Jul-20,Regular
4JN19CS026,18MAT21,49,44,93,P,10,Jul-20,Regular
4JN19CS026,18CHE22,49,44,93,P,10,Jul-20,Regular
4JN19CS026,18CPS23,45,44,89,P,9,Jul-20,Regular
4JN19CS026,18ELN24,50,44,94,P,10,Jul-20,Regular
4JN19CS026,18ME25,49,44,93,P,10,Jul-20,Regular
4JN19CS026,18CHEL26,50,44,94,P,10,Jul-20,Regular
4JN19CS026,18CPL27,50,44,94,P,10,Jul-20,Regular
4JN19CS026,18EGH28,38,44,82,P,9,Jul-20,Regular
4JN19CS027,18MAT21,50,43,93,P,10,Jul-20,Regular
4JN19CS027,18CHE22,49,43,92,P,10,Jul-20,Regular
4JN19CS027,18CPS23,50,43,93,P,10,Jul-20,Regular
4JN19CS027,18ELN24,50,43,93,P,10,Jul-20,Regular
4JN19CS027,18ME25,49,43,92,P,10,Jul-20,Regular
4JN19CS027,18CHEL26,50,43,93,P,10,Jul-20,Regular
4JN19CS027,18CPL27,50,43,93,P,10,Jul-20,Regular
4JN19CS027,18EGH28,37,43,80,P,9,Jul-20,Regular
4JN19CS030,18MAT21,47,32,79,P,8,Jul-20,Regular
4JN19CS030,18CHE22,49,32,81,P,9,Jul-20,Regular
4JN19CS030,18CPS23,38,32,70,P,8,Jul-20,Regular
4JN19CS030,18ELN24,50,32,82,P,9,Jul-20,Regular
4JN19CS030,18ME25,42,32,74,P,8,Jul-20,Regular
4JN19CS030,18CHEL26,48,32,80,P,9,Jul-20,Regular
4JN19CS030,18CPL27,48,32,80,P,9,Jul-20,Regular
4JN19CS030,18EGH28,38,32,70,P,8,Jul-20,Regular
4JN19CS031,18MAT21,50,36,86,P,9,Jul-20,Regular
4JN19CS031,18CHE22,48,36,84,P,9,Jul-20,Regular
4JN19CS031,18CPS23,39,36,75,P,8,Jul-20,Regular
4JN19CS031,18ELN24,50,36,86,P,9,Jul-20,Regular
4JN19CS031,18ME25,43,36,79,P,8,Jul-20,Regular
4JN19CS031,18CHEL26,45,36,81,P,9,Jul-20,Regular
4JN19CS031,18CPL27,44,36,80,P,9,Jul-20,Regular
4JN19CS031,18EGH28,37,36,73,P,8,Jul-20,Regular
4JN19CS033,18MAT21,50,34,84,P,9,Jul-20,Regular
4JN19CS033,18CHE22,49,34,83,P,9,Jul-20,Regular
4JN19CS033,18CPS23,42,34,76,P,8,Jul-20,Regular
4JN19CS033,18ELN24,50,34,84,P,9,Jul-20,Regular
4JN19CS033,18ME25,49,34,83,P,9,Jul-20,Regular
4JN19CS033,18CHEL26,49,34,83,P,9,Jul-20,Regular
4JN19CS033,18CPL27,47,34,81,P,9,Jul-20,Regular
4JN19CS033,18EGH28,42,34,76,P,8,Jul-20,Regular
4JN19CS034,18MAT21,50,32,82,P,9,Jul-20,Regular
4JN19CS034,18CHE22,49,32,81,P,9,Jul-20,Regular
4JN19CS034,18CPS23,43,32,75,P,8,Jul-20,Regular
4JN19CS034,18ELN24,49,32,81,P,9,Jul-20,Regular
4JN19CS034,18ME25,50,32,82,P,9,Jul-20,Regular
4JN19CS034,18CHEL26,50,32,82,P,9,Jul-20,Regular
4JN19CS034,18CPL27,39,32,71,P,8,Jul-20,Regular
4JN19CS034,18EGH28,32,32,64,P,7,Jul-20,Regular
4JN19CS035,18MAT21,50,36,86,P,9,Jul-20,Regular
4JN19CS035,18CHE22,50,36,86,P,9,Jul-20,Regular
4JN19CS035,18CPS23,42,36,78,P,8,Jul-20,Regular
4JN19CS035,18ELN24,50,36,86,P,9,Jul-20,Regular
4JN19CS035,18ME25,50,36,86,P,9,Jul-20,Regular
4JN19CS035,18CHEL26,50,36,86,P,9,Jul-20,Regular
4JN19CS035,18CPL27,38,36,74,P,8,Jul-20,Regular
4JN19CS035,18EGH28,35,36,71,P,8,Jul-20,Regular
4JN19CS036,18MAT21,50,38,88,P,9,Jul-20,Regular
4JN19CS036,18CHE22,49,38,87,P,9,Jul-20,Regular
4JN19CS036,18CPS23,43,38,81,P,9,Jul-20,Regular
4JN19CS036,18ELN24,50,38,88,P,9,Jul-20,Regular
4JN19CS036,18ME25,50,38,88,P,9,Jul-20,Regular
4JN19CS036,18CHEL26,48,38,86,P,9,Jul-20,Regular
4JN19CS036,18CPL27,39,38,77,P,8,Jul-20,Regular
4JN19CS036,18EGH28,37,38,75,P,8,Jul-20,Regular
4JN19CS037,18MAT21,50,37,87,P,9,Jul-20,Regular
4JN19CS037,18CHE22,49,37,86,P,9,Jul-20,Regular
4JN19CS037,18CPS23,40,37,77,P,8,Jul-20,Regular
4JN19CS037,18ELN24,50,37,87,P,9,Jul-20,Regular
4JN19CS037,18ME25,50,37,87,P,9,Jul-20,Regular
4JN19CS037,18CHEL26,47,37,84,P,9,Jul-20,Regular
4JN19CS037,18CPL27,47,37,84,P,9,Jul-20,Regular
4JN19CS037,18EGH28,28,37,65,P,7,Jul-20,Regular
4JN19CS038,18MAT21,50,41,91,P,10,Jul-20,Regular
4JN19CS038,18CHE22,49,41,90,P,10,Jul-20,Regular
4JN19CS038,18CPS23,39,41,80,P,9,Jul-20,Regular
4JN19CS038,18ELN24,50,41,91,P,10,Jul-20,Regular
4JN19CS038,18ME25,50,41,91,P,10,Jul-20,Regular
4JN19CS038,18CHEL26,49,41,90,P,10,Jul-20,Regular
4JN19CS038,18CPL27,47,41,88,P,9,Jul-20,Regular
4JN19CS038,18EGH28,32,41,73,P,8,Jul-20,Regular
4JN19CS040,18MAT21,50,31,81,P,9,Jul-20,Regular
4JN19CS040,18CHE22,49,31,80,P,9,Jul-20,Regular
4JN19CS040,18CPS23,39,31,70,P,8,Jul-20,Regular
4JN19CS040,18ELN24,49,31,80,P,9,Jul-20,Regular
4JN19CS040,18ME25,49,31,80,P,9,Jul-20,Regular
4JN19CS040,18CHEL26,49,31,80,P,9,Jul-20,Regular
4JN19CS040,18CPL27,47,31,78,P,8,Jul-20,Regular
4JN19CS040,18EGH28,29,31,60,P,7,Jul-20,Regular
4JN19CS041,18MAT21,50,40,90,P,10,Jul-20,Regular
4JN19CS041,18CHE22,50,40,90,P,10,Jul-20,Regular
4JN19CS041,18CPS23,43,40,83,P,9,Jul-20,Regular
4JN19CS041,18ELN24,50,40,90,P,10,Jul-20,Regular
4JN19CS041,18ME25,50,40,90,P,10,Jul-20,Regular
4JN19CS041,18CHEL26,50,40,90,P,10,Jul-20,Regular
4JN19CS041,18CPL27,38,40,78,P,8,Jul-20,Regular
4JN19CS041,18EGH28,40,40,80,P,9,Jul-20,Regular
4JN19CS042,18MAT21,50,34,84,P,9,Jul-20,Regular
4JN19CS042,18CHE22,49,34,83,P,9,Jul-20,Regular
4JN19CS042,18CPS23,38,34,72,P,8,Jul-20,Regular
4JN19CS042,18ELN24,50,34,84,P,9,Jul-20,Regular
4JN19CS042,18ME25,49,34,83,P,9,Jul-20,Regular
4JN19CS042,18CHEL26,49,34,83,P,9,Jul-20,Regular
4JN19CS042,18CPL27,38,34,72,P,8,Jul-20,Regular
4JN19CS042,18EGH28,28,34,62,P,7,Jul-20,Regular
4JN19CS043,18MAT21,50,32,82,P,9,Jul-20,Regular
4JN19CS043,18CHE22,48,32,80,P,9,Jul-20,Regular
4JN19CS043,18CPS23,38,32,70,P,8,Jul-20,Regular
4JN19CS043,18ELN24,49,32,81,P,9,Jul-20,Regular
4JN19CS043,18ME25,49,32,81,P,9,Jul-20,Regular
4JN19CS043,18CHEL26,48,32,80,P,9,Jul-20,Regular
4JN19CS043,18CPL27,38,32,70,P,8,Jul-20,Regular
4JN19CS043,18EGH28,43,32,75,P,8,Jul-20,Regular
4JN19CS044,18MAT21,50,37,87,P,9,Jul-20,Regular
4JN19CS044,18CHE22,49,37,86,P,9,Jul-20,Regular
4JN19CS044,18CPS23,43,37,80,P,9,Jul-20,Regular
4JN19CS044,18ELN24,50,37,87,P,9,Jul-20,Regular
4JN19CS044,18ME25,49,37,86,P,9,Jul-20,Regular
4JN19CS044,18CHEL26,49,37,86,P,9,Jul-20,Regular
4JN19CS044,18CPL27,47,37,84,P,9,Jul-20,Regular
4JN19CS044,18EGH28,30,37,67,P,7,Jul-20,Regular
4JN19CS046,18MAT21,50,35,85,P,9,Jul-20,Regular
4JN19CS046,18CHE22,48,35,83,P,9,Jul-20,Regular
4JN19CS046,18CPS23,42,35,77,P,8,Jul-20,Regular
4JN19CS046,18ELN24,50,35,85,P,9,Jul-20,Regular
4JN19CS046,18ME25,50,35,85,P,9,Jul-20,Regular
4JN19CS046,18CHEL26,47,35,82,P,9,Jul-20,Regular
4JN19CS046,18CPL27,38,35,73,P,8,Jul-20,Regular
4JN19CS046,18EGH28,34,35,69,P,7,Jul-20,Regular
4JN19CS047,18MAT21,50,43,93,P,10,Jul-20,Regular
4JN19CS047,18CHE22,49,43,92,P,10,Jul-20,Regular
4JN19CS047,18CPS23,45,43,88,P,9,Jul-20,Regular
4JN19CS047,18ELN24,50,43,93,P,10,Jul-20,Regular
4JN19CS047,18ME25,49,43,92,P,10,Jul-20,Regular
4JN19CS047,18CHEL26,49,43,92,P,10,Jul-20,Regular
4JN19CS047,18CPL27,47,43,90,P,10,Jul-20,Regular
4JN19CS047,18EGH28,38,43,81,P,9,Jul-20,Regular
4JN19CS048,18MAT21,50,33,83,P,9,Jul-20,Regular
4JN19CS048,18CHE22,49,33,82,P,9,Jul-20,Regular
4JN19CS048,18CPS23,38,33,71,P,8,Jul-20,Regular
4JN19CS048,18ELN24,49,33,82,P,9,Jul-20,Regular
4JN19CS048,18ME25,49,33,82,P,9,Jul-20,Regular
4JN19CS048,18CHEL26,48,33,81,P,9,Jul-20,Regular
4JN19CS048,18CPL27,47,33,80,P,9,Jul-20,Regular
4JN19CS048,18EGH28,42,33,75,P,8,Jul-20,Regular
4JN19CS049,18MAT21,50,37,87,P,9,Jul-20,Regular
4JN19CS049,18CHE22,50,37,87,P,9,Jul-20,Regular
4JN19CS049,18CPS23,43,37,80,P,9,Jul-20,Regular
4JN19CS049,18ELN24,50,37,87,P,9,Jul-20,Regular
4JN19CS049,18ME25,49,37,86,P,9,Jul-20,Regular
4JN19CS049,18CHEL26,49,37,86,P,9,Jul-20,Regular
4JN19CS049,18CPL27,38,37,75,P,8,Jul-20,Regular
4JN19CS049,18EGH28,35,37,72,P,8,Jul-20,Regular
4JN19CS050,18MAT21,50,42,92,P,10,Jul-20,Regular
4JN19CS050,18CHE22,49,42,91,P,10,Jul-20,Regular
4JN19CS050,18CPS23,39,42,81,P,9,Jul-20,Regular
4JN19CS050,18ELN24,50,42,92,P,10,Jul-20,Regular
4JN19CS050,18ME25,49,42,91,P,10,Jul-20,Regular
4JN19CS050,18CHEL26,48,42,90,P,10,Jul-20,Regular
4JN19CS050,18CPL27,47,42,89,P,9,Jul-20,Regular
4JN19CS050,18EGH28,42,42,84,P,9,Jul-20,Regular
4JN19CS051,18MAT21,50,38,88,P,9,Jul-20,Regular
4JN19CS051,18CHE22,49,38,87,P,9,Jul-20,Regular
4JN19CS051,18CPS23,40,38,78,P,8,Jul-20,Regular
4JN19CS051,18ELN24,50,38,88,P,9,Jul-20,Regular
4JN19CS051,18ME25,49,38,87,P,9,Jul-20,Regular
4JN19CS051,18CHEL26,49,38,87,P,9,Jul-20,Regular
4JN19CS051,18CPL27,47,38,85,P,9,Jul-20,Regular
4JN19CS051,18EGH28,37,38,75,P,8,Jul-20,Regular
4JN19CS052,18MAT21,50,36,86,P,9,Jul-20,Regular
4JN19CS052,18CHE22,49,36,85,P,9,Jul-20,Regular
4JN19CS052,18CPS23,38,36,74,P,8,Jul-20,Regular
4JN19CS052,18ELN24,48,36,84,P,9,Jul-20,Regular
4JN19CS052,18ME25,49,36,85,P,9,Jul-20,Regular
4JN19CS052,18CHEL26,48,36,84,P,9,Jul-20,Regular
4JN19CS052,18CPL27,47,36,83,P,9,Jul-20,Regular
4JN19CS052,18EGH28,43,36,79,P,8,Jul-20,Regular
4JN19CS053,18MAT21,50,34,84,P,9,Jul-20,Regular
4JN19CS053,18CHE22,50,34,84,P,9,Jul-20,Regular
4JN19CS053,18CPS23,38,34,72,P,8,Jul-20,Regular
4JN19CS053,18ELN24,49,34,83,P,9,Jul-20,Regular
4JN19CS053,18ME25,49,34,83,P,9,Jul-20,Regular
4JN19CS053,18CHEL26,48,34,82,P,9,Jul-20,Regular
4JN19CS053,18CPL27,38,34,72,P,8,Jul-20,Regular
4JN19CS053,18EGH28,30,34,64,P,7,Jul-20,Regular
4JN19CS054,18MAT21,50,31,81,P,9,Jul-20,Regular
4JN19CS054,18CHE22,49,31,80,P,9,Jul-20,Regular
4JN19CS054,18CPS23,40,31,71,P,8,Jul-20,Regular
4JN19CS054,18ELN24,50,31,81,P,9,Jul-20,Regular
4JN19CS054,18ME25,49,31,80,P,9,Jul-20,Regular
4JN19CS054,18CHEL26,47,31,78,P,8,Jul-20,Regular
4JN19CS054,18CPL27,43,31,74,P,8,Jul-20,Regular
4JN19CS054,18EGH28,29,31,60,P,7,Jul-20,Regular
4JN19CS055,18MAT21,50,28,78,P,8,Jul-20,Regular
4JN19CS055,18CHE22,48,28,76,P,8,Jul-20,Regular
4JN19CS055,18CPS23,37,28,65,P,7,Jul-20,Regular
4JN19CS055,18ELN24,50,28,78,P,8,Jul-20,Regular
4JN19CS055,18ME25,49,28,77,P,8,Jul-20,Regular
4JN19CS055,18CHEL26,47,28,75,P,8,Jul-20,Regular
4JN19CS055,18CPL27,38,28,66,P,7,Jul-20,Regular
4JN19CS055,18EGH28,28,28,56,P,6,Jul-20,Regular
4JN19CS056,18MAT21,50,32,82,P,9,Jul-20,Regular
4JN19CS056,18CHE22,49,32,81,P,9,Jul-20,Regular
4JN19CS056,18CPS23,37,32,69,P,7,Jul-20,Regular
4JN19CS056,18ELN24,48,32,80,P,9,Jul-20,Regular
4JN19CS056,18ME25,49,32,81,P,9,Jul-20,Regular
4JN19CS056,18CHEL26,47,32,79,P,8,Jul-20,Regular
4JN19CS056,18CPL27,37,32,69,P,7,Jul-20,Regular
4JN19CS056,18EGH28,29,32,61,P,7,Jul-20,Regular
4JN19CS058,18MAT21,50,37,87,P,9,Jul-20,Regular
4JN19CS058,18CHE22,49,37,86,P,9,Jul-20,Regular
4JN19CS058,18CPS23,43,37,80,P,9,Jul-20,Regular
4JN19CS058,18ELN24,50,37,87,P,9,Jul-20,Regular
4JN19CS058,18ME25,50,37,87,P,9,Jul-20,Regular
4JN19CS058,18CHEL26,50,37,87,P,9,Jul-20,Regular
4JN19CS058,18CPL27,38,37,75,P,8,Jul-20,Regular
4JN19CS058,18EGH28,42,37,79,P,8,Jul-20,Regular
4JN19CS059,18MAT21,50,39,89,P,9,Jul-20,Regular
4JN19CS059,18CHE22,49,39,88,P,9,Jul-20,Regular
4JN19CS059,18CPS23,43,39,82,P,9,Jul-20,Regular
4JN19CS059,18ELN24,49,39,88,P,9,Jul-20,Regular
4JN19CS059,18ME25,49,39,88,P,9,Jul-20,Regular
4JN19CS059,18CHEL26,47,39,86,P,9,Jul-20,Regular
4JN19CS059,18CPL27,47,39,86,P,9,Jul-20,Regular
4JN19CS059,18EGH28,44,39,83,P,9,Jul-20,Regular
4JN19CS060,18MAT21,50,31,81,P,9,Jul-20,Regular
4JN19CS060,18CHE22,49,31,80,P,9,Jul-20,Regular
4JN19CS060,18CPS23,38,31,69,P,7,Jul-20,Regular
4JN19CS060,18ELN24,50,31,81,P,9,Jul-20,Regular
4JN19CS060,18ME25,49,31,80,P,9,Jul-20,Regular
4JN19CS060,18CHEL26,48,31,79,P,8,Jul-20,Regular
4JN19CS060,18CPL27,38,31,69,P,7,Jul-20,Regular
4JN19CS060,18EGH28,32,31,63,P,7,Jul-20,Regular
4JN19CS061,18MAT21,50,34,84,P,9,Jul-20,Regular
4JN19CS061,18CHE22,50,34,84,P,9,Jul-20,Regular
4JN19CS061,18CPS23,39,34,73,P,8,Jul-20,Regular
4JN19CS061,18ELN24,50,34,84,P,9,Jul-20,Regular
4JN19CS061,18ME25,50,34,84,P,9,Jul-20,Regular
4JN19CS061,18CHEL26,47,34,81,P,9,Jul-20,Regular
4JN19CS061,18CPL27,38,34,72,P,8,Jul-20,Regular
4JN19CS061,18EGH28,37,34,71,P,8,Jul-20,Regular
4JN19CS062,18MAT21,50,43,93,P,10,Jul-20,Regular
4JN19CS062,18CHE22,49,43,92,P,10,Jul-20,Regular
4JN19CS062,18CPS23,42,43,85,P,9,Jul-20,Regular
4JN19CS062,18ELN24,50,43,93,P,10,Jul-20,Regular
4JN19CS062,18ME25,50,43,93,P,10,Jul-20,Regular
4JN19CS062,18CHEL26,50,43,93,P,10,Jul-20,Regular
4JN19CS062,18CPL27,47,43,90,P,10,Jul-20,Regular
4JN19CS062,18EGH28,35,43,78,P,8,Jul-20,Regular
4JN19CS063,18MAT21,50,40,90,P,10,Jul-20,Regular
4JN19CS063,18CHE22,50,40,90,P,10,Jul-20,Regular
4JN19CS063,18CPS23,44,40,84,P,9,Jul-20,Regular
4JN19CS063,18ELN24,50,40,90,P,10,Jul-20,Regular
4JN19CS063,18ME25,50,40,90,P,10,Jul-20,Regular
4JN19CS063,18CHEL26,48,40,88,P,9,Jul-20,Regular
4JN19CS063,18CPL27,38,40,78,P,8,Jul-20,Regular
4JN19CS063,18EGH28,39,40,79,P,8,Jul-20,Regular
4JN19CS065,18MAT21,50,46,96,P,10,Jul-20,Regular
4JN19CS065,18CHE22,50,46,96,P,10,Jul-20,Regular
4JN19CS065,18CPS23,50,46,96,P,10,Jul-20,Regular
4JN19CS065,18ELN24,50,46,96,P,10,Jul-20,Regular
4JN19CS065,18ME25,50,46,96,P,10,Jul-20,Regular
4JN19CS065,18CHEL26,50,46,96,P,10,Jul-20,Regular
4JN19CS065,18CPL27,49,46,95,P,10,Jul-20,Regular
4JN19CS065,18EGH28,45,46,91,P,10,Jul-20,Regular
4JN19CS066,18MAT21,50,38,88,P,9,Jul-20,Regular
4JN19CS066,18CHE22,49,38,87,P,9,Jul-20,Regular
4JN19CS066,18CPS23,50,38,88,P,9,Jul-20,Regular
4JN19CS066,18ELN24,48,38,86,P,9,Jul-20,Regular
4JN19CS066,18ME25,49,38,87,P,9,Jul-20,Regular
4JN19CS066,18CHEL26,49,38,87,P,9,Jul-20,Regular
4JN19CS066,18CPL27,47,38,85,P,9,Jul-20,Regular
4JN19CS066,18EGH28,40,38,78,P,8,Jul-20,Regular
4JN19CS067,18MAT21,49,35,84,P,9,Jul-20,Regular
4JN19CS067,18CHE22,48,35,83,P,9,Jul-20,Regular
4JN19CS067,18CPS23,45,35,80,P,9,Jul-20,Regular
4JN19CS067,18ELN24,48,35,83,P,9,Jul-20,Regular
4JN19CS067,18ME25,49,35,84,P,9,Jul-20,Regular
4JN19CS067,18CHEL26,48,35,83,P,9,Jul-20,Regular
4JN19CS067,18CPL27,40,35,75,P,8,Jul-20,Regular
4JN19CS067,18EGH28,33,35,68,P,7,Jul-20,Regular
4JN19CS068,18MAT21,49,29,78,P,8,Jul-20,Regular
4JN19CS068,18CHE22,48,29,77,P,8,Jul-20,Regular
4JN19CS068,18CPS23,50,29,79,P,8,Jul-20,Regular
4JN19CS068,18ELN24,48,29,77,P,8,Jul-20,Regular
4JN19CS068,18ME25,49,29,78,P,8,Jul-20,Regular
4JN19CS068,18CHEL26,49,29,78,P,8,Jul-20,Regular
4JN19CS068,18CPL27,43,29,72,P,8,Jul-20,Regular
4JN19CS068,18EGH28,30,29,59,P,6,Jul-20,Regular
4JN19CS069,18MAT21,49,41,90,P,10,Jul-20,Regular
4JN19CS069,18CHE22,49,41,90,P,10,Jul-20,Regular
4JN19CS069,18CPS23,49,41,90,P,10,Jul-20,Regular
4JN19CS069,18ELN24,49,41,90,P,10,Jul-20,Regular
4JN19CS069,18ME25,49,41,90,P,10,Jul-20,Regular
4JN19CS069,18CHEL26,50,41,91,P,10,Jul-20,Regular
4JN19CS069,18CPL27,45,41,86,P,9,Jul-20,Regular
4JN19CS069,18EGH28,33,41,74,P,8,Jul-20,Regular
4JN19CS070,18MAT21,49,36,85,P,9,Jul-20,Regular
4JN19CS070,18CHE22,48,36,84,P,9,Jul-20,Regular
4JN19CS070,18CPS23,50,36,86,P,9,Jul-20,Regular
4JN19CS070,18ELN24,49,36,85,P,9,Jul-20,Regular
4JN19CS070,18ME25,50,36,86,P,9,Jul-20,Regular
4JN19CS070,18CHEL26,50,36,86,P,9,Jul-20,Regular
4JN19CS070,18CPL27,49,36,85,P,9,Jul-20,Regular
4JN19CS070,18EGH28,38,36,74,P,8,Jul-20,Regular
4JN19CS071,18MAT21,49,33,82,P,9,Jul-20,Regular
4JN19CS071,18CHE22,49,33,82,P,9,Jul-20,Regular
4JN19CS071,18CPS23,48,33,81,P,9,Jul-20,Regular
4JN19CS071,18ELN24,47,33,80,P,9,Jul-20,Regular
4JN19CS071,18ME25,48,33,81,P,9,Jul-20,Regular
4JN19CS071,18CHEL26,47,33,80,P,9,Jul-20,Regular
4JN19CS071,18CPL27,43,33,76,P,8,Jul-20,Regular
4JN19CS071,18EGH28,37,33,70,P,8,Jul-20,Regular
4JN19CS073,18MAT21,49,33,82,P,9,Jul-20,Regular
4JN19CS073,18CHE22,50,33,83,P,9,Jul-20,Regular
4JN19CS073,18CPS23,49,33,82,P,9,Jul-20,Regular
4JN19CS073,18ELN24,50,33,83,P,9,Jul-20,Regular
4JN19CS073,18ME25,50,33,83,P,9,Jul-20,Regular
4JN19CS073,18CHEL26,50,33,83,P,9,Jul-20,Regular
4JN19CS073,18CPL27,45,33,78,P,8,Jul-20,Regular
4JN19CS073,18EGH28,29,33,62,P,7,Jul-20,Regular
4JN19CS074,18MAT21,49,37,86,P,9,Jul-20,Regular
4JN19CS074,18CHE22,50,37,87,P,9,Jul-20,Regular
4JN19CS074,18CPS23,50,37,87,P,9,Jul-20,Regular
4JN19CS074,18ELN24,50,37,87,P,9,Jul-20,Regular
4JN19CS074,18ME25,50,37,87,P,9,Jul-20,Regular
4JN19CS074,18CHEL26,50,37,87,P,9,Jul-20,Regular
4JN19CS074,18CPL27,47,37,84,P,9,Jul-20,Regular
4JN19CS074,18EGH28,37,37,74,P,8,Jul-20,Regular
4JN19CS075,18MAT21,50,37,87,P,9,Jul-20,Regular
4JN19CS075,18CHE22,50,37,87,P,9,Jul-20,Regular
4JN19CS075,18CPS23,49,37,86,P,9,Jul-20,Regular
4JN19CS075,18ELN24,50,37,87,P,9,Jul-20,Regular
4JN19CS075,18ME25,50,37,87,P,9,Jul-20,Regular
4JN19CS075,18CHEL26,49,37,86,P,9,Jul-20,Regular
4JN19CS075,18CPL27,49,37,86,P,9,Jul-20,Regular
4JN19CS075,18EGH28,39,37,76,P,8,Jul-20,Regular
4JN19CS076,18MAT21,49,37,86,P,9,Jul-20,Regular
4JN19CS076,18CHE22,50,37,87,P,9,Jul-20,Regular
4JN19CS076,18CPS23,50,37,87,P,9,Jul-20,Regular
4JN19CS076,18ELN24,50,37,87,P,9,Jul-20,Regular
4JN19CS076,18ME25,50,37,87,P,9,Jul-20,Regular
4JN19CS076,18CHEL26,50,37,87,P,9,Jul-20,Regular
4JN19CS076,18CPL27,44,37,81,P,9,Jul-20,Regular
4JN19CS076,18EGH28,32,37,69,P,7,Jul-20,Regular
4JN19CS079,18MAT21,49,34,83,P,9,Jul-20,Regular
4JN19CS079,18CHE22,50,34,84,P,9,Jul-20,Regular
4JN19CS079,18CPS23,49,34,83,P,9,Jul-20,Regular
4JN19CS079,18ELN24,50,34,84,P,9,Jul-20,Regular
4JN19CS079,18ME25,49,34,83,P,9,Jul-20,Regular
4JN19CS079,18CHEL26,49,34,83,P,9,Jul-20,Regular
4JN19CS079,18CPL27,43,34,77,P,8,Jul-20,Regular
4JN19CS079,18EGH28,30,34,64,P,7,Jul-20,Regular
4JN19CS082,18MAT21,50,40,90,P,10,Jul-20,Regular
4JN19CS082,18CHE22,50,40,90,P,10,Jul-20,Regular
4JN19CS082,18CPS23,49,40,89,P,9,Jul-20,Regular
4JN19CS082,18ELN24,50,40,90,P,10,Jul-20,Regular
4JN19CS082,18ME25,49,40,89,P,9,Jul-20,Regular
4JN19CS082,18CHEL26,50,40,90,P,10,Jul-20,Regular
4JN19CS082,18CPL27,47,40,87,P,9,Jul-20,Regular
4JN19CS082,18EGH28,37,40,77,P,8,Jul-20,Regular
4JN19CS083,18MAT21,49,34,83,P,9,Jul-20,Regular
4JN19CS083,18CHE22,50,34,84,P,9,Jul-20,Regular
4JN19CS083,18CPS23,49,34,83,P,9,Jul-20,Regular
4JN19CS083,18ELN24,50,34,84,P,9,Jul-20,Regular
4JN19CS083,18ME25,49,34,83,P,9,Jul-20,Regular
4JN19CS083,18CHEL26,50,34,84,P,9,Jul-20,Regular
4JN19CS083,18CPL27,44,34,78,P,8,Jul-20,Regular
4JN19CS083,18EGH28,33,34,67,P,7,Jul-20,Regular
4JN19CS084,18MAT21,49,34,83,P,9,Jul-20,Regular
4JN19CS084,18CHE22,50,34,84,P,9,Jul-20,Regular
4JN19CS084,18CPS23,49,34,83,P,9,Jul-20,Regular
4JN19CS084,18ELN24,50,34,84,P,9,Jul-20,Regular
4JN19CS084,18ME25,49,34,83,P,9,Jul-20,Regular
4JN19CS084,18CHEL26,48,34,82,P,9,Jul-20,Regular
4JN19CS084,18CPL27,47,34,81,P,9,Jul-20,Regular
4JN19CS084,18EGH28,34,34,68,P,7,Jul-20,Regular
4JN19CS086,18MAT21,50,41,91,P,10,Jul-20,Regular
4JN19CS086,18CHE22,50,41,91,P,10,Jul-20,Regular
4JN19CS086,18CPS23,50,41,91,P,10,Jul-20,Regular
4JN19CS086,18ELN24,49,41,90,P,10,Jul-20,Regular
4JN19CS086,18ME25,49,41,90,P,10,Jul-20,Regular
4JN19CS086,18CHEL26,50,41,91,P,10,Jul-20,Regular
4JN19CS086,18CPL27,48,41,89,P,9,Jul-20,Regular
4JN19CS086,18EGH28,39,41,80,P,9,Jul-20,Regular
4JN19CS089,18MAT21,49,32,81,P,9,Jul-20,Regular
4JN19CS089,18CHE22,49,32,81,P,9,Jul-20,Regular
4JN19CS089,18CPS23,47,32,79,P,8,Jul-20,Regular
4JN19CS089,18ELN24,48,32,80,P,9,Jul-20,Regular
4JN19CS089,18ME25,48,32,80,P,9,Jul-20,Regular
4JN19CS089,18CHEL26,48,32,80,P,9,Jul-20,Regular
4JN19CS089,18CPL27,45,32,77,P,8,Jul-20,Regular
4JN19CS089,18EGH28,43,32,75,P,8,Jul-20,Regular
4JN19CS090,18MAT21,49,37,86,P,9,Jul-20,Regular
4JN19CS090,18CHE22,49,37,86,P,9,Jul-20,Regular
4JN19CS090,18CPS23,47,37,84,P,9,Jul-20,Regular
4JN19CS090,18ELN24,49,37,86,P,9,Jul-20,Regular
4JN19CS090,18ME25,47,37,84,P,9,Jul-20,Regular
4JN19CS090,18CHEL26,50,37,87,P,9,Jul-20,Regular
4JN19CS090,18CPL27,45,37,82,P,9,Jul-20,Regular
4JN19CS090,18EGH28,29,37,66,P,7,Jul-20,Regular
4JN19CS092,18MAT21,49,37,86,P,9,Jul-20,Regular
4JN19CS092,18CHE22,50,37,87,P,9,Jul-20,Regular
4JN19CS092,18CPS23,50,37,87,P,9,Jul-20,Regular
4JN19CS092,18ELN24,50,37,87,P,9,Jul-20,Regular
4JN19CS092,18ME25,50,37,87,P,9,Jul-20,Regular
4JN19CS092,18CHEL26,50,37,87,P,9,Jul-20,Regular
4JN19CS092,18CPL27,45,37,82,P,9,Jul-20,Regular
4JN19CS092,18EGH28,34,37,71,P,8,Jul-20,Regular
4JN19CS093,18MAT21,50,41,91,P,10,Jul-20,Regular
4JN19CS093,18CHE22,50,41,91,P,10,Jul-20,Regular
4JN19CS093,18CPS23,50,41,91,P,10,Jul-20,Regular
4JN19CS093,18ELN24,50,41,91,P,10,Jul-20,Regular
4JN19CS093,18ME25,50,41,91,P,10,Jul-20,Regular
4JN19CS093,18CHEL26,50,41,91,P,10,Jul-20,Regular
4JN19CS093,18CPL27,44,41,85,P,9,Jul-20,Regular
4JN19CS093,18EGH28,37,41,78,P,8,Jul-20,Regular
4JN19CS095,18MAT21,50,36,86,P,9,Jul-20,Regular
4JN19CS095,18CHE22,48,36,84,P,9,Jul-20,Regular
4JN19CS095,18CPS23,50,36,86,P,9,Jul-20,Regular
4JN19CS095,18ELN24,37,36,73,P,8,Jul-20,Regular
4JN19CS095,18ME25,49,36,85,P,9,Jul-20,Regular
4JN19CS095,18CHEL26,47,36,83,P,9,Jul-20,Regular
4JN19CS095,18CPL27,44,36,80,P,9,Jul-20,Regular
4JN19CS095,18EGH28,38,36,74,P,8,Jul-20,Regular
4JN19CS097,18MAT21,50,37,87,P,9,Jul-20,Regular
4JN19CS097,18CHE22,49,37,86,P,9,Jul-20,Regular
4JN19CS097,18CPS23,50,37,87,P,9,Jul-20,Regular
4JN19CS097,18ELN24,48,37,85,P,9,Jul-20,Regular
4JN19CS097,18ME25,50,37,87,P,9,Jul-20,Regular
4JN19CS097,18CHEL26,48,37,85,P,9,Jul-20,Regular
4JN19CS097,18CPL27,47,37,84,P,9,Jul-20,Regular
4JN19CS097,18EGH28,32,37,69,P,7,Jul-20,Regular
4JN19CS098,18MAT21,50,37,87,P,9,Jul-20,Regular
4JN19CS098,18CHE22,49,37,86,P,9,Jul-20,Regular
4JN19CS098,18CPS23,50,37,87,P,9,Jul-20,Regular
4JN19CS098,18ELN24,48,37,85,P,9,Jul-20,Regular
4JN19CS098,18ME25,49,37,86,P,9,Jul-20,Regular
4JN19CS098,18CHEL26,49,37,86,P,9,Jul-20,Regular
4JN19CS098,18CPL27,47,37,84,P,9,Jul-20,Regular
4JN19CS098,18EGH28,37,37,74,P,8,Jul-20,Regular
4JN19CS099,18MAT21,50,39,89,P,9,Jul-20,Regular
4JN19CS099,18CHE22,50,39,89,P,9,Jul-20,Regular
4JN19CS099,18CPS23,50,39,89,P,9,Jul-20,Regular
4JN19CS099,18ELN24,45,39,84,P,9,Jul-20,Regular
4JN19CS099,18ME25,49,39,88,P,9,Jul-20,Regular
4JN19CS099,18CHEL26,48,39,87,P,9,Jul-20,Regular
4JN19CS099,18CPL27,48,39,87,P,9,Jul-20,Regular
4JN19CS099,18EGH28,43,39,82,P,9,Jul-20,Regular
4JN19CS100,18MAT21,50,29,79,P,8,Jul-20,Regular
4JN19CS100,18CHE22,49,29,78,P,8,Jul-20,Regular
4JN19CS100,18CPS23,50,29,79,P,8,Jul-20,Regular
4JN19CS100,18ELN24,43,29,72,P,8,Jul-20,Regular
4JN19CS100,18ME25,50,29,79,P,8,Jul-20,Regular
4JN19CS100,18CHEL26,47,29,76,P,8,Jul-20,Regular
4JN19CS100,18CPL27,44,29,73,P,8,Jul-20,Regular
4JN19CS100,18EGH28,28,29,57,P,6,Jul-20,Regular
4JN19CS101,18MAT21,50,28,78,P,8,Jul-20,Regular
4JN19CS101,18CHE22,45,28,73,P,8,Jul-20,Regular
4JN19CS101,18CPS23,50,28,78,P,8,Jul-20,Regular
4JN19CS101,18ELN24,48,28,76,P,8,Jul-20,Regular
4JN19CS101,18ME25,49,28,77,P,8,Jul-20,Regular
4JN19CS101,18CHEL26,47,28,75,P,8,Jul-20,Regular
4JN19CS101,18CPL27,45,28,73,P,8,Jul-20,Regular
4JN19CS101,18EGH28,39,28,67,P,7,Jul-20,Regular
4JN19CS102,18MAT21,50,39,89,P,9,Jul-20,Regular
4JN19CS102,18CHE22,49,39,88,P,9,Jul-20,Regular
4JN19CS102,18CPS23,50,39,89,P,9,Jul-20,Regular
4JN19CS102,18ELN24,45,39,84,P,9,Jul-20,Regular
4JN19CS102,18ME25,49,39,88,P,9,Jul-20,Regular
4JN19CS102,18CHEL26,48,39,87,P,9,Jul-20,Regular
4JN19CS102,18CPL27,47,39,86,P,9,Jul-20,Regular
4JN19CS102,18EGH28,40,39,79,P,8,Jul-20,Regular
4JN19CS103,18MAT21,50,36,86,P,9,Jul-20,Regular
4JN19CS103,18CHE22,49,36,85,P,9,Jul-20,Regular
4JN19CS103,18CPS23,50,36,86,P,9,Jul-20,Regular
4JN19CS103,18ELN24,45,36,81,P,9,Jul-20,Regular
4JN19CS103,18ME25,48,36,84,P,9,Jul-20,Regular
4JN19CS103,18CHEL26,48,36,84,P,9,Jul-20,Regular
4JN19CS103,18CPL27,43,36,79,P,8,Jul-20,Regular
4JN19CS103,18EGH28,29,36,65,P,7,Jul-20,Regular
4JN19CS104,18MAT21,50,44,94,P,10,Jul-20,Regular
4JN19CS104,18CHE22,50,44,94,P,10,Jul-20,Regular
4JN19CS104,18CPS23,50,44,94,P,10,Jul-20,Regular
4JN19CS104,18ELN24,49,44,93,P,10,Jul-20,Regular
4JN19CS104,18ME25,50,44,94,P,10,Jul-20,Regular
4JN19CS104,18CHEL26,50,44,94,P,10,Jul-20,Regular
4JN19CS104,18CPL27,48,44,92,P,10,Jul-20,Regular
4JN19CS104,18EGH28,43,44,87,P,9,Jul-20,Regular
4JN19CS105,18MAT21,50,38,88,P,9,Jul-20,Regular
4JN19CS105,18CHE22,49,38,87,P,9,Jul-20,Regular
4JN19CS105,18CPS23,50,38,88,P,9,Jul-20,Regular
4JN19CS105,18ELN24,49,38,87,P,9,Jul-20,Regular
4JN19CS105,18ME25,50,38,88,P,9,Jul-20,Regular
4JN19CS105,18CHEL26,49,38,87,P,9,Jul-20,Regular
4JN19CS105,18CPL27,42,38,80,P,9,Jul-20,Regular
4JN19CS105,18EGH28,40,38,78,P,8,Jul-20,Regular
4JN19CS107,18MAT21,50,39,89,P,9,Jul-20,Regular
4JN19CS107,18CHE22,49,39,88,P,9,Jul-20,Regular
4JN19CS107,18CPS23,50,39,89,P,9,Jul-20,Regular
4JN19CS107,18ELN24,48,39,87,P,9,Jul-20,Regular
4JN19CS107,18ME25,50,39,89,P,9,Jul-20,Regular
4JN19CS107,18CHEL26,48,39,87,P,9,Jul-20,Regular
4JN19CS107,18CPL27,50,39,89,P,9,Jul-20,Regular
4JN19CS107,18EGH28,34,39,73,P,8,Jul-20,Regular
4JN19CS108,18MAT21,50,37,87,P,9,Jul-20,Regular
4JN19CS108,18CHE22,49,37,86,P,9,Jul-20,Regular
4JN19CS108,18CPS23,50,37,87,P,9,Jul-20,Regular
4JN19CS108,18ELN24,42,37,79,P,8,Jul-20,Regular
4JN19CS108,18ME25,50,37,87,P,9,Jul-20,Regular
4JN19CS108,18CHEL26,49,37,86,P,9,Jul-20,Regular
4JN19CS108,18CPL27,43,37,80,P,9,Jul-20,Regular
4JN19CS108,18EGH28,40,37,77,P,8,Jul-20,Regular
4JN19CS109,18MAT21,50,31,81,P,9,Jul-20,Regular
4JN19CS109,18CHE22,50,31,81,P,9,Jul-20,Regular
4JN19CS109,18CPS23,50,31,81,P,9,Jul-20,Regular
4JN19CS109,18ELN24,47,31,78,P,8,Jul-20,Regular
4JN19CS109,18ME25,49,31,80,P,9,Jul-20,Regular
4JN19CS109,18CHEL26,50,31,81,P,9,Jul-20,Regular
4JN19CS109,18CPL27,44,31,75,P,8,Jul-20,Regular
4JN19CS109,18EGH28,28,31,59,P,6,Jul-20,Regular
4JN19CS110,18MAT21,50,44,94,P,10,Jul-20,Regular
4JN19CS110,18CHE22,50,44,94,P,10,Jul-20,Regular
4JN19CS110,18CPS23,50,44,94,P,10,Jul-20,Regular
4JN19CS110,18ELN24,49,44,93,P,10,Jul-20,Regular
4JN19CS110,18ME25,50,44,94,P,10,Jul-20,Regular
4JN19CS110,18CHEL26,50,44,94,P,10,Jul-20,Regular
4JN19CS110,18CPL27,44,44,88,P,9,Jul-20,Regular
4JN19CS110,18EGH28,39,44,83,P,9,Jul-20,Regular
4JN19CS111,18MAT21,50,35,85,P,9,Jul-20,Regular
4JN19CS111,18CHE22,48,35,83,P,9,Jul-20,Regular
4JN19CS111,18CPS23,50,35,85,P,9,Jul-20,Regular
4JN19CS111,18ELN24,45,35,80,P,9,Jul-20,Regular
4JN19CS111,18ME25,50,35,85,P,9,Jul-20,Regular
4JN19CS111,18CHEL26,47,35,82,P,9,Jul-20,Regular
4JN19CS111,18CPL27,45,35,80,P,9,Jul-20,Regular
4JN19CS111,18EGH28,34,35,69,P,7,Jul-20,Regular
4JN19CS112,18MAT21,50,35,85,P,9,Jul-20,Regular
4JN19CS112,18CHE22,50,35,85,P,9,Jul-20,Regular
4JN19CS112,18CPS23,50,35,85,P,9,Jul-20,Regular
4JN19CS112,18ELN24,45,35,80,P,9,Jul-20,Regular
4JN19CS112,18ME25,50,35,85,P,9,Jul-20,Regular
4JN19CS112,18CHEL26,49,35,84,P,9,Jul-20,Regular
4JN19CS112,18CPL27,49,35,84,P,9,Jul-20,Regular
4JN19CS112,18EGH28,34,35,69,P,7,Jul-20,Regular
4JN19CS113,18MAT21,50,30,80,P,9,Jul-20,Regular
4JN19CS113,18CHE22,48,30,78,P,8,Jul-20,Regular
